,Sea,Lge,Date,HT,AT,HS,AS,GD,WDL
91525,0,SCO4,2000-08-05,Albion Rovers,East Fife,0,1,-1,L
91526,0,SCO4,2000-08-05,Brechin City,Elgin City,2,1,1,W
91527,0,SCO4,2000-08-05,East Stirling,Cowdenbeath,0,2,-2,L
91528,0,SCO4,2000-08-05,Hamilton Academical,Dumbarton,2,0,2,W
91529,0,SCO4,2000-08-05,Peterhead,Montrose,2,0,2,W
91530,0,SCO4,2000-08-12,Cowdenbeath,Albion Rovers,5,0,5,W
91531,0,SCO4,2000-08-12,Dumbarton,Brechin City,0,2,-2,L
91532,0,SCO4,2000-08-12,East Fife,Peterhead,1,1,0,D
91533,0,SCO4,2000-08-12,Elgin City,Hamilton Academical,0,2,-2,L
91534,0,SCO4,2000-08-12,Montrose,East Stirling,0,1,-1,L
91535,0,SCO4,2000-08-19,Albion Rovers,Elgin City,1,1,0,D
91536,0,SCO4,2000-08-19,Brechin City,Cowdenbeath,0,0,0,D
91537,0,SCO4,2000-08-19,East Stirling,East Fife,2,5,-3,L
91538,0,SCO4,2000-08-19,Hamilton Academical,Montrose,6,0,6,W
91539,0,SCO4,2000-08-19,Peterhead,Dumbarton,2,0,2,W
91540,0,SCO4,2000-08-26,Albion Rovers,Dumbarton,0,1,-1,L
91541,0,SCO4,2000-08-26,Cowdenbeath,Elgin City,3,1,2,W
91542,0,SCO4,2000-08-26,East Stirling,Hamilton Academical,0,0,0,D
91543,0,SCO4,2000-08-26,Montrose,East Fife,0,1,-1,L
91544,0,SCO4,2000-08-26,Peterhead,Brechin City,1,2,-1,L
91545,0,SCO4,2000-09-09,Brechin City,Montrose,6,1,5,W
91546,0,SCO4,2000-09-09,Dumbarton,East Stirling,1,2,-1,L
91547,0,SCO4,2000-09-09,East Fife,Cowdenbeath,0,2,-2,L
91548,0,SCO4,2000-09-09,Elgin City,Peterhead,1,3,-2,L
91549,0,SCO4,2000-09-09,Hamilton Academical,Albion Rovers,0,2,-2,L
91550,0,SCO4,2000-09-16,Albion Rovers,Brechin City,1,3,-2,L
91551,0,SCO4,2000-09-16,Cowdenbeath,Hamilton Academical,2,0,2,W
91552,0,SCO4,2000-09-16,East Fife,Elgin City,1,1,0,D
91553,0,SCO4,2000-09-16,Montrose,Dumbarton,2,2,0,D
91554,0,SCO4,2000-09-16,Peterhead,East Stirling,2,4,-2,L
91555,0,SCO4,2000-09-23,Brechin City,East Fife,3,1,2,W
91556,0,SCO4,2000-09-23,Dumbarton,Cowdenbeath,2,4,-2,L
91557,0,SCO4,2000-09-23,East Stirling,Albion Rovers,1,1,0,D
91558,0,SCO4,2000-09-23,Elgin City,Montrose,1,1,0,D
91559,0,SCO4,2000-09-23,Hamilton Academical,Peterhead,3,0,3,W
91560,0,SCO4,2000-09-30,Albion Rovers,Peterhead,0,0,0,D
91561,0,SCO4,2000-09-30,Brechin City,East Stirling,4,1,3,W
91562,0,SCO4,2000-09-30,Cowdenbeath,Montrose,2,0,2,W
91563,0,SCO4,2000-09-30,East Fife,Hamilton Academical,1,2,-1,L
91564,0,SCO4,2000-09-30,Elgin City,Dumbarton,2,0,2,W
91565,0,SCO4,2000-10-07,Dumbarton,East Fife,2,3,-1,L
91566,0,SCO4,2000-10-07,East Stirling,Elgin City,0,2,-2,L
91567,0,SCO4,2000-10-07,Hamilton Academical,Brechin City,4,1,3,W
91568,0,SCO4,2000-10-07,Montrose,Albion Rovers,0,2,-2,L
91569,0,SCO4,2000-10-07,Peterhead,Cowdenbeath,3,0,3,W
91570,0,SCO4,2000-10-14,Cowdenbeath,East Stirling,3,0,3,W
91571,0,SCO4,2000-10-14,Dumbarton,Hamilton Academical,2,3,-1,L
91572,0,SCO4,2000-10-14,East Fife,Albion Rovers,0,0,0,D
91573,0,SCO4,2000-10-14,Elgin City,Brechin City,2,2,0,D
91574,0,SCO4,2000-10-14,Montrose,Peterhead,0,2,-2,L
91575,0,SCO4,2000-10-21,Albion Rovers,Cowdenbeath,1,0,1,W
91576,0,SCO4,2000-10-21,Brechin City,Dumbarton,3,1,2,W
91577,0,SCO4,2000-10-21,East Stirling,Montrose,1,2,-1,L
91578,0,SCO4,2000-10-21,Hamilton Academical,Elgin City,4,1,3,W
91579,0,SCO4,2000-10-21,Peterhead,East Fife,0,0,0,D
91580,0,SCO4,2000-10-24,Hamilton Academical,East Stirling,4,0,4,W
91581,0,SCO4,2000-10-28,Brechin City,Peterhead,3,2,1,W
91582,0,SCO4,2000-10-28,Dumbarton,Albion Rovers,0,1,-1,L
91583,0,SCO4,2000-10-28,East Fife,Montrose,3,1,2,W
91584,0,SCO4,2000-10-28,Elgin City,Cowdenbeath,2,3,-1,L
91585,0,SCO4,2000-11-04,Albion Rovers,Hamilton Academical,1,1,0,D
91586,0,SCO4,2000-11-04,Cowdenbeath,East Fife,1,0,1,W
91587,0,SCO4,2000-11-04,East Stirling,Dumbarton,1,1,0,D
91588,0,SCO4,2000-11-04,Montrose,Brechin City,1,1,0,D
91589,0,SCO4,2000-11-04,Peterhead,Elgin City,1,0,1,W
91590,0,SCO4,2000-11-11,Albion Rovers,East Stirling,2,1,1,W
91591,0,SCO4,2000-11-11,Cowdenbeath,Dumbarton,1,1,0,D
91592,0,SCO4,2000-11-11,East Fife,Brechin City,1,0,1,W
91593,0,SCO4,2000-11-11,Montrose,Elgin City,0,0,0,D
91594,0,SCO4,2000-11-11,Peterhead,Hamilton Academical,1,1,0,D
91595,0,SCO4,2000-11-18,Brechin City,Albion Rovers,2,1,1,W
91596,0,SCO4,2000-11-18,Dumbarton,Montrose,1,0,1,W
91597,0,SCO4,2000-11-18,East Stirling,Peterhead,1,3,-2,L
91598,0,SCO4,2000-11-18,Elgin City,East Fife,1,3,-2,L
91599,0,SCO4,2000-11-18,Hamilton Academical,Cowdenbeath,0,0,0,D
91600,0,SCO4,2000-11-25,Albion Rovers,Montrose,3,2,1,W
91601,0,SCO4,2000-11-25,Brechin City,Hamilton Academical,0,0,0,D
91602,0,SCO4,2000-11-25,Cowdenbeath,Peterhead,2,0,2,W
91603,0,SCO4,2000-11-25,East Fife,Dumbarton,1,0,1,W
91604,0,SCO4,2000-11-25,Elgin City,East Stirling,1,2,-1,L
91605,0,SCO4,2000-12-02,Dumbarton,Elgin City,3,0,3,W
91606,0,SCO4,2000-12-02,East Stirling,Brechin City,0,1,-1,L
91607,0,SCO4,2000-12-02,Hamilton Academical,East Fife,1,1,0,D
91608,0,SCO4,2000-12-02,Montrose,Cowdenbeath,1,2,-1,L
91609,0,SCO4,2000-12-02,Peterhead,Albion Rovers,1,2,-1,L
91610,0,SCO4,2000-12-16,Brechin City,Elgin City,2,1,1,W
91611,0,SCO4,2000-12-16,Hamilton Academical,Dumbarton,2,0,2,W
91612,0,SCO4,2000-12-23,Albion Rovers,East Fife,1,2,-1,L
91613,0,SCO4,2000-12-23,Cowdenbeath,Brechin City,2,1,1,W
91614,0,SCO4,2000-12-23,Dumbarton,Peterhead,1,3,-2,L
91615,0,SCO4,2000-12-26,East Fife,East Stirling,3,1,2,W
91616,0,SCO4,2000-12-30,Peterhead,Brechin City,0,2,-2,L
91617,0,SCO4,2001-01-02,Dumbarton,East Stirling,3,0,3,W
91618,0,SCO4,2001-01-02,East Fife,Cowdenbeath,1,2,-1,L
91619,0,SCO4,2001-01-02,Hamilton Academical,Albion Rovers,3,2,1,W
91620,0,SCO4,2001-01-13,Peterhead,East Stirling,1,2,-1,L
91621,0,SCO4,2001-01-20,Hamilton Academical,Peterhead,3,0,3,W
91622,0,SCO4,2001-01-27,Albion Rovers,Dumbarton,1,3,-2,L
91623,0,SCO4,2001-01-27,East Stirling,Hamilton Academical,1,4,-3,L
91624,0,SCO4,2001-02-03,Dumbarton,East Fife,2,0,2,W
91625,0,SCO4,2001-02-03,East Stirling,Elgin City,1,0,1,W
91626,0,SCO4,2001-02-03,Hamilton Academical,Brechin City,1,0,1,W
91627,0,SCO4,2001-02-03,Montrose,Albion Rovers,0,1,-1,L
91628,0,SCO4,2001-02-17,Albion Rovers,Elgin City,0,1,-1,L
91629,0,SCO4,2001-02-17,Brechin City,Cowdenbeath,2,0,2,W
91630,0,SCO4,2001-02-17,East Stirling,East Fife,1,0,1,W
91631,0,SCO4,2001-02-17,Hamilton Academical,Montrose,1,3,-2,L
91632,0,SCO4,2001-02-24,Cowdenbeath,Albion Rovers,1,0,1,W
91633,0,SCO4,2001-02-24,Dumbarton,Brechin City,1,0,1,W
91634,0,SCO4,2001-02-24,East Fife,Peterhead,2,1,1,W
91635,0,SCO4,2001-02-24,Montrose,East Stirling,1,1,0,D
91636,0,SCO4,2001-03-06,Elgin City,Peterhead,0,1,-1,L
91637,0,SCO4,2001-03-07,Dumbarton,Cowdenbeath,3,0,3,W
91638,0,SCO4,2001-03-10,Dumbarton,Albion Rovers,1,4,-3,L
91639,0,SCO4,2001-03-10,East Fife,Montrose,1,0,1,W
91640,0,SCO4,2001-03-10,Elgin City,Cowdenbeath,0,2,-2,L
91641,0,SCO4,2001-03-10,Hamilton Academical,East Stirling,2,2,0,D
91642,0,SCO4,2001-03-13,East Stirling,Albion Rovers,1,0,1,W
91643,0,SCO4,2001-03-13,Elgin City,Dumbarton,0,3,-3,L
91644,0,SCO4,2001-03-13,Montrose,East Fife,1,1,0,D
91645,0,SCO4,2001-03-13,Peterhead,Cowdenbeath,3,0,3,W
91646,0,SCO4,2001-03-17,Albion Rovers,East Stirling,2,2,0,D
91647,0,SCO4,2001-03-17,Cowdenbeath,Dumbarton,2,2,0,D
91648,0,SCO4,2001-03-17,East Fife,Brechin City,1,4,-3,L
91649,0,SCO4,2001-03-17,Montrose,Elgin City,2,1,1,W
91650,0,SCO4,2001-03-17,Peterhead,Hamilton Academical,2,1,1,W
91651,0,SCO4,2001-03-20,Albion Rovers,Peterhead,0,1,-1,L
91652,0,SCO4,2001-03-20,Brechin City,Montrose,3,0,3,W
91653,0,SCO4,2001-03-20,Cowdenbeath,Hamilton Academical,1,1,0,D
91654,0,SCO4,2001-03-20,East Fife,Elgin City,1,1,0,D
91655,0,SCO4,2001-03-20,East Stirling,Dumbarton,0,0,0,D
91656,0,SCO4,2001-03-24,Brechin City,East Stirling,5,1,4,W
91657,0,SCO4,2001-03-24,Peterhead,Dumbarton,0,1,-1,L
91658,0,SCO4,2001-03-25,Albion Rovers,Hamilton Academical,0,1,-1,L
91659,0,SCO4,2001-03-25,Cowdenbeath,Elgin City,1,0,1,W
91660,0,SCO4,2001-03-27,Brechin City,Peterhead,1,1,0,D
91661,0,SCO4,2001-03-27,East Fife,Hamilton Academical,1,4,-3,L
91662,0,SCO4,2001-03-27,Montrose,Dumbarton,1,2,-1,L
91663,0,SCO4,2001-03-28,Elgin City,Albion Rovers,1,2,-1,L
91664,0,SCO4,2001-03-31,Dumbarton,Montrose,1,2,-1,L
91665,0,SCO4,2001-03-31,East Stirling,Peterhead,1,0,1,W
91666,0,SCO4,2001-03-31,Elgin City,East Fife,1,3,-2,L
91667,0,SCO4,2001-03-31,Hamilton Academical,Cowdenbeath,0,0,0,D
91668,0,SCO4,2001-04-03,Brechin City,East Fife,1,0,1,W
91669,0,SCO4,2001-04-03,East Stirling,Cowdenbeath,0,2,-2,L
91670,0,SCO4,2001-04-03,Elgin City,Montrose,0,2,-2,L
91671,0,SCO4,2001-04-07,Albion Rovers,Montrose,2,1,1,W
91672,0,SCO4,2001-04-07,Brechin City,Hamilton Academical,3,4,-1,L
91673,0,SCO4,2001-04-07,Cowdenbeath,Peterhead,4,0,4,W
91674,0,SCO4,2001-04-07,East Fife,Dumbarton,0,1,-1,L
91675,0,SCO4,2001-04-07,Elgin City,East Stirling,4,2,2,W
91676,0,SCO4,2001-04-10,Albion Rovers,Brechin City,1,1,0,D
91677,0,SCO4,2001-04-10,Cowdenbeath,Montrose,2,1,1,W
91678,0,SCO4,2001-04-10,Elgin City,Hamilton Academical,0,3,-3,L
91679,0,SCO4,2001-04-14,Dumbarton,Elgin City,2,0,2,W
91680,0,SCO4,2001-04-14,East Stirling,Brechin City,0,2,-2,L
91681,0,SCO4,2001-04-14,Hamilton Academical,East Fife,1,1,0,D
91682,0,SCO4,2001-04-14,Montrose,Cowdenbeath,0,1,-1,L
91683,0,SCO4,2001-04-14,Peterhead,Albion Rovers,1,1,0,D
91684,0,SCO4,2001-04-17,Brechin City,Albion Rovers,1,2,-1,L
91685,0,SCO4,2001-04-17,Cowdenbeath,East Fife,3,2,1,W
91686,0,SCO4,2001-04-17,Peterhead,Montrose,1,1,0,D
91687,0,SCO4,2001-04-21,Cowdenbeath,East Stirling,1,3,-2,L
91688,0,SCO4,2001-04-21,Dumbarton,Hamilton Academical,1,2,-1,L
91689,0,SCO4,2001-04-21,East Fife,Albion Rovers,2,1,1,W
91690,0,SCO4,2001-04-21,Elgin City,Brechin City,0,3,-3,L
91691,0,SCO4,2001-04-21,Montrose,Peterhead,2,2,0,D
91692,0,SCO4,2001-04-24,Montrose,Brechin City,1,3,-2,L
91693,0,SCO4,2001-04-28,Albion Rovers,Cowdenbeath,0,0,0,D
91694,0,SCO4,2001-04-28,Brechin City,Dumbarton,1,0,1,W
91695,0,SCO4,2001-04-28,East Stirling,Montrose,0,1,-1,L
91696,0,SCO4,2001-04-28,Hamilton Academical,Elgin City,3,0,3,W
91697,0,SCO4,2001-04-28,Peterhead,East Fife,2,1,1,W
91698,0,SCO4,2001-05-01,Montrose,Hamilton Academical,0,2,-2,L
91699,0,SCO4,2001-05-01,Peterhead,Elgin City,1,1,0,D
91700,0,SCO4,2001-05-05,Cowdenbeath,Brechin City,2,1,1,W
91701,0,SCO4,2001-05-05,Dumbarton,Peterhead,2,2,0,D
91702,0,SCO4,2001-05-05,East Fife,East Stirling,4,1,3,W
91703,0,SCO4,2001-05-05,Elgin City,Albion Rovers,1,0,1,W
91704,0,SCO4,2001-05-05,Montrose,Hamilton Academical,1,4,-3,L
91705,1,SCO4,2001-08-04,Dumbarton,Brechin City,1,2,-1,L
91706,1,SCO4,2001-08-04,East Fife,Albion Rovers,0,0,0,D
91707,1,SCO4,2001-08-04,Elgin City,East Stirling,2,1,1,W
91708,1,SCO4,2001-08-04,Montrose,Queens Park,3,1,2,W
91709,1,SCO4,2001-08-04,Stirling Albion,Peterhead,2,1,1,W
91710,1,SCO4,2001-08-11,Albion Rovers,Stirling Albion,1,3,-2,L
91711,1,SCO4,2001-08-11,Brechin City,East Fife,6,0,6,W
91712,1,SCO4,2001-08-11,East Stirling,Montrose,0,1,-1,L
91713,1,SCO4,2001-08-11,Peterhead,Dumbarton,0,3,-3,L
91714,1,SCO4,2001-08-11,Queens Park,Elgin City,0,0,0,D
91715,1,SCO4,2001-08-18,Dumbarton,Queens Park,2,1,1,W
91716,1,SCO4,2001-08-18,East Fife,East Stirling,0,4,-4,L
91717,1,SCO4,2001-08-18,Elgin City,Albion Rovers,2,0,2,W
91718,1,SCO4,2001-08-18,Montrose,Peterhead,0,3,-3,L
91719,1,SCO4,2001-08-18,Stirling Albion,Brechin City,1,3,-2,L
91720,1,SCO4,2001-08-25,Brechin City,Albion Rovers,4,1,3,W
91721,1,SCO4,2001-08-25,Dumbarton,Montrose,0,1,-1,L
91722,1,SCO4,2001-08-25,East Fife,Peterhead,0,1,-1,L
91723,1,SCO4,2001-08-25,Elgin City,Stirling Albion,2,3,-1,L
91724,1,SCO4,2001-08-25,Queens Park,East Stirling,2,3,-1,L
91725,1,SCO4,2001-09-08,Albion Rovers,Queens Park,2,1,1,W
91726,1,SCO4,2001-09-08,East Stirling,Dumbarton,2,4,-2,L
91727,1,SCO4,2001-09-08,Montrose,Brechin City,0,1,-1,L
91728,1,SCO4,2001-09-08,Peterhead,Elgin City,1,1,0,D
91729,1,SCO4,2001-09-08,Stirling Albion,East Fife,2,1,1,W
91730,1,SCO4,2001-09-15,Dumbarton,Albion Rovers,1,1,0,D
91731,1,SCO4,2001-09-15,East Stirling,Peterhead,2,3,-1,L
91732,1,SCO4,2001-09-15,Elgin City,East Fife,1,1,0,D
91733,1,SCO4,2001-09-15,Montrose,Stirling Albion,4,0,4,W
91734,1,SCO4,2001-09-15,Queens Park,Brechin City,1,3,-2,L
91735,1,SCO4,2001-09-18,Albion Rovers,East Stirling,0,4,-4,L
91736,1,SCO4,2001-09-18,East Fife,Montrose,1,2,-1,L
91737,1,SCO4,2001-09-19,Stirling Albion,Dumbarton,4,5,-1,L
91738,1,SCO4,2001-09-22,Dumbarton,Elgin City,2,2,0,D
91739,1,SCO4,2001-09-22,East Stirling,Stirling Albion,1,1,0,D
91740,1,SCO4,2001-09-22,Montrose,Albion Rovers,1,2,-1,L
91741,1,SCO4,2001-09-22,Peterhead,Brechin City,4,2,2,W
91742,1,SCO4,2001-09-22,Queens Park,East Fife,1,2,-1,L
91743,1,SCO4,2001-09-29,Albion Rovers,Peterhead,1,0,1,W
91744,1,SCO4,2001-09-29,Brechin City,East Stirling,1,2,-1,L
91745,1,SCO4,2001-09-29,East Fife,Dumbarton,4,1,3,W
91746,1,SCO4,2001-09-29,Elgin City,Montrose,1,2,-1,L
91747,1,SCO4,2001-09-29,Stirling Albion,Queens Park,0,0,0,D
91748,1,SCO4,2001-10-06,Peterhead,Queens Park,2,1,1,W
91749,1,SCO4,2001-10-07,Brechin City,Elgin City,1,0,1,W
91750,1,SCO4,2001-10-13,Albion Rovers,East Fife,3,0,3,W
91751,1,SCO4,2001-10-13,Brechin City,Dumbarton,3,2,1,W
91752,1,SCO4,2001-10-13,East Stirling,Elgin City,2,1,1,W
91753,1,SCO4,2001-10-13,Peterhead,Stirling Albion,3,3,0,D
91754,1,SCO4,2001-10-13,Queens Park,Montrose,2,2,0,D
91755,1,SCO4,2001-10-20,Dumbarton,Peterhead,0,3,-3,L
91756,1,SCO4,2001-10-20,East Fife,Brechin City,3,1,2,W
91757,1,SCO4,2001-10-20,Elgin City,Queens Park,2,0,2,W
91758,1,SCO4,2001-10-20,Montrose,East Stirling,2,0,2,W
91759,1,SCO4,2001-10-20,Stirling Albion,Albion Rovers,2,2,0,D
91760,1,SCO4,2001-10-27,Brechin City,Montrose,0,0,0,D
91761,1,SCO4,2001-10-27,Dumbarton,East Stirling,2,2,0,D
91762,1,SCO4,2001-10-27,East Fife,Stirling Albion,1,1,0,D
91763,1,SCO4,2001-10-27,Elgin City,Peterhead,4,1,3,W
91764,1,SCO4,2001-10-27,Queens Park,Albion Rovers,1,2,-1,L
91765,1,SCO4,2001-11-03,Albion Rovers,Brechin City,1,2,-1,L
91766,1,SCO4,2001-11-03,East Stirling,Queens Park,0,1,-1,L
91767,1,SCO4,2001-11-03,Montrose,Dumbarton,1,3,-2,L
91768,1,SCO4,2001-11-03,Peterhead,East Fife,1,3,-2,L
91769,1,SCO4,2001-11-03,Stirling Albion,Elgin City,0,1,-1,L
91770,1,SCO4,2001-11-10,Albion Rovers,Dumbarton,0,2,-2,L
91771,1,SCO4,2001-11-10,Brechin City,Queens Park,2,1,1,W
91772,1,SCO4,2001-11-10,East Fife,Elgin City,3,0,3,W
91773,1,SCO4,2001-11-10,Peterhead,East Stirling,3,2,1,W
91774,1,SCO4,2001-11-10,Stirling Albion,Montrose,1,1,0,D
91775,1,SCO4,2001-11-24,Dumbarton,Stirling Albion,4,1,3,W
91776,1,SCO4,2001-11-24,East Stirling,Brechin City,3,4,-1,L
91777,1,SCO4,2001-11-24,Montrose,East Fife,2,1,1,W
91778,1,SCO4,2001-11-24,Queens Park,Peterhead,0,1,-1,L
91779,1,SCO4,2001-11-27,East Stirling,Albion Rovers,1,2,-1,L
91780,1,SCO4,2001-11-27,Elgin City,Brechin City,0,1,-1,L
91781,1,SCO4,2001-12-01,Albion Rovers,Montrose,0,0,0,D
91782,1,SCO4,2001-12-01,Brechin City,Peterhead,4,3,1,W
91783,1,SCO4,2001-12-01,East Fife,Queens Park,1,4,-3,L
91784,1,SCO4,2001-12-01,Stirling Albion,East Stirling,1,1,0,D
91785,1,SCO4,2001-12-08,Elgin City,Dumbarton,0,3,-3,L
91786,1,SCO4,2001-12-15,Dumbarton,East Fife,1,0,1,W
91787,1,SCO4,2001-12-15,Montrose,Elgin City,0,2,-2,L
91788,1,SCO4,2001-12-15,Peterhead,Albion Rovers,0,0,0,D
91789,1,SCO4,2001-12-15,Queens Park,Stirling Albion,2,2,0,D
91790,1,SCO4,2001-12-22,Peterhead,Montrose,4,0,4,W
91791,1,SCO4,2002-01-05,Peterhead,Elgin City,1,0,1,W
91792,1,SCO4,2002-01-12,Brechin City,Albion Rovers,0,0,0,D
91793,1,SCO4,2002-01-12,Dumbarton,Montrose,0,5,-5,L
91794,1,SCO4,2002-01-12,East Fife,Peterhead,2,3,-1,L
91795,1,SCO4,2002-01-12,Elgin City,Stirling Albion,2,1,1,W
91796,1,SCO4,2002-01-12,Queens Park,East Stirling,1,0,1,W
91797,1,SCO4,2002-01-19,Albion Rovers,East Stirling,5,1,4,W
91798,1,SCO4,2002-01-19,Brechin City,Elgin City,1,0,1,W
91799,1,SCO4,2002-01-19,East Fife,Montrose,2,0,2,W
91800,1,SCO4,2002-01-19,Queens Park,Peterhead,2,0,2,W
91801,1,SCO4,2002-01-19,Stirling Albion,Dumbarton,2,1,1,W
91802,1,SCO4,2002-01-26,Dumbarton,Albion Rovers,2,0,2,W
91803,1,SCO4,2002-01-26,Elgin City,East Fife,2,0,2,W
91804,1,SCO4,2002-01-26,Montrose,Stirling Albion,1,3,-2,L
91805,1,SCO4,2002-01-26,Queens Park,Brechin City,0,0,0,D
91806,1,SCO4,2002-02-02,Albion Rovers,Peterhead,2,1,1,W
91807,1,SCO4,2002-02-02,Brechin City,East Stirling,2,0,2,W
91808,1,SCO4,2002-02-02,East Fife,Dumbarton,1,0,1,W
91809,1,SCO4,2002-02-02,Elgin City,Montrose,1,0,1,W
91810,1,SCO4,2002-02-02,Stirling Albion,Queens Park,3,2,1,W
91811,1,SCO4,2002-02-09,Dumbarton,Elgin City,3,1,2,W
91812,1,SCO4,2002-02-09,East Stirling,Stirling Albion,3,0,3,W
91813,1,SCO4,2002-02-09,Montrose,Albion Rovers,2,0,2,W
91814,1,SCO4,2002-02-09,Peterhead,Brechin City,1,3,-2,L
91815,1,SCO4,2002-02-09,Queens Park,East Fife,2,0,2,W
91816,1,SCO4,2002-02-12,East Fife,Albion Rovers,2,3,-1,L
91817,1,SCO4,2002-02-16,Albion Rovers,Stirling Albion,2,0,2,W
91818,1,SCO4,2002-02-16,Brechin City,East Fife,1,1,0,D
91819,1,SCO4,2002-02-16,East Stirling,Montrose,2,1,1,W
91820,1,SCO4,2002-02-16,Peterhead,Dumbarton,4,0,4,W
91821,1,SCO4,2002-02-16,Queens Park,Elgin City,3,0,3,W
91822,1,SCO4,2002-02-23,East Fife,East Stirling,1,0,1,W
91823,1,SCO4,2002-02-23,Montrose,Peterhead,2,1,1,W
91824,1,SCO4,2002-02-23,Queens Park,Dumbarton,0,0,0,D
91825,1,SCO4,2002-02-26,Albion Rovers,Elgin City,4,4,0,D
91826,1,SCO4,2002-02-26,Montrose,Queens Park,3,1,2,W
91827,1,SCO4,2002-02-27,Dumbarton,Brechin City,2,1,1,W
91828,1,SCO4,2002-02-27,Stirling Albion,Peterhead,0,2,-2,L
91829,1,SCO4,2002-03-02,Albion Rovers,Brechin City,0,1,-1,L
91830,1,SCO4,2002-03-02,East Stirling,Queens Park,3,1,2,W
91831,1,SCO4,2002-03-02,Montrose,Dumbarton,1,1,0,D
91832,1,SCO4,2002-03-02,Peterhead,East Fife,1,1,0,D
91833,1,SCO4,2002-03-02,Stirling Albion,Elgin City,3,1,2,W
91834,1,SCO4,2002-03-05,Albion Rovers,Queens Park,2,0,2,W
91835,1,SCO4,2002-03-05,Elgin City,East Stirling,2,2,0,D
91836,1,SCO4,2002-03-05,Montrose,Brechin City,0,0,0,D
91837,1,SCO4,2002-03-06,Stirling Albion,East Fife,0,1,-1,L
91838,1,SCO4,2002-03-09,Brechin City,Montrose,2,0,2,W
91839,1,SCO4,2002-03-09,Dumbarton,East Stirling,2,1,1,W
91840,1,SCO4,2002-03-09,East Fife,Stirling Albion,1,1,0,D
91841,1,SCO4,2002-03-09,Queens Park,Albion Rovers,0,3,-3,L
91842,1,SCO4,2002-03-12,Brechin City,Stirling Albion,3,1,2,W
91843,1,SCO4,2002-03-16,Albion Rovers,Dumbarton,1,1,0,D
91844,1,SCO4,2002-03-16,Brechin City,Queens Park,5,0,5,W
91845,1,SCO4,2002-03-16,East Fife,Elgin City,0,1,-1,L
91846,1,SCO4,2002-03-16,Peterhead,East Stirling,2,1,1,W
91847,1,SCO4,2002-03-16,Stirling Albion,Montrose,0,1,-1,L
91848,1,SCO4,2002-03-19,Elgin City,Peterhead,0,3,-3,L
91849,1,SCO4,2002-03-19,Queens Park,Dumbarton,0,2,-2,L
91850,1,SCO4,2002-03-19,Stirling Albion,Brechin City,1,3,-2,L
91851,1,SCO4,2002-03-23,Dumbarton,Stirling Albion,2,0,2,W
91852,1,SCO4,2002-03-23,East Stirling,Albion Rovers,1,2,-1,L
91853,1,SCO4,2002-03-23,Elgin City,Brechin City,3,1,2,W
91854,1,SCO4,2002-03-23,Montrose,East Fife,0,1,-1,L
91855,1,SCO4,2002-03-23,Peterhead,Queens Park,1,2,-1,L
91856,1,SCO4,2002-03-26,Elgin City,Albion Rovers,0,0,0,D
91857,1,SCO4,2002-03-30,Albion Rovers,Montrose,0,0,0,D
91858,1,SCO4,2002-03-30,Brechin City,Peterhead,1,1,0,D
91859,1,SCO4,2002-03-30,East Fife,Queens Park,0,3,-3,L
91860,1,SCO4,2002-03-30,Elgin City,Dumbarton,2,0,2,W
91861,1,SCO4,2002-03-30,Stirling Albion,East Stirling,1,0,1,W
91862,1,SCO4,2002-04-02,East Stirling,Dumbarton,1,0,1,W
91863,1,SCO4,2002-04-06,Dumbarton,East Fife,2,0,2,W
91864,1,SCO4,2002-04-06,East Stirling,Brechin City,2,0,2,W
91865,1,SCO4,2002-04-06,Montrose,Elgin City,1,0,1,W
91866,1,SCO4,2002-04-06,Peterhead,Albion Rovers,0,2,-2,L
91867,1,SCO4,2002-04-06,Queens Park,Stirling Albion,0,0,0,D
91868,1,SCO4,2002-04-09,East Stirling,Peterhead,1,0,1,W
91869,1,SCO4,2002-04-13,Albion Rovers,East Fife,2,1,1,W
91870,1,SCO4,2002-04-13,Brechin City,Dumbarton,0,1,-1,L
91871,1,SCO4,2002-04-13,East Stirling,Elgin City,0,3,-3,L
91872,1,SCO4,2002-04-13,Peterhead,Stirling Albion,5,1,4,W
91873,1,SCO4,2002-04-13,Queens Park,Montrose,0,1,-1,L
91874,1,SCO4,2002-04-16,East Stirling,East Fife,2,1,1,W
91875,1,SCO4,2002-04-20,Dumbarton,Peterhead,3,0,3,W
91876,1,SCO4,2002-04-20,East Fife,Brechin City,1,1,0,D
91877,1,SCO4,2002-04-20,Elgin City,Queens Park,0,1,-1,L
91878,1,SCO4,2002-04-20,Montrose,East Stirling,2,0,2,W
91879,1,SCO4,2002-04-20,Stirling Albion,Albion Rovers,0,3,-3,L
91880,1,SCO4,2002-04-27,Albion Rovers,Elgin City,2,2,0,D
91881,1,SCO4,2002-04-27,Brechin City,Stirling Albion,2,1,1,W
91882,1,SCO4,2002-04-27,Dumbarton,Queens Park,1,1,0,D
91883,1,SCO4,2002-04-27,East Stirling,East Fife,1,2,-1,L
91884,1,SCO4,2002-04-27,Peterhead,Montrose,3,1,2,W
91885,2,SCO4,2002-08-03,East Stirling,Montrose,1,1,0,D
91886,2,SCO4,2002-08-03,Gretna,Greenock Morton,1,1,0,D
91887,2,SCO4,2002-08-03,Peterhead,East Fife,0,2,-2,L
91888,2,SCO4,2002-08-03,Queens Park,Elgin City,1,2,-1,L
91889,2,SCO4,2002-08-03,Stirling Albion,Albion Rovers,0,1,-1,L
91890,2,SCO4,2002-08-10,Albion Rovers,Peterhead,3,0,3,W
91891,2,SCO4,2002-08-10,East Fife,East Stirling,4,1,3,W
91892,2,SCO4,2002-08-10,Elgin City,Gretna,0,2,-2,L
91893,2,SCO4,2002-08-10,Montrose,Queens Park,1,0,1,W
91894,2,SCO4,2002-08-10,Greenock Morton,Stirling Albion,5,1,4,W
91895,2,SCO4,2002-08-17,East Stirling,Albion Rovers,0,3,-3,L
91896,2,SCO4,2002-08-17,Gretna,Montrose,4,1,3,W
91897,2,SCO4,2002-08-17,Peterhead,Greenock Morton,4,2,2,W
91898,2,SCO4,2002-08-17,Queens Park,East Fife,0,0,0,D
91899,2,SCO4,2002-08-17,Stirling Albion,Elgin City,1,1,0,D
91900,2,SCO4,2002-08-24,East Fife,Montrose,2,0,2,W
91901,2,SCO4,2002-08-24,Elgin City,Peterhead,3,0,3,W
91902,2,SCO4,2002-08-24,Gretna,Albion Rovers,2,0,2,W
91903,2,SCO4,2002-08-24,Greenock Morton,Queens Park,3,0,3,W
91904,2,SCO4,2002-08-24,Stirling Albion,East Stirling,3,0,3,W
91905,2,SCO4,2002-08-31,Albion Rovers,East Fife,1,5,-4,L
91906,2,SCO4,2002-08-31,East Stirling,Greenock Morton,1,1,0,D
91907,2,SCO4,2002-08-31,Montrose,Elgin City,1,0,1,W
91908,2,SCO4,2002-08-31,Peterhead,Stirling Albion,1,0,1,W
91909,2,SCO4,2002-08-31,Queens Park,Gretna,1,0,1,W
91910,2,SCO4,2002-09-14,Elgin City,East Fife,1,1,0,D
91911,2,SCO4,2002-09-14,Gretna,Peterhead,1,4,-3,L
91912,2,SCO4,2002-09-14,Greenock Morton,Albion Rovers,0,1,-1,L
91913,2,SCO4,2002-09-14,Queens Park,East Stirling,0,2,-2,L
91914,2,SCO4,2002-09-14,Stirling Albion,Montrose,1,1,0,D
91915,2,SCO4,2002-09-21,Albion Rovers,Elgin City,1,1,0,D
91916,2,SCO4,2002-09-21,East Fife,Stirling Albion,1,1,0,D
91917,2,SCO4,2002-09-21,East Stirling,Gretna,0,4,-4,L
91918,2,SCO4,2002-09-21,Montrose,Greenock Morton,2,5,-3,L
91919,2,SCO4,2002-09-21,Peterhead,Queens Park,3,0,3,W
91920,2,SCO4,2002-09-28,East Stirling,Elgin City,1,2,-1,L
91921,2,SCO4,2002-09-28,Gretna,Stirling Albion,0,2,-2,L
91922,2,SCO4,2002-09-28,Montrose,Peterhead,0,3,-3,L
91923,2,SCO4,2002-09-28,Greenock Morton,East Fife,2,1,1,W
91924,2,SCO4,2002-09-28,Queens Park,Albion Rovers,2,4,-2,L
91925,2,SCO4,2002-10-05,Albion Rovers,Montrose,1,1,0,D
91926,2,SCO4,2002-10-05,East Fife,Gretna,3,2,1,W
91927,2,SCO4,2002-10-05,Elgin City,Greenock Morton,0,1,-1,L
91928,2,SCO4,2002-10-05,Peterhead,East Stirling,5,0,5,W
91929,2,SCO4,2002-10-05,Stirling Albion,Queens Park,1,0,1,W
91930,2,SCO4,2002-10-19,East Stirling,East Fife,1,4,-3,L
91931,2,SCO4,2002-10-19,Gretna,Elgin City,0,0,0,D
91932,2,SCO4,2002-10-19,Peterhead,Albion Rovers,2,0,2,W
91933,2,SCO4,2002-10-19,Queens Park,Montrose,0,1,-1,L
91934,2,SCO4,2002-10-19,Stirling Albion,Greenock Morton,2,0,2,W
91935,2,SCO4,2002-10-26,Albion Rovers,Stirling Albion,1,3,-2,L
91936,2,SCO4,2002-10-26,East Fife,Peterhead,3,3,0,D
91937,2,SCO4,2002-10-26,Elgin City,Queens Park,2,2,0,D
91938,2,SCO4,2002-10-26,Montrose,East Stirling,2,2,0,D
91939,2,SCO4,2002-10-26,Greenock Morton,Gretna,2,2,0,D
91940,2,SCO4,2002-11-02,East Fife,Albion Rovers,0,4,-4,L
91941,2,SCO4,2002-11-02,Elgin City,Montrose,0,0,0,D
91942,2,SCO4,2002-11-02,Gretna,Queens Park,2,2,0,D
91943,2,SCO4,2002-11-02,Greenock Morton,East Stirling,4,1,3,W
91944,2,SCO4,2002-11-02,Stirling Albion,Peterhead,1,0,1,W
91945,2,SCO4,2002-11-09,Albion Rovers,Gretna,2,1,1,W
91946,2,SCO4,2002-11-09,East Stirling,Stirling Albion,1,1,0,D
91947,2,SCO4,2002-11-09,Montrose,East Fife,0,5,-5,L
91948,2,SCO4,2002-11-09,Peterhead,Elgin City,2,2,0,D
91949,2,SCO4,2002-11-09,Queens Park,Greenock Morton,1,1,0,D
91950,2,SCO4,2002-11-16,Albion Rovers,Greenock Morton,2,1,1,W
91951,2,SCO4,2002-11-16,East Fife,Elgin City,4,0,4,W
91952,2,SCO4,2002-11-16,East Stirling,Queens Park,0,4,-4,L
91953,2,SCO4,2002-11-16,Montrose,Stirling Albion,1,1,0,D
91954,2,SCO4,2002-11-16,Peterhead,Gretna,1,1,0,D
91955,2,SCO4,2002-11-23,Albion Rovers,Elgin City,1,1,0,D
91956,2,SCO4,2002-11-23,Gretna,East Stirling,2,2,0,D
91957,2,SCO4,2002-11-23,Greenock Morton,Montrose,4,2,2,W
91958,2,SCO4,2002-11-23,Queens Park,Peterhead,2,0,2,W
91959,2,SCO4,2002-11-23,Stirling Albion,East Fife,0,0,0,D
91960,2,SCO4,2002-11-30,East Stirling,Peterhead,1,4,-3,L
91961,2,SCO4,2002-11-30,Gretna,East Fife,2,3,-1,L
91962,2,SCO4,2002-11-30,Montrose,Albion Rovers,0,1,-1,L
91963,2,SCO4,2002-11-30,Greenock Morton,Elgin City,4,0,4,W
91964,2,SCO4,2002-11-30,Queens Park,Stirling Albion,0,1,-1,L
91965,2,SCO4,2002-12-07,Elgin City,Peterhead,0,4,-4,L
91966,2,SCO4,2002-12-07,Gretna,Albion Rovers,1,2,-1,L
91967,2,SCO4,2002-12-07,Greenock Morton,Queens Park,1,1,0,D
91968,2,SCO4,2002-12-14,Albion Rovers,Queens Park,0,2,-2,L
91969,2,SCO4,2002-12-14,East Fife,Greenock Morton,1,4,-3,L
91970,2,SCO4,2002-12-14,Peterhead,Montrose,4,2,2,W
91971,2,SCO4,2002-12-14,Stirling Albion,Gretna,0,1,-1,L
91972,2,SCO4,2002-12-17,Elgin City,East Stirling,3,1,2,W
91973,2,SCO4,2002-12-21,Peterhead,East Fife,2,2,0,D
91974,2,SCO4,2002-12-21,Queens Park,Elgin City,3,2,1,W
91975,2,SCO4,2002-12-28,Albion Rovers,East Stirling,6,0,6,W
91976,2,SCO4,2002-12-28,East Fife,Queens Park,1,1,0,D
91977,2,SCO4,2002-12-28,Elgin City,Stirling Albion,0,3,-3,L
91978,2,SCO4,2002-12-28,Montrose,Gretna,0,2,-2,L
91979,2,SCO4,2002-12-28,Greenock Morton,Peterhead,1,0,1,W
91980,2,SCO4,2003-01-01,East Fife,Montrose,2,0,2,W
91981,2,SCO4,2003-01-01,Stirling Albion,East Stirling,2,1,1,W
91982,2,SCO4,2003-01-11,Queens Park,Gretna,1,2,-1,L
91983,2,SCO4,2003-01-18,Elgin City,East Fife,0,1,-1,L
91984,2,SCO4,2003-01-18,Gretna,Peterhead,1,1,0,D
91985,2,SCO4,2003-01-18,Greenock Morton,Albion Rovers,2,1,1,W
91986,2,SCO4,2003-01-18,Queens Park,East Stirling,3,4,-1,L
91987,2,SCO4,2003-01-18,Stirling Albion,Montrose,1,1,0,D
91988,2,SCO4,2003-01-25,Albion Rovers,East Fife,0,0,0,D
91989,2,SCO4,2003-01-25,Montrose,Elgin City,2,0,2,W
91990,2,SCO4,2003-02-08,East Stirling,Elgin City,2,2,0,D
91991,2,SCO4,2003-02-08,Gretna,Stirling Albion,0,0,0,D
91992,2,SCO4,2003-02-08,Montrose,Peterhead,1,2,-1,L
91993,2,SCO4,2003-02-08,Greenock Morton,East Fife,1,1,0,D
91994,2,SCO4,2003-02-08,Queens Park,Albion Rovers,1,1,0,D
91995,2,SCO4,2003-02-11,East Fife,Stirling Albion,2,1,1,W
91996,2,SCO4,2003-02-12,East Stirling,Greenock Morton,0,1,-1,L
91997,2,SCO4,2003-02-15,Elgin City,Greenock Morton,0,0,0,D
91998,2,SCO4,2003-02-15,Peterhead,East Stirling,6,0,6,W
91999,2,SCO4,2003-02-22,East Fife,East Stirling,3,0,3,W
92000,2,SCO4,2003-02-22,Elgin City,Gretna,2,2,0,D
92001,2,SCO4,2003-02-22,Montrose,Queens Park,1,1,0,D
92002,2,SCO4,2003-02-25,Montrose,Greenock Morton,0,0,0,D
92003,2,SCO4,2003-02-26,East Stirling,Gretna,1,2,-1,L
92004,2,SCO4,2003-02-26,Stirling Albion,Albion Rovers,3,4,-1,L
92005,2,SCO4,2003-03-01,East Stirling,Albion Rovers,0,4,-4,L
92006,2,SCO4,2003-03-01,Gretna,Montrose,2,2,0,D
92007,2,SCO4,2003-03-01,Peterhead,Greenock Morton,3,1,2,W
92008,2,SCO4,2003-03-01,Queens Park,East Fife,1,2,-1,L
92009,2,SCO4,2003-03-01,Stirling Albion,Elgin City,4,0,4,W
92010,2,SCO4,2003-03-04,Albion Rovers,Montrose,3,0,3,W
92011,2,SCO4,2003-03-04,East Fife,Gretna,2,1,1,W
92012,2,SCO4,2003-03-04,Peterhead,Stirling Albion,6,0,6,W
92013,2,SCO4,2003-03-08,Albion Rovers,Gretna,1,1,0,D
92014,2,SCO4,2003-03-08,East Stirling,Stirling Albion,1,3,-2,L
92015,2,SCO4,2003-03-08,Montrose,East Fife,0,2,-2,L
92016,2,SCO4,2003-03-08,Peterhead,Elgin City,3,2,1,W
92017,2,SCO4,2003-03-08,Queens Park,Greenock Morton,0,1,-1,L
92018,2,SCO4,2003-03-11,Albion Rovers,Peterhead,0,0,0,D
92019,2,SCO4,2003-03-11,Greenock Morton,Stirling Albion,2,2,0,D
92020,2,SCO4,2003-03-12,East Stirling,Montrose,0,3,-3,L
92021,2,SCO4,2003-03-15,East Fife,Albion Rovers,1,1,0,D
92022,2,SCO4,2003-03-15,Elgin City,Montrose,0,2,-2,L
92023,2,SCO4,2003-03-15,Gretna,Queens Park,0,1,-1,L
92024,2,SCO4,2003-03-15,Greenock Morton,East Stirling,2,1,1,W
92025,2,SCO4,2003-03-15,Stirling Albion,Peterhead,2,1,1,W
92026,2,SCO4,2003-03-19,Stirling Albion,Queens Park,1,0,1,W
92027,2,SCO4,2003-03-22,Elgin City,Albion Rovers,0,1,-1,L
92028,2,SCO4,2003-03-22,Gretna,East Stirling,3,1,2,W
92029,2,SCO4,2003-03-22,Greenock Morton,Montrose,1,0,1,W
92030,2,SCO4,2003-03-22,Queens Park,Peterhead,1,2,-1,L
92031,2,SCO4,2003-03-22,Stirling Albion,East Fife,1,2,-1,L
92032,2,SCO4,2003-03-29,Elgin City,Albion Rovers,1,2,-1,L
92033,2,SCO4,2003-03-29,Gretna,Greenock Morton,0,1,-1,L
92034,2,SCO4,2003-03-29,Peterhead,Queens Park,3,1,2,W
92035,2,SCO4,2003-04-05,Albion Rovers,Greenock Morton,2,1,1,W
92036,2,SCO4,2003-04-05,East Fife,Elgin City,5,0,5,W
92037,2,SCO4,2003-04-05,East Stirling,Queens Park,0,2,-2,L
92038,2,SCO4,2003-04-05,Montrose,Stirling Albion,0,1,-1,L
92039,2,SCO4,2003-04-05,Peterhead,Gretna,1,0,1,W
92040,2,SCO4,2003-04-12,East Stirling,Peterhead,1,1,0,D
92041,2,SCO4,2003-04-12,Gretna,East Fife,3,3,0,D
92042,2,SCO4,2003-04-12,Montrose,Albion Rovers,1,1,0,D
92043,2,SCO4,2003-04-12,Greenock Morton,Elgin City,2,0,2,W
92044,2,SCO4,2003-04-12,Queens Park,Stirling Albion,3,3,0,D
92045,2,SCO4,2003-04-19,Albion Rovers,Queens Park,2,1,1,W
92046,2,SCO4,2003-04-19,East Fife,Greenock Morton,0,1,-1,L
92047,2,SCO4,2003-04-19,Elgin City,East Stirling,3,0,3,W
92048,2,SCO4,2003-04-19,Peterhead,Montrose,3,0,3,W
92049,2,SCO4,2003-04-19,Stirling Albion,Gretna,1,0,1,W
92050,2,SCO4,2003-04-26,Albion Rovers,Stirling Albion,2,1,1,W
92051,2,SCO4,2003-04-26,East Fife,Peterhead,0,2,-2,L
92052,2,SCO4,2003-04-26,Elgin City,Queens Park,0,0,0,D
92053,2,SCO4,2003-04-26,Montrose,East Stirling,5,4,1,W
92054,2,SCO4,2003-04-26,Greenock Morton,Gretna,5,0,5,W
92055,2,SCO4,2003-05-03,East Stirling,East Fife,0,4,-4,L
92056,2,SCO4,2003-05-03,Gretna,Elgin City,2,1,1,W
92057,2,SCO4,2003-05-03,Peterhead,Albion Rovers,0,0,0,D
92058,2,SCO4,2003-05-03,Queens Park,Montrose,1,1,0,D
92059,2,SCO4,2003-05-03,Stirling Albion,Greenock Morton,0,3,-3,L
92060,2,SCO4,2003-05-10,Albion Rovers,East Stirling,3,1,2,W
92061,2,SCO4,2003-05-10,East Fife,Queens Park,1,0,1,W
92062,2,SCO4,2003-05-10,Elgin City,Stirling Albion,2,2,0,D
92063,2,SCO4,2003-05-10,Montrose,Gretna,0,1,-1,L
92064,2,SCO4,2003-05-10,Greenock Morton,Peterhead,1,0,1,W
92065,3,SCO4,2003-08-09,Albion Rovers,Stranraer,1,1,0,D
92066,3,SCO4,2003-08-09,Elgin City,East Stirling,3,1,2,W
92067,3,SCO4,2003-08-09,Gretna,Queens Park,1,1,0,D
92068,3,SCO4,2003-08-09,Montrose,Peterhead,0,1,-1,L
92069,3,SCO4,2003-08-09,Stirling Albion,Cowdenbeath,0,0,0,D
92070,3,SCO4,2003-08-16,Cowdenbeath,Albion Rovers,1,4,-3,L
92071,3,SCO4,2003-08-16,East Stirling,Montrose,1,1,0,D
92072,3,SCO4,2003-08-16,Peterhead,Gretna,2,0,2,W
92073,3,SCO4,2003-08-16,Queens Park,Elgin City,5,2,3,W
92074,3,SCO4,2003-08-16,Stranraer,Stirling Albion,0,1,-1,L
92075,3,SCO4,2003-08-23,Albion Rovers,Queens Park,3,1,2,W
92076,3,SCO4,2003-08-23,Elgin City,Peterhead,2,3,-1,L
92077,3,SCO4,2003-08-23,Gretna,Stranraer,1,1,0,D
92078,3,SCO4,2003-08-23,Montrose,Cowdenbeath,1,3,-2,L
92079,3,SCO4,2003-08-23,Stirling Albion,East Stirling,5,1,4,W
92080,3,SCO4,2003-08-30,East Stirling,Cowdenbeath,1,1,0,D
92081,3,SCO4,2003-08-30,Gretna,Albion Rovers,3,1,2,W
92082,3,SCO4,2003-08-30,Montrose,Elgin City,3,3,0,D
92083,3,SCO4,2003-08-30,Peterhead,Stranraer,1,2,-1,L
92084,3,SCO4,2003-08-30,Queens Park,Stirling Albion,0,2,-2,L
92085,3,SCO4,2003-09-06,Albion Rovers,Elgin City,1,2,-1,L
92086,3,SCO4,2003-09-13,Albion Rovers,Montrose,0,1,-1,L
92087,3,SCO4,2003-09-13,Cowdenbeath,Queens Park,0,1,-1,L
92088,3,SCO4,2003-09-13,Elgin City,Gretna,3,3,0,D
92089,3,SCO4,2003-09-13,Stirling Albion,Peterhead,3,1,2,W
92090,3,SCO4,2003-09-13,Stranraer,East Stirling,4,0,4,W
92091,3,SCO4,2003-09-20,Cowdenbeath,Gretna,0,1,-1,L
92092,3,SCO4,2003-09-20,Peterhead,East Stirling,2,0,2,W
92093,3,SCO4,2003-09-20,Queens Park,Montrose,1,1,0,D
92094,3,SCO4,2003-09-20,Stirling Albion,Albion Rovers,2,1,1,W
92095,3,SCO4,2003-09-20,Stranraer,Elgin City,4,3,1,W
92096,3,SCO4,2003-09-27,Albion Rovers,Peterhead,2,0,2,W
92097,3,SCO4,2003-09-27,East Stirling,Queens Park,1,2,-1,L
92098,3,SCO4,2003-09-27,Elgin City,Cowdenbeath,0,4,-4,L
92099,3,SCO4,2003-09-27,Gretna,Stirling Albion,0,1,-1,L
92100,3,SCO4,2003-09-27,Montrose,Stranraer,2,4,-2,L
92101,3,SCO4,2003-10-04,Albion Rovers,East Stirling,5,0,5,W
92102,3,SCO4,2003-10-04,Cowdenbeath,Stranraer,0,1,-1,L
92103,3,SCO4,2003-10-04,Gretna,Montrose,1,1,0,D
92104,3,SCO4,2003-10-04,Queens Park,Peterhead,0,2,-2,L
92105,3,SCO4,2003-10-04,Stirling Albion,Elgin City,3,0,3,W
92106,3,SCO4,2003-10-11,Stirling Albion,Montrose,3,0,3,W
92107,3,SCO4,2003-10-18,East Stirling,Gretna,0,1,-1,L
92108,3,SCO4,2003-10-18,Elgin City,Albion Rovers,1,5,-4,L
92109,3,SCO4,2003-10-18,Montrose,Stirling Albion,2,3,-1,L
92110,3,SCO4,2003-10-18,Peterhead,Cowdenbeath,0,1,-1,L
92111,3,SCO4,2003-10-18,Stranraer,Queens Park,1,0,1,W
92112,3,SCO4,2003-10-25,Albion Rovers,Cowdenbeath,1,2,-1,L
92113,3,SCO4,2003-10-25,Elgin City,Queens Park,2,2,0,D
92114,3,SCO4,2003-10-25,Gretna,Peterhead,3,2,1,W
92115,3,SCO4,2003-10-25,Montrose,East Stirling,5,1,4,W
92116,3,SCO4,2003-10-25,Stirling Albion,Stranraer,1,0,1,W
92117,3,SCO4,2003-11-01,Cowdenbeath,Stirling Albion,2,0,2,W
92118,3,SCO4,2003-11-01,East Stirling,Elgin City,3,1,2,W
92119,3,SCO4,2003-11-01,Peterhead,Montrose,0,0,0,D
92120,3,SCO4,2003-11-01,Queens Park,Gretna,0,1,-1,L
92121,3,SCO4,2003-11-01,Stranraer,Albion Rovers,5,0,5,W
92122,3,SCO4,2003-11-08,East Stirling,Stranraer,1,4,-3,L
92123,3,SCO4,2003-11-08,Gretna,Elgin City,2,2,0,D
92124,3,SCO4,2003-11-08,Montrose,Albion Rovers,1,0,1,W
92125,3,SCO4,2003-11-08,Peterhead,Stirling Albion,2,2,0,D
92126,3,SCO4,2003-11-08,Queens Park,Cowdenbeath,0,0,0,D
92127,3,SCO4,2003-11-14,Albion Rovers,Gretna,1,3,-2,L
92128,3,SCO4,2003-11-14,Cowdenbeath,East Stirling,2,1,1,W
92129,3,SCO4,2003-11-15,Elgin City,Montrose,2,3,-1,L
92130,3,SCO4,2003-11-15,Stirling Albion,Queens Park,1,0,1,W
92131,3,SCO4,2003-11-15,Stranraer,Peterhead,0,2,-2,L
92132,3,SCO4,2003-11-29,East Stirling,Peterhead,1,3,-2,L
92133,3,SCO4,2003-11-29,Elgin City,Stranraer,1,3,-2,L
92134,3,SCO4,2003-12-02,Albion Rovers,Stirling Albion,0,3,-3,L
92135,3,SCO4,2003-12-02,Gretna,Cowdenbeath,1,0,1,W
92136,3,SCO4,2003-12-02,Montrose,Queens Park,0,0,0,D
92137,3,SCO4,2003-12-06,Cowdenbeath,Elgin City,3,2,1,W
92138,3,SCO4,2003-12-06,Peterhead,Albion Rovers,2,1,1,W
92139,3,SCO4,2003-12-06,Queens Park,East Stirling,3,0,3,W
92140,3,SCO4,2003-12-06,Stirling Albion,Gretna,0,1,-1,L
92141,3,SCO4,2003-12-06,Stranraer,Montrose,2,0,2,W
92142,3,SCO4,2003-12-13,East Stirling,Albion Rovers,3,4,-1,L
92143,3,SCO4,2003-12-13,Elgin City,Stirling Albion,0,2,-2,L
92144,3,SCO4,2003-12-13,Montrose,Gretna,2,0,2,W
92145,3,SCO4,2003-12-13,Peterhead,Queens Park,4,1,3,W
92146,3,SCO4,2003-12-13,Stranraer,Cowdenbeath,2,0,2,W
92147,3,SCO4,2003-12-27,Cowdenbeath,Peterhead,2,0,2,W
92148,3,SCO4,2003-12-27,Gretna,East Stirling,2,1,1,W
92149,3,SCO4,2004-01-03,Cowdenbeath,Montrose,3,3,0,D
92150,3,SCO4,2004-01-03,Peterhead,Elgin City,5,1,4,W
92151,3,SCO4,2004-01-03,Queens Park,Albion Rovers,1,1,0,D
92152,3,SCO4,2004-01-03,Stranraer,Gretna,1,2,-1,L
92153,3,SCO4,2004-01-10,East Stirling,Stirling Albion,2,4,-2,L
92154,3,SCO4,2004-01-10,Queens Park,Stranraer,0,4,-4,L
92155,3,SCO4,2004-01-17,Elgin City,East Stirling,3,0,3,W
92156,3,SCO4,2004-01-17,Gretna,Queens Park,0,1,-1,L
92157,3,SCO4,2004-01-17,Montrose,Peterhead,2,1,1,W
92158,3,SCO4,2004-01-17,Stirling Albion,Cowdenbeath,1,1,0,D
92159,3,SCO4,2004-01-24,Cowdenbeath,Gretna,1,2,-1,L
92160,3,SCO4,2004-01-24,Peterhead,East Stirling,6,0,6,W
92161,3,SCO4,2004-01-24,Queens Park,Montrose,1,1,0,D
92162,3,SCO4,2004-01-24,Stirling Albion,Albion Rovers,3,0,3,W
92163,3,SCO4,2004-01-24,Stranraer,Elgin City,6,0,6,W
92164,3,SCO4,2004-01-31,Montrose,Stranraer,1,4,-3,L
92165,3,SCO4,2004-02-07,Albion Rovers,Montrose,3,0,3,W
92166,3,SCO4,2004-02-07,Cowdenbeath,Queens Park,5,1,4,W
92167,3,SCO4,2004-02-07,Elgin City,Gretna,1,1,0,D
92168,3,SCO4,2004-02-07,Stirling Albion,Peterhead,0,2,-2,L
92169,3,SCO4,2004-02-07,Stranraer,East Stirling,7,1,6,W
92170,3,SCO4,2004-02-14,East Stirling,Cowdenbeath,0,1,-1,L
92171,3,SCO4,2004-02-14,Gretna,Albion Rovers,3,0,3,W
92172,3,SCO4,2004-02-14,Montrose,Elgin City,4,3,1,W
92173,3,SCO4,2004-02-14,Peterhead,Stranraer,2,0,2,W
92174,3,SCO4,2004-02-14,Queens Park,Stirling Albion,1,4,-3,L
92175,3,SCO4,2004-02-17,Albion Rovers,Stranraer,1,4,-3,L
92176,3,SCO4,2004-02-21,East Stirling,Gretna,2,4,-2,L
92177,3,SCO4,2004-02-21,Elgin City,Albion Rovers,1,2,-1,L
92178,3,SCO4,2004-02-21,Montrose,Stirling Albion,1,4,-3,L
92179,3,SCO4,2004-02-21,Peterhead,Cowdenbeath,0,0,0,D
92180,3,SCO4,2004-02-21,Stranraer,Queens Park,3,1,2,W
92181,3,SCO4,2004-02-28,Gretna,Montrose,1,2,-1,L
92182,3,SCO4,2004-02-28,Queens Park,Peterhead,1,0,1,W
92183,3,SCO4,2004-03-02,East Stirling,Queens Park,2,4,-2,L
92184,3,SCO4,2004-03-02,Gretna,Stirling Albion,1,0,1,W
92185,3,SCO4,2004-03-06,Cowdenbeath,Albion Rovers,1,1,0,D
92186,3,SCO4,2004-03-06,East Stirling,Montrose,1,4,-3,L
92187,3,SCO4,2004-03-06,Peterhead,Gretna,2,1,1,W
92188,3,SCO4,2004-03-06,Queens Park,Elgin City,4,0,4,W
92189,3,SCO4,2004-03-06,Stranraer,Stirling Albion,1,1,0,D
92190,3,SCO4,2004-03-09,Albion Rovers,East Stirling,5,1,4,W
92191,3,SCO4,2004-03-09,Cowdenbeath,Stranraer,1,2,-1,L
92192,3,SCO4,2004-03-10,Stirling Albion,Elgin City,6,1,5,W
92193,3,SCO4,2004-03-13,Albion Rovers,Queens Park,3,1,2,W
92194,3,SCO4,2004-03-13,Elgin City,Peterhead,1,0,1,W
92195,3,SCO4,2004-03-13,Gretna,Stranraer,0,0,0,D
92196,3,SCO4,2004-03-13,Montrose,Cowdenbeath,1,1,0,D
92197,3,SCO4,2004-03-13,Stirling Albion,East Stirling,6,0,6,W
92198,3,SCO4,2004-03-16,Albion Rovers,Peterhead,3,3,0,D
92199,3,SCO4,2004-03-16,Elgin City,Cowdenbeath,0,0,0,D
92200,3,SCO4,2004-03-20,Gretna,Elgin City,2,1,1,W
92201,3,SCO4,2004-03-20,Montrose,Albion Rovers,3,1,2,W
92202,3,SCO4,2004-03-20,Peterhead,Stirling Albion,0,0,0,D
92203,3,SCO4,2004-03-20,Queens Park,Cowdenbeath,1,2,-1,L
92204,3,SCO4,2004-03-24,East Stirling,Stranraer,1,2,-1,L
92205,3,SCO4,2004-03-27,Albion Rovers,Gretna,1,2,-1,L
92206,3,SCO4,2004-03-27,Cowdenbeath,East Stirling,2,0,2,W
92207,3,SCO4,2004-03-27,Elgin City,Montrose,2,1,1,W
92208,3,SCO4,2004-03-27,Stirling Albion,Queens Park,0,0,0,D
92209,3,SCO4,2004-03-27,Stranraer,Peterhead,1,1,0,D
92210,3,SCO4,2004-04-03,Cowdenbeath,Elgin City,2,0,2,W
92211,3,SCO4,2004-04-03,Peterhead,Albion Rovers,5,0,5,W
92212,3,SCO4,2004-04-03,Queens Park,East Stirling,1,0,1,W
92213,3,SCO4,2004-04-03,Stirling Albion,Gretna,0,1,-1,L
92214,3,SCO4,2004-04-03,Stranraer,Montrose,6,0,6,W
92215,3,SCO4,2004-04-10,Albion Rovers,Stirling Albion,3,5,-2,L
92216,3,SCO4,2004-04-10,East Stirling,Peterhead,0,3,-3,L
92217,3,SCO4,2004-04-10,Elgin City,Stranraer,0,0,0,D
92218,3,SCO4,2004-04-10,Gretna,Cowdenbeath,0,1,-1,L
92219,3,SCO4,2004-04-10,Montrose,Queens Park,1,1,0,D
92220,3,SCO4,2004-04-17,Albion Rovers,Elgin City,1,2,-1,L
92221,3,SCO4,2004-04-17,Cowdenbeath,Peterhead,0,3,-3,L
92222,3,SCO4,2004-04-17,Gretna,East Stirling,5,1,4,W
92223,3,SCO4,2004-04-17,Queens Park,Stranraer,0,2,-2,L
92224,3,SCO4,2004-04-17,Stirling Albion,Montrose,1,1,0,D
92225,3,SCO4,2004-04-24,East Stirling,Albion Rovers,1,8,-7,L
92226,3,SCO4,2004-04-24,Elgin City,Stirling Albion,0,1,-1,L
92227,3,SCO4,2004-04-24,Montrose,Gretna,1,4,-3,L
92228,3,SCO4,2004-04-24,Peterhead,Queens Park,1,1,0,D
92229,3,SCO4,2004-04-24,Stranraer,Cowdenbeath,1,0,1,W
92230,3,SCO4,2004-05-01,Cowdenbeath,Montrose,0,0,0,D
92231,3,SCO4,2004-05-01,East Stirling,Stirling Albion,0,3,-3,L
92232,3,SCO4,2004-05-01,Peterhead,Elgin City,3,1,2,W
92233,3,SCO4,2004-05-01,Queens Park,Albion Rovers,0,1,-1,L
92234,3,SCO4,2004-05-01,Stranraer,Gretna,3,2,1,W
92235,3,SCO4,2004-05-08,Albion Rovers,Cowdenbeath,2,4,-2,L
92236,3,SCO4,2004-05-08,Elgin City,Queens Park,1,3,-2,L
92237,3,SCO4,2004-05-08,Gretna,Peterhead,3,2,1,W
92238,3,SCO4,2004-05-08,Montrose,East Stirling,1,0,1,W
92239,3,SCO4,2004-05-08,Stirling Albion,Stranraer,2,2,0,D
92240,3,SCO4,2004-05-15,Cowdenbeath,Stirling Albion,0,5,-5,L
92241,3,SCO4,2004-05-15,East Stirling,Elgin City,2,1,1,W
92242,3,SCO4,2004-05-15,Peterhead,Montrose,1,2,-1,L
92243,3,SCO4,2004-05-15,Queens Park,Gretna,1,1,0,D
92244,3,SCO4,2004-05-15,Stranraer,Albion Rovers,4,0,4,W
92245,4,SCO4,2004-08-07,East Fife,Montrose,1,0,1,W
92246,4,SCO4,2004-08-07,Gretna,Albion Rovers,6,0,6,W
92247,4,SCO4,2004-08-07,Peterhead,East Stirling,5,0,5,W
92248,4,SCO4,2004-08-07,Queens Park,Cowdenbeath,3,2,1,W
92249,4,SCO4,2004-08-07,Stenhousemuir,Elgin City,0,2,-2,L
92250,4,SCO4,2004-08-14,Albion Rovers,East Fife,2,0,2,W
92251,4,SCO4,2004-08-14,Cowdenbeath,Stenhousemuir,0,6,-6,L
92252,4,SCO4,2004-08-14,East Stirling,Gretna,1,2,-1,L
92253,4,SCO4,2004-08-14,Elgin City,Queens Park,1,0,1,W
92254,4,SCO4,2004-08-14,Montrose,Peterhead,0,1,-1,L
92255,4,SCO4,2004-08-21,East Fife,Cowdenbeath,1,1,0,D
92256,4,SCO4,2004-08-21,Gretna,Montrose,1,0,1,W
92257,4,SCO4,2004-08-21,Peterhead,Elgin City,2,1,1,W
92258,4,SCO4,2004-08-21,Queens Park,Albion Rovers,1,1,0,D
92259,4,SCO4,2004-08-21,Stenhousemuir,East Stirling,6,0,6,W
92260,4,SCO4,2004-08-28,Albion Rovers,Peterhead,0,1,-1,L
92261,4,SCO4,2004-08-28,Cowdenbeath,East Stirling,2,1,1,W
92262,4,SCO4,2004-08-28,East Fife,Stenhousemuir,0,0,0,D
92263,4,SCO4,2004-08-28,Elgin City,Montrose,1,3,-2,L
92264,4,SCO4,2004-08-28,Queens Park,Gretna,3,2,1,W
92265,4,SCO4,2004-09-04,East Stirling,Elgin City,0,1,-1,L
92266,4,SCO4,2004-09-04,Gretna,Cowdenbeath,2,1,1,W
92267,4,SCO4,2004-09-04,Montrose,Albion Rovers,1,1,0,D
92268,4,SCO4,2004-09-04,Peterhead,East Fife,2,0,2,W
92269,4,SCO4,2004-09-04,Stenhousemuir,Queens Park,1,1,0,D
92270,4,SCO4,2004-09-11,Albion Rovers,Stenhousemuir,1,0,1,W
92271,4,SCO4,2004-09-11,Cowdenbeath,Elgin City,3,1,2,W
92272,4,SCO4,2004-09-11,East Fife,East Stirling,1,0,1,W
92273,4,SCO4,2004-09-11,Peterhead,Gretna,1,1,0,D
92274,4,SCO4,2004-09-11,Queens Park,Montrose,1,2,-1,L
92275,4,SCO4,2004-09-18,East Stirling,Queens Park,0,5,-5,L
92276,4,SCO4,2004-09-18,Elgin City,Albion Rovers,1,0,1,W
92277,4,SCO4,2004-09-18,Gretna,East Fife,5,1,4,W
92278,4,SCO4,2004-09-18,Montrose,Cowdenbeath,3,1,2,W
92279,4,SCO4,2004-09-18,Stenhousemuir,Peterhead,1,2,-1,L
92280,4,SCO4,2004-09-25,Albion Rovers,East Stirling,3,3,0,D
92281,4,SCO4,2004-09-25,East Fife,Queens Park,1,4,-3,L
92282,4,SCO4,2004-09-25,Gretna,Elgin City,3,0,3,W
92283,4,SCO4,2004-09-25,Montrose,Stenhousemuir,0,2,-2,L
92284,4,SCO4,2004-09-25,Peterhead,Cowdenbeath,3,1,2,W
92285,4,SCO4,2004-10-02,Cowdenbeath,Albion Rovers,2,0,2,W
92286,4,SCO4,2004-10-02,East Stirling,Montrose,1,1,0,D
92287,4,SCO4,2004-10-02,Elgin City,East Fife,2,1,1,W
92288,4,SCO4,2004-10-02,Queens Park,Peterhead,1,2,-1,L
92289,4,SCO4,2004-10-02,Stenhousemuir,Gretna,0,3,-3,L
92290,4,SCO4,2004-10-16,East Fife,Albion Rovers,1,0,1,W
92291,4,SCO4,2004-10-16,Gretna,East Stirling,8,1,7,W
92292,4,SCO4,2004-10-16,Peterhead,Montrose,3,2,1,W
92293,4,SCO4,2004-10-16,Queens Park,Elgin City,0,1,-1,L
92294,4,SCO4,2004-10-16,Stenhousemuir,Cowdenbeath,2,2,0,D
92295,4,SCO4,2004-10-23,Albion Rovers,Gretna,2,6,-4,L
92296,4,SCO4,2004-10-23,Cowdenbeath,Queens Park,2,1,1,W
92297,4,SCO4,2004-10-23,East Stirling,Peterhead,1,2,-1,L
92298,4,SCO4,2004-10-23,Elgin City,Stenhousemuir,1,1,0,D
92299,4,SCO4,2004-10-23,Montrose,East Fife,2,1,1,W
92300,4,SCO4,2004-10-30,East Stirling,Cowdenbeath,0,2,-2,L
92301,4,SCO4,2004-10-30,Gretna,Queens Park,4,1,3,W
92302,4,SCO4,2004-10-30,Montrose,Elgin City,2,0,2,W
92303,4,SCO4,2004-10-30,Peterhead,Albion Rovers,4,1,3,W
92304,4,SCO4,2004-10-30,Stenhousemuir,East Fife,5,2,3,W
92305,4,SCO4,2004-11-06,Albion Rovers,Montrose,1,2,-1,L
92306,4,SCO4,2004-11-06,Cowdenbeath,Gretna,0,8,-8,L
92307,4,SCO4,2004-11-06,East Fife,Peterhead,0,2,-2,L
92308,4,SCO4,2004-11-06,Elgin City,East Stirling,1,3,-2,L
92309,4,SCO4,2004-11-06,Queens Park,Stenhousemuir,4,3,1,W
92310,4,SCO4,2004-11-13,East Stirling,East Fife,1,1,0,D
92311,4,SCO4,2004-11-13,Elgin City,Cowdenbeath,0,4,-4,L
92312,4,SCO4,2004-11-13,Gretna,Peterhead,2,1,1,W
92313,4,SCO4,2004-11-13,Montrose,Queens Park,2,4,-2,L
92314,4,SCO4,2004-11-13,Stenhousemuir,Albion Rovers,3,0,3,W
92315,4,SCO4,2004-11-20,Gretna,Albion Rovers,6,2,4,W
92316,4,SCO4,2004-11-27,Albion Rovers,Elgin City,2,2,0,D
92317,4,SCO4,2004-11-27,East Fife,Gretna,1,3,-2,L
92318,4,SCO4,2004-11-27,Queens Park,East Stirling,0,0,0,D
92319,4,SCO4,2004-11-30,Cowdenbeath,Montrose,0,0,0,D
92320,4,SCO4,2004-11-30,Peterhead,Stenhousemuir,5,0,5,W
92321,4,SCO4,2004-12-04,Cowdenbeath,Peterhead,0,4,-4,L
92322,4,SCO4,2004-12-04,East Stirling,Albion Rovers,1,1,0,D
92323,4,SCO4,2004-12-04,Elgin City,Gretna,1,3,-2,L
92324,4,SCO4,2004-12-04,Queens Park,East Fife,1,2,-1,L
92325,4,SCO4,2004-12-04,Stenhousemuir,Montrose,1,1,0,D
92326,4,SCO4,2004-12-18,Albion Rovers,Cowdenbeath,2,3,-1,L
92327,4,SCO4,2004-12-18,Gretna,Stenhousemuir,3,0,3,W
92328,4,SCO4,2004-12-18,Peterhead,Queens Park,2,2,0,D
92329,4,SCO4,2004-12-27,East Fife,Montrose,1,0,1,W
92330,4,SCO4,2004-12-27,Peterhead,East Stirling,3,0,3,W
92331,4,SCO4,2004-12-27,Queens Park,Cowdenbeath,2,3,-1,L
92332,4,SCO4,2004-12-27,Stenhousemuir,Elgin City,4,0,4,W
92333,4,SCO4,2005-01-01,Cowdenbeath,East Fife,1,1,0,D
92334,4,SCO4,2005-01-01,Montrose,Gretna,2,3,-1,L
92335,4,SCO4,2005-01-03,Albion Rovers,Peterhead,0,4,-4,L
92336,4,SCO4,2005-01-03,East Fife,Stenhousemuir,2,0,2,W
92337,4,SCO4,2005-01-03,Elgin City,Montrose,2,2,0,D
92338,4,SCO4,2005-01-03,Queens Park,Gretna,1,1,0,D
92339,4,SCO4,2005-01-08,Cowdenbeath,East Stirling,3,2,1,W
92340,4,SCO4,2005-01-15,East Stirling,Elgin City,0,3,-3,L
92341,4,SCO4,2005-01-15,Gretna,Cowdenbeath,2,0,2,W
92342,4,SCO4,2005-01-15,Montrose,Albion Rovers,0,1,-1,L
92343,4,SCO4,2005-01-15,Peterhead,East Fife,0,0,0,D
92344,4,SCO4,2005-01-15,Stenhousemuir,Queens Park,0,0,0,D
92345,4,SCO4,2005-01-22,Peterhead,Gretna,4,2,2,W
92346,4,SCO4,2005-01-22,Queens Park,Montrose,1,0,1,W
92347,4,SCO4,2005-01-29,East Stirling,Queens Park,3,1,2,W
92348,4,SCO4,2005-01-29,Elgin City,Albion Rovers,1,1,0,D
92349,4,SCO4,2005-01-29,Gretna,East Fife,4,0,4,W
92350,4,SCO4,2005-01-29,Montrose,Cowdenbeath,1,2,-1,L
92351,4,SCO4,2005-01-29,Stenhousemuir,Peterhead,1,1,0,D
92352,4,SCO4,2005-02-05,Albion Rovers,East Stirling,1,1,0,D
92353,4,SCO4,2005-02-05,East Fife,Queens Park,0,1,-1,L
92354,4,SCO4,2005-02-05,Gretna,Elgin City,2,1,1,W
92355,4,SCO4,2005-02-05,Montrose,Stenhousemuir,0,3,-3,L
92356,4,SCO4,2005-02-05,Peterhead,Cowdenbeath,1,1,0,D
92357,4,SCO4,2005-02-12,Cowdenbeath,Albion Rovers,1,2,-1,L
92358,4,SCO4,2005-02-12,East Stirling,Montrose,1,2,-1,L
92359,4,SCO4,2005-02-12,Elgin City,East Fife,2,1,1,W
92360,4,SCO4,2005-02-12,Queens Park,Peterhead,1,1,0,D
92361,4,SCO4,2005-02-12,Stenhousemuir,Gretna,1,4,-3,L
92362,4,SCO4,2005-02-15,East Fife,East Stirling,2,0,2,W
92363,4,SCO4,2005-02-19,East Fife,Cowdenbeath,1,1,0,D
92364,4,SCO4,2005-02-19,Gretna,Montrose,4,1,3,W
92365,4,SCO4,2005-02-19,Queens Park,Albion Rovers,0,3,-3,L
92366,4,SCO4,2005-02-19,Stenhousemuir,East Stirling,3,2,1,W
92367,4,SCO4,2005-02-26,Montrose,Peterhead,0,2,-2,L
92368,4,SCO4,2005-03-01,Albion Rovers,Queens Park,0,4,-4,L
92369,4,SCO4,2005-03-01,Montrose,East Stirling,4,1,3,W
92370,4,SCO4,2005-03-01,Peterhead,Elgin City,3,0,3,W
92371,4,SCO4,2005-03-05,Albion Rovers,Montrose,1,2,-1,L
92372,4,SCO4,2005-03-05,Cowdenbeath,Gretna,0,1,-1,L
92373,4,SCO4,2005-03-05,East Fife,Peterhead,1,2,-1,L
92374,4,SCO4,2005-03-05,Elgin City,East Stirling,0,0,0,D
92375,4,SCO4,2005-03-05,Queens Park,Stenhousemuir,0,0,0,D
92376,4,SCO4,2005-03-08,Albion Rovers,Stenhousemuir,1,1,0,D
92377,4,SCO4,2005-03-08,East Stirling,Gretna,0,4,-4,L
92378,4,SCO4,2005-03-08,Elgin City,Peterhead,2,2,0,D
92379,4,SCO4,2005-03-12,East Stirling,Cowdenbeath,2,1,1,W
92380,4,SCO4,2005-03-12,Gretna,Queens Park,4,0,4,W
92381,4,SCO4,2005-03-12,Montrose,Elgin City,2,0,2,W
92382,4,SCO4,2005-03-12,Peterhead,Albion Rovers,2,3,-1,L
92383,4,SCO4,2005-03-12,Stenhousemuir,East Fife,1,2,-1,L
92384,4,SCO4,2005-03-15,Cowdenbeath,Elgin City,1,1,0,D
92385,4,SCO4,2005-03-15,East Stirling,Stenhousemuir,3,2,1,W
92386,4,SCO4,2005-03-19,East Stirling,East Fife,1,0,1,W
92387,4,SCO4,2005-03-19,Elgin City,Cowdenbeath,2,0,2,W
92388,4,SCO4,2005-03-19,Gretna,Peterhead,6,1,5,W
92389,4,SCO4,2005-03-19,Montrose,Queens Park,2,0,2,W
92390,4,SCO4,2005-03-19,Stenhousemuir,Albion Rovers,1,1,0,D
92391,4,SCO4,2005-03-22,Albion Rovers,East Fife,0,6,-6,L
92392,4,SCO4,2005-03-22,Cowdenbeath,Stenhousemuir,0,2,-2,L
92393,4,SCO4,2005-03-22,Elgin City,Queens Park,1,0,1,W
92394,4,SCO4,2005-03-26,East Fife,Elgin City,2,0,2,W
92395,4,SCO4,2005-04-02,Albion Rovers,Elgin City,2,0,2,W
92396,4,SCO4,2005-04-02,Cowdenbeath,Montrose,0,0,0,D
92397,4,SCO4,2005-04-02,East Fife,Gretna,0,2,-2,L
92398,4,SCO4,2005-04-02,Peterhead,Stenhousemuir,1,1,0,D
92399,4,SCO4,2005-04-02,Queens Park,East Stirling,2,0,2,W
92400,4,SCO4,2005-04-09,Albion Rovers,Cowdenbeath,1,4,-3,L
92401,4,SCO4,2005-04-09,East Fife,Elgin City,1,2,-1,L
92402,4,SCO4,2005-04-09,Gretna,Stenhousemuir,7,0,7,W
92403,4,SCO4,2005-04-09,Montrose,East Stirling,4,1,3,W
92404,4,SCO4,2005-04-09,Peterhead,Queens Park,1,1,0,D
92405,4,SCO4,2005-04-16,Cowdenbeath,Peterhead,4,0,4,W
92406,4,SCO4,2005-04-16,East Stirling,Albion Rovers,0,2,-2,L
92407,4,SCO4,2005-04-16,Elgin City,Gretna,2,6,-4,L
92408,4,SCO4,2005-04-16,Queens Park,East Fife,2,1,1,W
92409,4,SCO4,2005-04-16,Stenhousemuir,Montrose,0,1,-1,L
92410,4,SCO4,2005-04-23,Albion Rovers,Queens Park,1,2,-1,L
92411,4,SCO4,2005-04-23,Cowdenbeath,East Fife,4,2,2,W
92412,4,SCO4,2005-04-23,East Stirling,Stenhousemuir,1,4,-3,L
92413,4,SCO4,2005-04-23,Elgin City,Peterhead,0,2,-2,L
92414,4,SCO4,2005-04-23,Montrose,Gretna,0,4,-4,L
92415,4,SCO4,2005-04-30,East Fife,Albion Rovers,1,1,0,D
92416,4,SCO4,2005-04-30,Gretna,East Stirling,1,0,1,W
92417,4,SCO4,2005-04-30,Peterhead,Montrose,4,1,3,W
92418,4,SCO4,2005-04-30,Queens Park,Elgin City,1,0,1,W
92419,4,SCO4,2005-04-30,Stenhousemuir,Cowdenbeath,1,1,0,D
92420,4,SCO4,2005-05-07,Albion Rovers,Gretna,0,5,-5,L
92421,4,SCO4,2005-05-07,Cowdenbeath,Queens Park,1,0,1,W
92422,4,SCO4,2005-05-07,East Stirling,Peterhead,1,5,-4,L
92423,4,SCO4,2005-05-07,Elgin City,Stenhousemuir,4,2,2,W
92424,4,SCO4,2005-05-07,Montrose,East Fife,2,2,0,D
92425,5,SCO4,2005-08-06,Albion Rovers,Arbroath,2,2,0,D
92426,5,SCO4,2005-08-06,East Fife,Berwick Rangers,0,4,-4,L
92427,5,SCO4,2005-08-06,East Stirling,Cowdenbeath,0,1,-1,L
92428,5,SCO4,2005-08-06,Elgin City,Montrose,0,0,0,D
92429,5,SCO4,2005-08-06,Queens Park,Stenhousemuir,1,2,-1,L
92430,5,SCO4,2005-08-13,Arbroath,East Fife,1,0,1,W
92431,5,SCO4,2005-08-13,Berwick Rangers,East Stirling,3,2,1,W
92432,5,SCO4,2005-08-13,Cowdenbeath,Queens Park,0,2,-2,L
92433,5,SCO4,2005-08-13,Montrose,Albion Rovers,0,2,-2,L
92434,5,SCO4,2005-08-13,Stenhousemuir,Elgin City,3,1,2,W
92435,5,SCO4,2005-08-20,Albion Rovers,Stenhousemuir,0,2,-2,L
92436,5,SCO4,2005-08-20,East Fife,Montrose,3,2,1,W
92437,5,SCO4,2005-08-20,East Stirling,Arbroath,3,1,2,W
92438,5,SCO4,2005-08-20,Elgin City,Cowdenbeath,0,3,-3,L
92439,5,SCO4,2005-08-20,Queens Park,Berwick Rangers,1,3,-2,L
92440,5,SCO4,2005-08-27,Berwick Rangers,Elgin City,3,1,2,W
92441,5,SCO4,2005-08-27,East Fife,Cowdenbeath,1,0,1,W
92442,5,SCO4,2005-08-27,Montrose,Arbroath,1,0,1,W
92443,5,SCO4,2005-08-27,Queens Park,Albion Rovers,3,1,2,W
92444,5,SCO4,2005-08-27,Stenhousemuir,East Stirling,6,1,5,W
92445,5,SCO4,2005-09-10,Albion Rovers,East Fife,2,4,-2,L
92446,5,SCO4,2005-09-10,Arbroath,Stenhousemuir,1,1,0,D
92447,5,SCO4,2005-09-10,Cowdenbeath,Berwick Rangers,0,1,-1,L
92448,5,SCO4,2005-09-10,East Stirling,Montrose,1,1,0,D
92449,5,SCO4,2005-09-10,Elgin City,Queens Park,2,2,0,D
92450,5,SCO4,2005-09-17,Berwick Rangers,Arbroath,3,0,3,W
92451,5,SCO4,2005-09-17,Cowdenbeath,Montrose,2,0,2,W
92452,5,SCO4,2005-09-17,Elgin City,Albion Rovers,2,2,0,D
92453,5,SCO4,2005-09-17,Queens Park,East Stirling,3,0,3,W
92454,5,SCO4,2005-09-17,Stenhousemuir,East Fife,2,1,1,W
92455,5,SCO4,2005-09-24,Albion Rovers,Berwick Rangers,0,2,-2,L
92456,5,SCO4,2005-09-24,Arbroath,Cowdenbeath,0,3,-3,L
92457,5,SCO4,2005-09-24,East Fife,Queens Park,1,0,1,W
92458,5,SCO4,2005-09-24,East Stirling,Elgin City,0,2,-2,L
92459,5,SCO4,2005-09-24,Montrose,Stenhousemuir,0,3,-3,L
92460,5,SCO4,2005-10-01,Berwick Rangers,Montrose,1,1,0,D
92461,5,SCO4,2005-10-01,Cowdenbeath,Stenhousemuir,4,1,3,W
92462,5,SCO4,2005-10-01,East Stirling,Albion Rovers,3,1,2,W
92463,5,SCO4,2005-10-01,Elgin City,East Fife,1,2,-1,L
92464,5,SCO4,2005-10-01,Queens Park,Arbroath,2,2,0,D
92465,5,SCO4,2005-10-07,East Fife,Arbroath,1,1,0,D
92466,5,SCO4,2005-10-08,Berwick Rangers,Elgin City,1,1,0,D
92467,5,SCO4,2005-10-15,Albion Rovers,Cowdenbeath,0,3,-3,L
92468,5,SCO4,2005-10-15,Arbroath,Elgin City,2,0,2,W
92469,5,SCO4,2005-10-15,East Fife,East Stirling,3,1,2,W
92470,5,SCO4,2005-10-15,Montrose,Queens Park,0,1,-1,L
92471,5,SCO4,2005-10-15,Stenhousemuir,Berwick Rangers,0,1,-1,L
92472,5,SCO4,2005-10-22,Arbroath,Albion Rovers,1,2,-1,L
92473,5,SCO4,2005-10-22,Berwick Rangers,East Fife,3,0,3,W
92474,5,SCO4,2005-10-22,Cowdenbeath,East Stirling,5,1,4,W
92475,5,SCO4,2005-10-22,Montrose,Elgin City,2,0,2,W
92476,5,SCO4,2005-10-22,Stenhousemuir,Queens Park,1,0,1,W
92477,5,SCO4,2005-10-25,Albion Rovers,Montrose,1,1,0,D
92478,5,SCO4,2005-10-25,East Stirling,Berwick Rangers,1,2,-1,L
92479,5,SCO4,2005-10-25,Elgin City,Stenhousemuir,1,2,-1,L
92480,5,SCO4,2005-10-25,Queens Park,Cowdenbeath,0,2,-2,L
92481,5,SCO4,2005-10-29,Berwick Rangers,Cowdenbeath,1,0,1,W
92482,5,SCO4,2005-10-29,East Fife,Albion Rovers,1,1,0,D
92483,5,SCO4,2005-10-29,Montrose,East Stirling,3,0,3,W
92484,5,SCO4,2005-10-29,Queens Park,Elgin City,3,0,3,W
92485,5,SCO4,2005-10-29,Stenhousemuir,Arbroath,2,0,2,W
92486,5,SCO4,2005-11-05,Albion Rovers,Queens Park,1,1,0,D
92487,5,SCO4,2005-11-05,Arbroath,Montrose,2,1,1,W
92488,5,SCO4,2005-11-05,Cowdenbeath,East Fife,3,1,2,W
92489,5,SCO4,2005-11-05,East Stirling,Stenhousemuir,0,0,0,D
92490,5,SCO4,2005-11-05,Elgin City,Berwick Rangers,2,2,0,D
92491,5,SCO4,2005-11-12,Albion Rovers,Elgin City,0,2,-2,L
92492,5,SCO4,2005-11-12,Arbroath,Berwick Rangers,4,0,4,W
92493,5,SCO4,2005-11-12,East Fife,Stenhousemuir,2,3,-1,L
92494,5,SCO4,2005-11-12,Montrose,Cowdenbeath,0,1,-1,L
92495,5,SCO4,2005-11-26,Arbroath,East Stirling,7,2,5,W
92496,5,SCO4,2005-11-26,Queens Park,East Fife,2,0,2,W
92497,5,SCO4,2005-11-26,Stenhousemuir,Montrose,6,2,4,W
92498,5,SCO4,2005-12-03,Berwick Rangers,Stenhousemuir,0,2,-2,L
92499,5,SCO4,2005-12-03,Cowdenbeath,Albion Rovers,2,1,1,W
92500,5,SCO4,2005-12-03,East Stirling,East Fife,1,2,-1,L
92501,5,SCO4,2005-12-03,Elgin City,Arbroath,2,0,2,W
92502,5,SCO4,2005-12-03,Queens Park,Montrose,0,3,-3,L
92503,5,SCO4,2005-12-06,Cowdenbeath,Arbroath,3,2,1,W
92504,5,SCO4,2005-12-10,Berwick Rangers,Albion Rovers,0,1,-1,L
92505,5,SCO4,2005-12-10,Elgin City,East Stirling,1,1,0,D
92506,5,SCO4,2005-12-13,East Stirling,Queens Park,0,4,-4,L
92507,5,SCO4,2005-12-17,Stenhousemuir,Cowdenbeath,2,0,2,W
92508,5,SCO4,2005-12-26,East Fife,Berwick Rangers,1,0,1,W
92509,5,SCO4,2005-12-26,Elgin City,Montrose,1,0,1,W
92510,5,SCO4,2005-12-26,Queens Park,Stenhousemuir,2,0,2,W
92511,5,SCO4,2005-12-31,Montrose,East Fife,3,1,2,W
92512,5,SCO4,2006-01-02,East Fife,Cowdenbeath,2,1,1,W
92513,5,SCO4,2006-01-02,Montrose,Arbroath,0,1,-1,L
92514,5,SCO4,2006-01-02,Queens Park,Albion Rovers,1,1,0,D
92515,5,SCO4,2006-01-02,Stenhousemuir,East Stirling,5,0,5,W
92516,5,SCO4,2006-01-07,Albion Rovers,East Stirling,4,2,2,W
92517,5,SCO4,2006-01-07,East Fife,Elgin City,1,2,-1,L
92518,5,SCO4,2006-01-07,Montrose,Berwick Rangers,0,0,0,D
92519,5,SCO4,2006-01-14,Albion Rovers,East Fife,3,1,2,W
92520,5,SCO4,2006-01-14,Arbroath,Stenhousemuir,3,2,1,W
92521,5,SCO4,2006-01-14,Cowdenbeath,Berwick Rangers,1,1,0,D
92522,5,SCO4,2006-01-14,East Stirling,Montrose,1,0,1,W
92523,5,SCO4,2006-01-14,Elgin City,Queens Park,1,2,-1,L
92524,5,SCO4,2006-01-21,Berwick Rangers,Arbroath,2,1,1,W
92525,5,SCO4,2006-01-21,Cowdenbeath,Montrose,2,0,2,W
92526,5,SCO4,2006-01-21,Elgin City,Albion Rovers,2,1,1,W
92527,5,SCO4,2006-01-21,Queens Park,East Stirling,3,1,2,W
92528,5,SCO4,2006-01-21,Stenhousemuir,East Fife,4,2,2,W
92529,5,SCO4,2006-01-28,Albion Rovers,Berwick Rangers,0,1,-1,L
92530,5,SCO4,2006-01-28,Arbroath,Cowdenbeath,4,1,3,W
92531,5,SCO4,2006-01-28,East Fife,Queens Park,0,1,-1,L
92532,5,SCO4,2006-01-28,East Stirling,Elgin City,0,2,-2,L
92533,5,SCO4,2006-01-28,Montrose,Stenhousemuir,0,2,-2,L
92534,5,SCO4,2006-02-04,Berwick Rangers,Montrose,1,1,0,D
92535,5,SCO4,2006-02-04,Cowdenbeath,Stenhousemuir,1,1,0,D
92536,5,SCO4,2006-02-04,East Stirling,Albion Rovers,1,0,1,W
92537,5,SCO4,2006-02-04,Elgin City,East Fife,5,3,2,W
92538,5,SCO4,2006-02-04,Queens Park,Arbroath,0,0,0,D
92539,5,SCO4,2006-02-11,Albion Rovers,Cowdenbeath,1,3,-2,L
92540,5,SCO4,2006-02-11,Arbroath,Elgin City,0,1,-1,L
92541,5,SCO4,2006-02-11,East Fife,East Stirling,1,2,-1,L
92542,5,SCO4,2006-02-11,Montrose,Queens Park,0,0,0,D
92543,5,SCO4,2006-02-11,Stenhousemuir,Berwick Rangers,1,0,1,W
92544,5,SCO4,2006-02-18,Arbroath,East Fife,2,1,1,W
92545,5,SCO4,2006-02-18,Berwick Rangers,East Stirling,1,0,1,W
92546,5,SCO4,2006-02-18,Cowdenbeath,Queens Park,6,0,6,W
92547,5,SCO4,2006-02-18,Montrose,Albion Rovers,2,2,0,D
92548,5,SCO4,2006-02-18,Stenhousemuir,Elgin City,1,2,-1,L
92549,5,SCO4,2006-02-25,Albion Rovers,Stenhousemuir,1,2,-1,L
92550,5,SCO4,2006-02-25,East Fife,Montrose,4,0,4,W
92551,5,SCO4,2006-02-25,East Stirling,Arbroath,0,4,-4,L
92552,5,SCO4,2006-02-25,Elgin City,Cowdenbeath,0,4,-4,L
92553,5,SCO4,2006-02-25,Queens Park,Berwick Rangers,0,1,-1,L
92554,5,SCO4,2006-02-28,Stenhousemuir,Albion Rovers,1,0,1,W
92555,5,SCO4,2006-03-07,Albion Rovers,Arbroath,0,2,-2,L
92556,5,SCO4,2006-03-07,Berwick Rangers,Queens Park,1,2,-1,L
92557,5,SCO4,2006-03-11,Berwick Rangers,Cowdenbeath,1,0,1,W
92558,5,SCO4,2006-03-11,East Fife,Albion Rovers,1,0,1,W
92559,5,SCO4,2006-03-11,Montrose,East Stirling,2,0,2,W
92560,5,SCO4,2006-03-11,Queens Park,Elgin City,3,3,0,D
92561,5,SCO4,2006-03-11,Stenhousemuir,Arbroath,0,0,0,D
92562,5,SCO4,2006-03-14,Arbroath,Queens Park,1,1,0,D
92563,5,SCO4,2006-03-14,Elgin City,Berwick Rangers,1,3,-2,L
92564,5,SCO4,2006-03-18,Albion Rovers,Elgin City,1,2,-1,L
92565,5,SCO4,2006-03-18,Arbroath,Berwick Rangers,0,2,-2,L
92566,5,SCO4,2006-03-18,East Fife,Stenhousemuir,2,1,1,W
92567,5,SCO4,2006-03-18,East Stirling,Queens Park,0,0,0,D
92568,5,SCO4,2006-03-18,Montrose,Cowdenbeath,0,3,-3,L
92569,5,SCO4,2006-03-21,Albion Rovers,Queens Park,1,0,1,W
92570,5,SCO4,2006-03-21,Arbroath,Montrose,3,0,3,W
92571,5,SCO4,2006-03-21,Cowdenbeath,East Fife,4,1,3,W
92572,5,SCO4,2006-03-21,East Stirling,Stenhousemuir,0,7,-7,L
92573,5,SCO4,2006-03-25,Berwick Rangers,Albion Rovers,2,1,1,W
92574,5,SCO4,2006-03-25,Cowdenbeath,Arbroath,4,2,2,W
92575,5,SCO4,2006-03-25,Elgin City,East Stirling,3,0,3,W
92576,5,SCO4,2006-03-25,Queens Park,East Fife,1,1,0,D
92577,5,SCO4,2006-03-25,Stenhousemuir,Montrose,5,1,4,W
92578,5,SCO4,2006-03-28,Cowdenbeath,Elgin City,5,2,3,W
92579,5,SCO4,2006-04-01,Albion Rovers,East Stirling,2,0,2,W
92580,5,SCO4,2006-04-01,Arbroath,Queens Park,1,0,1,W
92581,5,SCO4,2006-04-01,East Fife,Elgin City,0,2,-2,L
92582,5,SCO4,2006-04-01,Montrose,Berwick Rangers,1,2,-1,L
92583,5,SCO4,2006-04-01,Stenhousemuir,Cowdenbeath,1,2,-1,L
92584,5,SCO4,2006-04-04,East Stirling,Cowdenbeath,1,1,0,D
92585,5,SCO4,2006-04-08,Berwick Rangers,Stenhousemuir,3,0,3,W
92586,5,SCO4,2006-04-08,Cowdenbeath,Albion Rovers,2,1,1,W
92587,5,SCO4,2006-04-08,East Stirling,East Fife,2,1,1,W
92588,5,SCO4,2006-04-08,Elgin City,Arbroath,4,1,3,W
92589,5,SCO4,2006-04-08,Queens Park,Montrose,2,2,0,D
92590,5,SCO4,2006-04-15,Arbroath,Albion Rovers,1,0,1,W
92591,5,SCO4,2006-04-15,Berwick Rangers,East Fife,1,1,0,D
92592,5,SCO4,2006-04-15,Cowdenbeath,East Stirling,5,0,5,W
92593,5,SCO4,2006-04-15,Montrose,Elgin City,1,3,-2,L
92594,5,SCO4,2006-04-15,Stenhousemuir,Queens Park,1,2,-1,L
92595,5,SCO4,2006-04-22,Albion Rovers,Montrose,1,1,0,D
92596,5,SCO4,2006-04-22,East Fife,Arbroath,0,3,-3,L
92597,5,SCO4,2006-04-22,East Stirling,Berwick Rangers,0,1,-1,L
92598,5,SCO4,2006-04-22,Elgin City,Stenhousemuir,0,2,-2,L
92599,5,SCO4,2006-04-22,Queens Park,Cowdenbeath,2,2,0,D
92600,5,SCO4,2006-04-29,Arbroath,East Stirling,2,1,1,W
92601,5,SCO4,2006-04-29,Berwick Rangers,Queens Park,1,0,1,W
92602,5,SCO4,2006-04-29,Cowdenbeath,Elgin City,2,1,1,W
92603,5,SCO4,2006-04-29,Montrose,East Fife,0,2,-2,L
92604,5,SCO4,2006-04-29,Stenhousemuir,Albion Rovers,4,2,2,W
92605,6,SCO4,2006-08-05,Berwick Rangers,Albion Rovers,1,1,0,D
92606,6,SCO4,2006-08-05,East Fife,Stenhousemuir,0,0,0,D
92607,6,SCO4,2006-08-05,East Stirling,Elgin City,2,1,1,W
92608,6,SCO4,2006-08-05,Montrose,Dumbarton,1,1,0,D
92609,6,SCO4,2006-08-05,Queens Park,Arbroath,0,3,-3,L
92610,6,SCO4,2006-08-12,Albion Rovers,East Fife,0,1,-1,L
92611,6,SCO4,2006-08-12,Arbroath,Berwick Rangers,0,1,-1,L
92612,6,SCO4,2006-08-12,Dumbarton,East Stirling,2,0,2,W
92613,6,SCO4,2006-08-12,Elgin City,Queens Park,1,2,-1,L
92614,6,SCO4,2006-08-12,Stenhousemuir,Montrose,5,0,5,W
92615,6,SCO4,2006-08-19,Berwick Rangers,Stenhousemuir,0,1,-1,L
92616,6,SCO4,2006-08-19,East Fife,Arbroath,2,1,1,W
92617,6,SCO4,2006-08-19,East Stirling,Albion Rovers,0,1,-1,L
92618,6,SCO4,2006-08-19,Montrose,Elgin City,2,0,2,W
92619,6,SCO4,2006-08-19,Queens Park,Dumbarton,1,0,1,W
92620,6,SCO4,2006-08-26,Albion Rovers,Queens Park,1,1,0,D
92621,6,SCO4,2006-08-26,Arbroath,Montrose,3,1,2,W
92622,6,SCO4,2006-08-26,Berwick Rangers,Dumbarton,3,0,3,W
92623,6,SCO4,2006-08-26,East Stirling,Stenhousemuir,5,0,5,W
92624,6,SCO4,2006-08-26,Elgin City,East Fife,1,2,-1,L
92625,6,SCO4,2006-09-01,East Fife,East Stirling,5,0,5,W
92626,6,SCO4,2006-09-03,Berwick Rangers,Queens Park,1,0,1,W
92627,6,SCO4,2006-09-03,Dumbarton,Arbroath,0,2,-2,L
92628,6,SCO4,2006-09-03,Montrose,Albion Rovers,2,1,1,W
92629,6,SCO4,2006-09-03,Stenhousemuir,Elgin City,2,0,2,W
92630,6,SCO4,2006-09-09,Arbroath,Albion Rovers,2,3,-1,L
92631,6,SCO4,2006-09-09,Berwick Rangers,East Stirling,2,2,0,D
92632,6,SCO4,2006-09-09,Elgin City,Dumbarton,0,2,-2,L
92633,6,SCO4,2006-09-09,Montrose,East Fife,1,0,1,W
92634,6,SCO4,2006-09-09,Stenhousemuir,Queens Park,2,1,1,W
92635,6,SCO4,2006-09-16,Albion Rovers,Elgin City,3,1,2,W
92636,6,SCO4,2006-09-16,Dumbarton,Stenhousemuir,4,0,4,W
92637,6,SCO4,2006-09-16,East Fife,Berwick Rangers,2,0,2,W
92638,6,SCO4,2006-09-16,East Stirling,Arbroath,0,2,-2,L
92639,6,SCO4,2006-09-16,Queens Park,Montrose,1,1,0,D
92640,6,SCO4,2006-09-23,Dumbarton,Albion Rovers,3,1,2,W
92641,6,SCO4,2006-09-23,Elgin City,Berwick Rangers,1,2,-1,L
92642,6,SCO4,2006-09-23,Montrose,East Stirling,1,0,1,W
92643,6,SCO4,2006-09-23,Queens Park,East Fife,3,0,3,W
92644,6,SCO4,2006-09-23,Stenhousemuir,Arbroath,1,2,-1,L
92645,6,SCO4,2006-09-30,Albion Rovers,Stenhousemuir,2,5,-3,L
92646,6,SCO4,2006-09-30,Arbroath,Elgin City,2,1,1,W
92647,6,SCO4,2006-09-30,Berwick Rangers,Montrose,1,2,-1,L
92648,6,SCO4,2006-09-30,East Fife,Dumbarton,1,0,1,W
92649,6,SCO4,2006-09-30,East Stirling,Queens Park,2,1,1,W
92650,6,SCO4,2006-10-07,Elgin City,East Fife,2,3,-1,L
92651,6,SCO4,2006-10-14,Albion Rovers,Berwick Rangers,0,1,-1,L
92652,6,SCO4,2006-10-14,Arbroath,Queens Park,1,2,-1,L
92653,6,SCO4,2006-10-14,Dumbarton,Montrose,2,0,2,W
92654,6,SCO4,2006-10-14,Elgin City,East Stirling,5,0,5,W
92655,6,SCO4,2006-10-14,Stenhousemuir,East Fife,0,1,-1,L
92656,6,SCO4,2006-10-21,Berwick Rangers,Arbroath,3,2,1,W
92657,6,SCO4,2006-10-21,East Fife,Albion Rovers,2,2,0,D
92658,6,SCO4,2006-10-21,East Stirling,Dumbarton,0,2,-2,L
92659,6,SCO4,2006-10-21,Montrose,Stenhousemuir,0,1,-1,L
92660,6,SCO4,2006-10-21,Queens Park,Elgin City,3,0,3,W
92661,6,SCO4,2006-10-28,Albion Rovers,Montrose,3,1,2,W
92662,6,SCO4,2006-10-28,Arbroath,Dumbarton,0,0,0,D
92663,6,SCO4,2006-10-28,East Stirling,East Fife,0,4,-4,L
92664,6,SCO4,2006-10-28,Elgin City,Stenhousemuir,2,0,2,W
92665,6,SCO4,2006-10-28,Queens Park,Berwick Rangers,1,0,1,W
92666,6,SCO4,2006-11-04,Dumbarton,Berwick Rangers,2,0,2,W
92667,6,SCO4,2006-11-04,East Fife,Elgin City,1,1,0,D
92668,6,SCO4,2006-11-04,Montrose,Arbroath,0,1,-1,L
92669,6,SCO4,2006-11-04,Queens Park,Albion Rovers,2,1,1,W
92670,6,SCO4,2006-11-04,Stenhousemuir,East Stirling,2,0,2,W
92671,6,SCO4,2006-11-11,Arbroath,East Stirling,1,2,-1,L
92672,6,SCO4,2006-11-11,Berwick Rangers,East Fife,2,1,1,W
92673,6,SCO4,2006-11-11,Elgin City,Albion Rovers,0,3,-3,L
92674,6,SCO4,2006-11-11,Montrose,Queens Park,0,3,-3,L
92675,6,SCO4,2006-11-11,Stenhousemuir,Dumbarton,1,0,1,W
92676,6,SCO4,2006-11-25,Albion Rovers,Arbroath,1,3,-2,L
92677,6,SCO4,2006-11-25,Dumbarton,Elgin City,3,1,2,W
92678,6,SCO4,2006-11-25,East Fife,Montrose,2,0,2,W
92679,6,SCO4,2006-11-25,Queens Park,Stenhousemuir,1,1,0,D
92680,6,SCO4,2006-12-02,Albion Rovers,Dumbarton,2,1,1,W
92681,6,SCO4,2006-12-02,Arbroath,Stenhousemuir,2,0,2,W
92682,6,SCO4,2006-12-02,Berwick Rangers,Elgin City,3,1,2,W
92683,6,SCO4,2006-12-02,East Fife,Queens Park,1,0,1,W
92684,6,SCO4,2006-12-02,East Stirling,Montrose,0,3,-3,L
92685,6,SCO4,2006-12-16,Dumbarton,East Fife,2,1,1,W
92686,6,SCO4,2006-12-16,Elgin City,Arbroath,0,4,-4,L
92687,6,SCO4,2006-12-16,Montrose,Berwick Rangers,0,1,-1,L
92688,6,SCO4,2006-12-16,Queens Park,East Stirling,1,3,-2,L
92689,6,SCO4,2006-12-16,Stenhousemuir,Albion Rovers,3,2,1,W
92690,6,SCO4,2006-12-23,Berwick Rangers,Albion Rovers,3,0,3,W
92691,6,SCO4,2006-12-23,East Fife,Stenhousemuir,1,1,0,D
92692,6,SCO4,2006-12-23,East Stirling,Elgin City,0,2,-2,L
92693,6,SCO4,2006-12-23,Montrose,Dumbarton,0,5,-5,L
92694,6,SCO4,2006-12-23,Queens Park,Arbroath,1,0,1,W
92695,6,SCO4,2006-12-30,Albion Rovers,East Stirling,4,0,4,W
92696,6,SCO4,2006-12-30,Arbroath,East Fife,1,1,0,D
92697,6,SCO4,2006-12-30,Dumbarton,Queens Park,0,0,0,D
92698,6,SCO4,2006-12-30,Elgin City,Montrose,3,2,1,W
92699,6,SCO4,2006-12-30,Stenhousemuir,Berwick Rangers,2,3,-1,L
92700,6,SCO4,2007-01-02,Albion Rovers,Queens Park,2,1,1,W
92701,6,SCO4,2007-01-02,Arbroath,Montrose,1,0,1,W
92702,6,SCO4,2007-01-06,Stenhousemuir,Albion Rovers,0,4,-4,L
92703,6,SCO4,2007-01-13,East Fife,East Stirling,0,2,-2,L
92704,6,SCO4,2007-01-13,Montrose,Albion Rovers,2,3,-1,L
92705,6,SCO4,2007-01-13,Queens Park,Berwick Rangers,0,2,-2,L
92706,6,SCO4,2007-01-13,Stenhousemuir,Elgin City,3,2,1,W
92707,6,SCO4,2007-01-20,Albion Rovers,Elgin City,6,2,4,W
92708,6,SCO4,2007-01-20,East Fife,Berwick Rangers,0,2,-2,L
92709,6,SCO4,2007-01-20,Queens Park,Montrose,5,0,5,W
92710,6,SCO4,2007-01-27,Arbroath,Albion Rovers,0,0,0,D
92711,6,SCO4,2007-01-27,Berwick Rangers,East Stirling,2,0,2,W
92712,6,SCO4,2007-01-27,Elgin City,Dumbarton,0,1,-1,L
92713,6,SCO4,2007-01-27,Montrose,East Fife,3,3,0,D
92714,6,SCO4,2007-01-27,Stenhousemuir,Queens Park,1,2,-1,L
92715,6,SCO4,2007-02-03,Dumbarton,Albion Rovers,3,1,2,W
92716,6,SCO4,2007-02-03,Elgin City,Berwick Rangers,2,1,1,W
92717,6,SCO4,2007-02-03,Montrose,East Stirling,4,0,4,W
92718,6,SCO4,2007-02-03,Queens Park,East Fife,1,1,0,D
92719,6,SCO4,2007-02-03,Stenhousemuir,Arbroath,1,2,-1,L
92720,6,SCO4,2007-02-10,Berwick Rangers,Montrose,1,0,1,W
92721,6,SCO4,2007-02-10,East Stirling,Queens Park,0,2,-2,L
92722,6,SCO4,2007-02-17,Berwick Rangers,Stenhousemuir,2,1,1,W
92723,6,SCO4,2007-02-17,East Fife,Arbroath,1,2,-1,L
92724,6,SCO4,2007-02-17,East Stirling,Albion Rovers,0,0,0,D
92725,6,SCO4,2007-02-17,Montrose,Elgin City,0,1,-1,L
92726,6,SCO4,2007-02-17,Queens Park,Dumbarton,2,0,2,W
92727,6,SCO4,2007-02-24,Albion Rovers,East Fife,0,3,-3,L
92728,6,SCO4,2007-02-24,Arbroath,Berwick Rangers,1,0,1,W
92729,6,SCO4,2007-02-24,Dumbarton,East Stirling,2,1,1,W
92730,6,SCO4,2007-02-24,Elgin City,Queens Park,0,3,-3,L
92731,6,SCO4,2007-02-24,Stenhousemuir,Montrose,2,5,-3,L
92732,6,SCO4,2007-03-03,Dumbarton,Berwick Rangers,1,2,-1,L
92733,6,SCO4,2007-03-03,East Fife,Elgin City,3,1,2,W
92734,6,SCO4,2007-03-03,Montrose,Arbroath,0,1,-1,L
92735,6,SCO4,2007-03-03,Queens Park,Albion Rovers,5,0,5,W
92736,6,SCO4,2007-03-03,Stenhousemuir,East Stirling,1,1,0,D
92737,6,SCO4,2007-03-06,East Stirling,Stenhousemuir,0,1,-1,L
92738,6,SCO4,2007-03-07,Arbroath,Elgin City,2,1,1,W
92739,6,SCO4,2007-03-07,Berwick Rangers,Dumbarton,2,1,1,W
92740,6,SCO4,2007-03-10,Albion Rovers,Montrose,2,2,0,D
92741,6,SCO4,2007-03-10,Arbroath,Dumbarton,2,2,0,D
92742,6,SCO4,2007-03-10,Berwick Rangers,Queens Park,0,2,-2,L
92743,6,SCO4,2007-03-10,East Stirling,East Fife,0,2,-2,L
92744,6,SCO4,2007-03-10,Elgin City,Stenhousemuir,2,1,1,W
92745,6,SCO4,2007-03-13,Dumbarton,Stenhousemuir,1,1,0,D
92746,6,SCO4,2007-03-14,East Stirling,Arbroath,1,5,-4,L
92747,6,SCO4,2007-03-17,Berwick Rangers,East Fife,2,0,2,W
92748,6,SCO4,2007-03-17,Elgin City,Albion Rovers,3,0,3,W
92749,6,SCO4,2007-03-17,Montrose,Queens Park,0,2,-2,L
92750,6,SCO4,2007-03-17,Stenhousemuir,Dumbarton,5,1,4,W
92751,6,SCO4,2007-03-20,East Stirling,Berwick Rangers,0,1,-1,L
92752,6,SCO4,2007-03-20,Albion Rovers,Stenhousemuir,2,1,1,W
92753,6,SCO4,2007-03-21,East Fife,Dumbarton,1,0,1,W
92754,6,SCO4,2007-03-24,Elgin City,Arbroath,0,1,-1,L
92755,6,SCO4,2007-03-25,Dumbarton,East Fife,0,2,-2,L
92756,6,SCO4,2007-03-25,Montrose,Berwick Rangers,1,2,-1,L
92757,6,SCO4,2007-03-27,Arbroath,East Stirling,3,2,1,W
92758,6,SCO4,2007-03-31,Albion Rovers,Arbroath,0,3,-3,L
92759,6,SCO4,2007-03-31,Dumbarton,Elgin City,1,0,1,W
92760,6,SCO4,2007-03-31,East Fife,Montrose,2,0,2,W
92761,6,SCO4,2007-03-31,East Stirling,Berwick Rangers,0,3,-3,L
92762,6,SCO4,2007-03-31,Queens Park,Stenhousemuir,1,0,1,W
92763,6,SCO4,2007-04-03,Dumbarton,Arbroath,1,0,1,W
92764,6,SCO4,2007-04-03,Queens Park,East Stirling,2,1,1,W
92765,6,SCO4,2007-04-07,Albion Rovers,Dumbarton,0,1,-1,L
92766,6,SCO4,2007-04-07,Arbroath,Stenhousemuir,4,1,3,W
92767,6,SCO4,2007-04-07,Berwick Rangers,Elgin City,0,0,0,D
92768,6,SCO4,2007-04-07,East Fife,Queens Park,1,0,1,W
92769,6,SCO4,2007-04-07,East Stirling,Montrose,0,2,-2,L
92770,6,SCO4,2007-04-14,Albion Rovers,Berwick Rangers,0,1,-1,L
92771,6,SCO4,2007-04-14,Arbroath,Queens Park,1,0,1,W
92772,6,SCO4,2007-04-14,Dumbarton,Montrose,2,1,1,W
92773,6,SCO4,2007-04-14,Elgin City,East Stirling,2,1,1,W
92774,6,SCO4,2007-04-14,Stenhousemuir,East Fife,3,5,-2,L
92775,6,SCO4,2007-04-21,Berwick Rangers,Arbroath,1,0,1,W
92776,6,SCO4,2007-04-21,East Fife,Albion Rovers,1,3,-2,L
92777,6,SCO4,2007-04-21,East Stirling,Dumbarton,1,5,-4,L
92778,6,SCO4,2007-04-21,Montrose,Stenhousemuir,3,2,1,W
92779,6,SCO4,2007-04-21,Queens Park,Elgin City,3,0,3,W
92780,6,SCO4,2007-04-28,Albion Rovers,East Stirling,2,1,1,W
92781,6,SCO4,2007-04-28,Arbroath,East Fife,1,3,-2,L
92782,6,SCO4,2007-04-28,Dumbarton,Queens Park,1,2,-1,L
92783,6,SCO4,2007-04-28,Elgin City,Montrose,0,2,-2,L
92784,6,SCO4,2007-04-28,Stenhousemuir,Berwick Rangers,2,0,2,W
92785,7,SCO4,2007-08-04,Dumbarton,Elgin City,1,0,1,W
92786,7,SCO4,2007-08-04,East Fife,East Stirling,3,1,2,W
92787,7,SCO4,2007-08-04,Montrose,Albion Rovers,0,1,-1,L
92788,7,SCO4,2007-08-04,Stenhousemuir,Arbroath,1,0,1,W
92789,7,SCO4,2007-08-04,Stranraer,Forfar Athletic,3,0,3,W
92790,7,SCO4,2007-08-11,Albion Rovers,Stranraer,3,2,1,W
92791,7,SCO4,2007-08-11,Arbroath,East Fife,2,3,-1,L
92792,7,SCO4,2007-08-11,East Stirling,Dumbarton,3,2,1,W
92793,7,SCO4,2007-08-11,Elgin City,Montrose,0,2,-2,L
92794,7,SCO4,2007-08-11,Forfar Athletic,Stenhousemuir,0,1,-1,L
92795,7,SCO4,2007-08-18,Albion Rovers,Stenhousemuir,1,1,0,D
92796,7,SCO4,2007-08-18,Arbroath,Dumbarton,1,1,0,D
92797,7,SCO4,2007-08-18,East Stirling,Forfar Athletic,2,1,1,W
92798,7,SCO4,2007-08-18,Elgin City,East Fife,2,3,-1,L
92799,7,SCO4,2007-08-18,Stranraer,Montrose,1,0,1,W
92800,7,SCO4,2007-08-25,Dumbarton,Albion Rovers,2,0,2,W
92801,7,SCO4,2007-08-25,East Fife,Stranraer,3,1,2,W
92802,7,SCO4,2007-08-25,Forfar Athletic,Elgin City,4,0,4,W
92803,7,SCO4,2007-08-25,Montrose,Arbroath,3,3,0,D
92804,7,SCO4,2007-08-25,Stenhousemuir,East Stirling,0,3,-3,L
92805,7,SCO4,2007-09-01,Albion Rovers,East Stirling,2,3,-1,L
92806,7,SCO4,2007-09-01,Arbroath,Elgin City,4,0,4,W
92807,7,SCO4,2007-09-01,East Fife,Forfar Athletic,3,0,3,W
92808,7,SCO4,2007-09-01,Stenhousemuir,Montrose,0,4,-4,L
92809,7,SCO4,2007-09-01,Stranraer,Dumbarton,2,0,2,W
92810,7,SCO4,2007-09-15,Dumbarton,Stenhousemuir,1,2,-1,L
92811,7,SCO4,2007-09-15,East Stirling,Stranraer,2,3,-1,L
92812,7,SCO4,2007-09-15,Elgin City,Albion Rovers,3,2,1,W
92813,7,SCO4,2007-09-15,Forfar Athletic,Arbroath,1,3,-2,L
92814,7,SCO4,2007-09-15,Montrose,East Fife,3,1,2,W
92815,7,SCO4,2007-09-22,Arbroath,Albion Rovers,1,0,1,W
92816,7,SCO4,2007-09-22,Dumbarton,East Fife,1,1,0,D
92817,7,SCO4,2007-09-22,Elgin City,East Stirling,6,0,6,W
92818,7,SCO4,2007-09-22,Forfar Athletic,Montrose,1,4,-3,L
92819,7,SCO4,2007-09-22,Stenhousemuir,Stranraer,1,4,-3,L
92820,7,SCO4,2007-09-29,East Fife,Stenhousemuir,7,0,7,W
92821,7,SCO4,2007-09-29,East Stirling,Arbroath,2,3,-1,L
92822,7,SCO4,2007-09-29,Montrose,Dumbarton,0,1,-1,L
92823,7,SCO4,2007-09-29,Stranraer,Elgin City,3,3,0,D
92824,7,SCO4,2007-10-06,Dumbarton,Forfar Athletic,0,0,0,D
92825,7,SCO4,2007-10-06,East Fife,Albion Rovers,4,0,4,W
92826,7,SCO4,2007-10-06,Montrose,East Stirling,3,1,2,W
92827,7,SCO4,2007-10-06,Stenhousemuir,Elgin City,2,3,-1,L
92828,7,SCO4,2007-10-06,Stranraer,Arbroath,1,1,0,D
92829,7,SCO4,2007-10-09,Albion Rovers,Forfar Athletic,2,1,1,W
92830,7,SCO4,2007-10-12,Montrose,Elgin City,0,0,0,D
92831,7,SCO4,2007-10-20,Albion Rovers,Montrose,1,3,-2,L
92832,7,SCO4,2007-10-20,Arbroath,Stenhousemuir,2,2,0,D
92833,7,SCO4,2007-10-20,East Stirling,East Fife,0,2,-2,L
92834,7,SCO4,2007-10-20,Elgin City,Dumbarton,2,1,1,W
92835,7,SCO4,2007-10-20,Forfar Athletic,Stranraer,1,1,0,D
92836,7,SCO4,2007-11-03,Dumbarton,Arbroath,1,1,0,D
92837,7,SCO4,2007-11-03,East Fife,Elgin City,4,0,4,W
92838,7,SCO4,2007-11-03,Forfar Athletic,East Stirling,0,2,-2,L
92839,7,SCO4,2007-11-03,Stenhousemuir,Albion Rovers,0,1,-1,L
92840,7,SCO4,2007-11-06,Montrose,Stranraer,2,4,-2,L
92841,7,SCO4,2007-11-10,Albion Rovers,Dumbarton,2,0,2,W
92842,7,SCO4,2007-11-10,Arbroath,Montrose,0,0,0,D
92843,7,SCO4,2007-11-10,East Stirling,Stenhousemuir,1,1,0,D
92844,7,SCO4,2007-11-10,Elgin City,Forfar Athletic,2,2,0,D
92845,7,SCO4,2007-11-10,Stranraer,East Fife,0,2,-2,L
92846,7,SCO4,2007-11-16,Arbroath,Stranraer,2,2,0,D
92847,7,SCO4,2007-11-24,Stenhousemuir,Forfar Athletic,4,0,4,W
92848,7,SCO4,2007-12-01,Albion Rovers,Elgin City,3,4,-1,L
92849,7,SCO4,2007-12-01,Arbroath,Forfar Athletic,3,4,-1,L
92850,7,SCO4,2007-12-01,East Fife,Montrose,2,0,2,W
92851,7,SCO4,2007-12-01,Stenhousemuir,Dumbarton,2,1,1,W
92852,7,SCO4,2007-12-01,Stranraer,East Stirling,2,1,1,W
92853,7,SCO4,2007-12-08,Dumbarton,Stranraer,0,2,-2,L
92854,7,SCO4,2007-12-08,East Stirling,Albion Rovers,4,5,-1,L
92855,7,SCO4,2007-12-08,Elgin City,Arbroath,1,3,-2,L
92856,7,SCO4,2007-12-08,Forfar Athletic,East Fife,0,2,-2,L
92857,7,SCO4,2007-12-08,Montrose,Stenhousemuir,1,0,1,W
92858,7,SCO4,2007-12-15,Albion Rovers,Arbroath,5,2,3,W
92859,7,SCO4,2007-12-15,East Fife,Dumbarton,2,0,2,W
92860,7,SCO4,2007-12-15,East Stirling,Elgin City,3,1,2,W
92861,7,SCO4,2007-12-15,Montrose,Forfar Athletic,0,1,-1,L
92862,7,SCO4,2007-12-15,Stranraer,Stenhousemuir,2,3,-1,L
92863,7,SCO4,2007-12-18,Dumbarton,East Stirling,3,1,2,W
92864,7,SCO4,2007-12-22,Dumbarton,Montrose,1,3,-2,L
92865,7,SCO4,2007-12-22,Stenhousemuir,East Fife,2,1,1,W
92866,7,SCO4,2007-12-26,East Fife,Arbroath,0,2,-2,L
92867,7,SCO4,2007-12-26,Stranraer,Albion Rovers,3,1,2,W
92868,7,SCO4,2007-12-29,Albion Rovers,East Fife,1,4,-3,L
92869,7,SCO4,2007-12-29,East Stirling,Montrose,0,3,-3,L
92870,7,SCO4,2007-12-29,Elgin City,Stenhousemuir,2,0,2,W
92871,7,SCO4,2007-12-29,Forfar Athletic,Dumbarton,3,1,2,W
92872,7,SCO4,2008-01-02,Dumbarton,Albion Rovers,2,0,2,W
92873,7,SCO4,2008-01-02,East Fife,Stranraer,2,1,1,W
92874,7,SCO4,2008-01-02,Forfar Athletic,Elgin City,0,1,-1,L
92875,7,SCO4,2008-01-02,Montrose,Arbroath,5,0,5,W
92876,7,SCO4,2008-01-02,Stenhousemuir,East Stirling,3,0,3,W
92877,7,SCO4,2008-01-05,Albion Rovers,Stenhousemuir,3,3,0,D
92878,7,SCO4,2008-01-05,East Stirling,Forfar Athletic,4,1,3,W
92879,7,SCO4,2008-01-05,Elgin City,East Fife,1,2,-1,L
92880,7,SCO4,2008-01-05,Stranraer,Montrose,0,2,-2,L
92881,7,SCO4,2008-01-12,Montrose,East Fife,0,1,-1,L
92882,7,SCO4,2008-01-19,Albion Rovers,East Stirling,2,2,0,D
92883,7,SCO4,2008-01-19,Arbroath,Elgin City,2,0,2,W
92884,7,SCO4,2008-01-19,East Fife,Forfar Athletic,3,0,3,W
92885,7,SCO4,2008-01-19,Stenhousemuir,Montrose,0,0,0,D
92886,7,SCO4,2008-01-19,Stranraer,Dumbarton,2,0,2,W
92887,7,SCO4,2008-01-26,Arbroath,East Fife,0,1,-1,L
92888,7,SCO4,2008-01-26,Elgin City,Montrose,2,1,1,W
92889,7,SCO4,2008-01-26,Forfar Athletic,Stenhousemuir,1,2,-1,L
92890,7,SCO4,2008-02-02,Dumbarton,Elgin City,1,4,-3,L
92891,7,SCO4,2008-02-02,East Fife,East Stirling,1,0,1,W
92892,7,SCO4,2008-02-02,Montrose,Albion Rovers,2,1,1,W
92893,7,SCO4,2008-02-02,Stenhousemuir,Arbroath,0,3,-3,L
92894,7,SCO4,2008-02-02,Stranraer,Forfar Athletic,2,1,1,W
92895,7,SCO4,2008-02-09,Albion Rovers,Forfar Athletic,0,0,0,D
92896,7,SCO4,2008-02-09,East Fife,Stenhousemuir,0,1,-1,L
92897,7,SCO4,2008-02-09,East Stirling,Arbroath,0,1,-1,L
92898,7,SCO4,2008-02-09,Montrose,Dumbarton,3,1,2,W
92899,7,SCO4,2008-02-09,Stranraer,Elgin City,0,0,0,D
92900,7,SCO4,2008-02-16,Arbroath,Albion Rovers,1,4,-3,L
92901,7,SCO4,2008-02-16,Dumbarton,East Fife,0,3,-3,L
92902,7,SCO4,2008-02-16,Forfar Athletic,Montrose,1,1,0,D
92903,7,SCO4,2008-02-16,Stenhousemuir,Stranraer,1,1,0,D
92904,7,SCO4,2008-02-23,Dumbarton,Arbroath,2,1,1,W
92905,7,SCO4,2008-02-23,East Fife,Elgin City,2,0,2,W
92906,7,SCO4,2008-02-23,Forfar Athletic,East Stirling,1,0,1,W
92907,7,SCO4,2008-02-23,Montrose,Stranraer,0,2,-2,L
92908,7,SCO4,2008-02-23,Stenhousemuir,Albion Rovers,2,2,0,D
92909,7,SCO4,2008-02-26,Forfar Athletic,Albion Rovers,1,0,1,W
92910,7,SCO4,2008-02-27,Arbroath,East Stirling,2,0,2,W
92911,7,SCO4,2008-02-27,Elgin City,Stranraer,0,5,-5,L
92912,7,SCO4,2008-03-01,Albion Rovers,Dumbarton,0,1,-1,L
92913,7,SCO4,2008-03-01,Arbroath,Montrose,2,1,1,W
92914,7,SCO4,2008-03-01,East Stirling,Stenhousemuir,3,4,-1,L
92915,7,SCO4,2008-03-01,Elgin City,Forfar Athletic,3,1,2,W
92916,7,SCO4,2008-03-01,Stranraer,East Fife,0,2,-2,L
92917,7,SCO4,2008-03-04,East Stirling,Stranraer,1,3,-2,L
92918,7,SCO4,2008-03-05,Arbroath,Dumbarton,0,0,0,D
92919,7,SCO4,2008-03-05,Elgin City,Albion Rovers,1,1,0,D
92920,7,SCO4,2008-03-08,East Fife,Albion Rovers,0,0,0,D
92921,7,SCO4,2008-03-08,Montrose,East Stirling,2,0,2,W
92922,7,SCO4,2008-03-08,Stenhousemuir,Elgin City,2,2,0,D
92923,7,SCO4,2008-03-08,Stranraer,Arbroath,0,3,-3,L
92924,7,SCO4,2008-03-11,Forfar Athletic,Arbroath,1,0,1,W
92925,7,SCO4,2008-03-15,Albion Rovers,Montrose,0,3,-3,L
92926,7,SCO4,2008-03-15,Arbroath,Stenhousemuir,1,0,1,W
92927,7,SCO4,2008-03-15,East Stirling,East Fife,0,3,-3,L
92928,7,SCO4,2008-03-15,Elgin City,Dumbarton,2,1,1,W
92929,7,SCO4,2008-03-15,Forfar Athletic,Stranraer,1,0,1,W
92930,7,SCO4,2008-03-18,Albion Rovers,Stranraer,1,1,0,D
92931,7,SCO4,2008-03-18,Dumbarton,Stenhousemuir,1,0,1,W
92932,7,SCO4,2008-03-19,Elgin City,East Stirling,3,0,3,W
92933,7,SCO4,2008-03-22,Albion Rovers,Elgin City,1,1,0,D
92934,7,SCO4,2008-03-22,Arbroath,Forfar Athletic,1,1,0,D
92935,7,SCO4,2008-03-22,East Fife,Montrose,0,0,0,D
92936,7,SCO4,2008-03-22,Stenhousemuir,Dumbarton,1,1,0,D
92937,7,SCO4,2008-03-22,Stranraer,East Stirling,2,1,1,W
92938,7,SCO4,2008-03-25,East Stirling,Dumbarton,1,1,0,D
92939,7,SCO4,2008-03-29,Dumbarton,Stranraer,0,1,-1,L
92940,7,SCO4,2008-03-29,East Stirling,Albion Rovers,3,0,3,W
92941,7,SCO4,2008-03-29,Elgin City,Arbroath,2,1,1,W
92942,7,SCO4,2008-03-29,Forfar Athletic,East Fife,2,3,-1,L
92943,7,SCO4,2008-03-29,Montrose,Stenhousemuir,2,1,1,W
92944,7,SCO4,2008-04-05,Albion Rovers,Arbroath,0,2,-2,L
92945,7,SCO4,2008-04-05,East Fife,Dumbarton,2,1,1,W
92946,7,SCO4,2008-04-05,East Stirling,Elgin City,0,0,0,D
92947,7,SCO4,2008-04-05,Montrose,Forfar Athletic,2,2,0,D
92948,7,SCO4,2008-04-05,Stranraer,Stenhousemuir,3,1,2,W
92949,7,SCO4,2008-04-08,Dumbarton,Forfar Athletic,0,0,0,D
92950,7,SCO4,2008-04-12,Arbroath,East Stirling,0,1,-1,L
92951,7,SCO4,2008-04-12,Dumbarton,Montrose,0,0,0,D
92952,7,SCO4,2008-04-12,Elgin City,Stranraer,2,3,-1,L
92953,7,SCO4,2008-04-12,Forfar Athletic,Albion Rovers,1,4,-3,L
92954,7,SCO4,2008-04-12,Stenhousemuir,East Fife,0,1,-1,L
92955,7,SCO4,2008-04-19,Dumbarton,East Stirling,1,0,1,W
92956,7,SCO4,2008-04-19,East Fife,Arbroath,2,1,1,W
92957,7,SCO4,2008-04-19,Montrose,Elgin City,3,2,1,W
92958,7,SCO4,2008-04-19,Stenhousemuir,Forfar Athletic,2,0,2,W
92959,7,SCO4,2008-04-19,Stranraer,Albion Rovers,3,0,3,W
92960,7,SCO4,2008-04-26,Albion Rovers,East Fife,2,2,0,D
92961,7,SCO4,2008-04-26,Arbroath,Stranraer,0,0,0,D
92962,7,SCO4,2008-04-26,East Stirling,Montrose,3,1,2,W
92963,7,SCO4,2008-04-26,Elgin City,Stenhousemuir,1,5,-4,L
92964,7,SCO4,2008-04-26,Forfar Athletic,Dumbarton,1,1,0,D
92965,8,SCO4,2008-08-02,Albion Rovers,Forfar Athletic,1,3,-2,L
92966,8,SCO4,2008-08-02,Berwick Rangers,East Stirling,2,1,1,W
92967,8,SCO4,2008-08-02,Cowdenbeath,Annan Athletic,1,4,-3,L
92968,8,SCO4,2008-08-02,Dumbarton,Montrose,1,1,0,D
92969,8,SCO4,2008-08-02,Stenhousemuir,Elgin City,3,0,3,W
92970,8,SCO4,2008-08-09,Annan Athletic,Stenhousemuir,1,1,0,D
92971,8,SCO4,2008-08-09,East Stirling,Albion Rovers,1,0,1,W
92972,8,SCO4,2008-08-09,Elgin City,Dumbarton,1,1,0,D
92973,8,SCO4,2008-08-09,Forfar Athletic,Cowdenbeath,0,1,-1,L
92974,8,SCO4,2008-08-09,Montrose,Berwick Rangers,1,1,0,D
92975,8,SCO4,2008-08-16,Annan Athletic,East Stirling,2,1,1,W
92976,8,SCO4,2008-08-16,Berwick Rangers,Dumbarton,1,2,-1,L
92977,8,SCO4,2008-08-16,Cowdenbeath,Albion Rovers,2,1,1,W
92978,8,SCO4,2008-08-16,Forfar Athletic,Elgin City,0,1,-1,L
92979,8,SCO4,2008-08-16,Stenhousemuir,Montrose,2,2,0,D
92980,8,SCO4,2008-08-23,Albion Rovers,Berwick Rangers,2,0,2,W
92981,8,SCO4,2008-08-23,Dumbarton,Stenhousemuir,1,2,-1,L
92982,8,SCO4,2008-08-23,East Stirling,Forfar Athletic,0,3,-3,L
92983,8,SCO4,2008-08-23,Elgin City,Cowdenbeath,0,2,-2,L
92984,8,SCO4,2008-08-23,Montrose,Annan Athletic,1,1,0,D
92985,8,SCO4,2008-08-30,Annan Athletic,Albion Rovers,2,4,-2,L
92986,8,SCO4,2008-08-30,Berwick Rangers,Forfar Athletic,2,2,0,D
92987,8,SCO4,2008-08-30,Dumbarton,East Stirling,1,1,0,D
92988,8,SCO4,2008-08-30,Montrose,Elgin City,1,0,1,W
92989,8,SCO4,2008-08-30,Stenhousemuir,Cowdenbeath,1,0,1,W
92990,8,SCO4,2008-09-13,Albion Rovers,Dumbarton,1,3,-2,L
92991,8,SCO4,2008-09-13,Cowdenbeath,Berwick Rangers,2,1,1,W
92992,8,SCO4,2008-09-13,East Stirling,Stenhousemuir,0,2,-2,L
92993,8,SCO4,2008-09-13,Elgin City,Annan Athletic,1,2,-1,L
92994,8,SCO4,2008-09-13,Forfar Athletic,Montrose,0,1,-1,L
92995,8,SCO4,2008-09-20,Annan Athletic,Forfar Athletic,1,3,-2,L
92996,8,SCO4,2008-09-20,Dumbarton,Cowdenbeath,2,1,1,W
92997,8,SCO4,2008-09-20,Elgin City,Albion Rovers,1,6,-5,L
92998,8,SCO4,2008-09-20,Montrose,East Stirling,3,0,3,W
92999,8,SCO4,2008-09-20,Stenhousemuir,Berwick Rangers,2,0,2,W
93000,8,SCO4,2008-09-27,Albion Rovers,Stenhousemuir,1,2,-1,L
93001,8,SCO4,2008-09-27,Berwick Rangers,Annan Athletic,3,0,3,W
93002,8,SCO4,2008-09-27,Cowdenbeath,Montrose,2,1,1,W
93003,8,SCO4,2008-09-27,East Stirling,Elgin City,5,2,3,W
93004,8,SCO4,2008-09-27,Forfar Athletic,Dumbarton,2,2,0,D
93005,8,SCO4,2008-10-04,Albion Rovers,Montrose,0,1,-1,L
93006,8,SCO4,2008-10-04,Berwick Rangers,Elgin City,1,1,0,D
93007,8,SCO4,2008-10-04,Cowdenbeath,East Stirling,0,0,0,D
93008,8,SCO4,2008-10-04,Dumbarton,Annan Athletic,4,1,3,W
93009,8,SCO4,2008-10-04,Stenhousemuir,Forfar Athletic,1,1,0,D
93010,8,SCO4,2008-10-18,Annan Athletic,Cowdenbeath,0,1,-1,L
93011,8,SCO4,2008-10-18,East Stirling,Berwick Rangers,1,0,1,W
93012,8,SCO4,2008-10-18,Elgin City,Stenhousemuir,4,2,2,W
93013,8,SCO4,2008-10-18,Forfar Athletic,Albion Rovers,0,0,0,D
93014,8,SCO4,2008-10-18,Montrose,Dumbarton,1,2,-1,L
93015,8,SCO4,2008-11-01,Albion Rovers,Cowdenbeath,3,1,2,W
93016,8,SCO4,2008-11-01,Dumbarton,Berwick Rangers,5,2,3,W
93017,8,SCO4,2008-11-01,Elgin City,Forfar Athletic,0,1,-1,L
93018,8,SCO4,2008-11-01,Montrose,Stenhousemuir,0,3,-3,L
93019,8,SCO4,2008-11-08,Annan Athletic,Montrose,1,2,-1,L
93020,8,SCO4,2008-11-08,Berwick Rangers,Albion Rovers,0,3,-3,L
93021,8,SCO4,2008-11-08,Cowdenbeath,Elgin City,4,1,3,W
93022,8,SCO4,2008-11-08,Forfar Athletic,East Stirling,2,3,-1,L
93023,8,SCO4,2008-11-08,Stenhousemuir,Dumbarton,1,1,0,D
93024,8,SCO4,2008-11-12,East Stirling,Annan Athletic,2,1,1,W
93025,8,SCO4,2008-11-15,Albion Rovers,Annan Athletic,0,1,-1,L
93026,8,SCO4,2008-11-15,Cowdenbeath,Stenhousemuir,1,2,-1,L
93027,8,SCO4,2008-11-15,East Stirling,Dumbarton,5,2,3,W
93028,8,SCO4,2008-11-15,Elgin City,Montrose,1,2,-1,L
93029,8,SCO4,2008-11-15,Forfar Athletic,Berwick Rangers,2,1,1,W
93030,8,SCO4,2008-11-22,Annan Athletic,Elgin City,5,0,5,W
93031,8,SCO4,2008-11-22,Berwick Rangers,Cowdenbeath,2,3,-1,L
93032,8,SCO4,2008-11-22,Dumbarton,Albion Rovers,1,1,0,D
93033,8,SCO4,2008-11-22,Montrose,Forfar Athletic,1,0,1,W
93034,8,SCO4,2008-11-22,Stenhousemuir,East Stirling,1,1,0,D
93035,8,SCO4,2008-12-06,Berwick Rangers,Stenhousemuir,3,2,1,W
93036,8,SCO4,2008-12-06,East Stirling,Montrose,5,0,5,W
93037,8,SCO4,2008-12-13,Annan Athletic,Berwick Rangers,1,2,-1,L
93038,8,SCO4,2008-12-13,Dumbarton,Forfar Athletic,3,0,3,W
93039,8,SCO4,2008-12-13,Elgin City,East Stirling,0,4,-4,L
93040,8,SCO4,2008-12-13,Montrose,Cowdenbeath,0,1,-1,L
93041,8,SCO4,2008-12-13,Stenhousemuir,Albion Rovers,1,0,1,W
93042,8,SCO4,2008-12-20,Annan Athletic,Dumbarton,2,1,1,W
93043,8,SCO4,2008-12-20,East Stirling,Cowdenbeath,1,4,-3,L
93044,8,SCO4,2008-12-20,Elgin City,Berwick Rangers,0,2,-2,L
93045,8,SCO4,2008-12-20,Forfar Athletic,Stenhousemuir,1,0,1,W
93046,8,SCO4,2008-12-20,Montrose,Albion Rovers,1,2,-1,L
93047,8,SCO4,2008-12-27,Berwick Rangers,Montrose,3,2,1,W
93048,8,SCO4,2008-12-27,Stenhousemuir,Annan Athletic,0,0,0,D
93049,8,SCO4,2009-01-03,East Stirling,Stenhousemuir,0,3,-3,L
93050,8,SCO4,2009-01-10,Cowdenbeath,Dumbarton,2,0,2,W
93051,8,SCO4,2009-01-10,Montrose,Elgin City,3,1,2,W
93052,8,SCO4,2009-01-13,Cowdenbeath,Berwick Rangers,2,0,2,W
93053,8,SCO4,2009-01-17,Albion Rovers,Berwick Rangers,2,1,1,W
93054,8,SCO4,2009-01-17,Dumbarton,Stenhousemuir,1,0,1,W
93055,8,SCO4,2009-01-17,East Stirling,Forfar Athletic,3,2,1,W
93056,8,SCO4,2009-01-17,Elgin City,Cowdenbeath,1,1,0,D
93057,8,SCO4,2009-01-17,Montrose,Annan Athletic,0,3,-3,L
93058,8,SCO4,2009-01-24,Annan Athletic,East Stirling,4,0,4,W
93059,8,SCO4,2009-01-24,Berwick Rangers,Dumbarton,1,2,-1,L
93060,8,SCO4,2009-01-24,Cowdenbeath,Albion Rovers,2,1,1,W
93061,8,SCO4,2009-01-24,Stenhousemuir,Montrose,1,3,-2,L
93062,8,SCO4,2009-01-31,Albion Rovers,Forfar Athletic,2,0,2,W
93063,8,SCO4,2009-01-31,Cowdenbeath,Annan Athletic,1,0,1,W
93064,8,SCO4,2009-01-31,Dumbarton,Montrose,1,1,0,D
93065,8,SCO4,2009-01-31,Stenhousemuir,Elgin City,4,2,2,W
93066,8,SCO4,2009-02-07,Annan Athletic,Stenhousemuir,1,1,0,D
93067,8,SCO4,2009-02-07,East Stirling,Albion Rovers,0,1,-1,L
93068,8,SCO4,2009-02-07,Montrose,Berwick Rangers,1,1,0,D
93069,8,SCO4,2009-02-14,East Stirling,Elgin City,1,0,1,W
93070,8,SCO4,2009-02-21,Annan Athletic,Forfar Athletic,1,0,1,W
93071,8,SCO4,2009-02-21,Dumbarton,Cowdenbeath,1,1,0,D
93072,8,SCO4,2009-02-21,Elgin City,Albion Rovers,1,0,1,W
93073,8,SCO4,2009-02-21,Montrose,East Stirling,0,2,-2,L
93074,8,SCO4,2009-02-21,Stenhousemuir,Berwick Rangers,1,2,-1,L
93075,8,SCO4,2009-02-24,Berwick Rangers,Annan Athletic,1,1,0,D
93076,8,SCO4,2009-02-28,Albion Rovers,Annan Athletic,2,1,1,W
93077,8,SCO4,2009-02-28,Cowdenbeath,Stenhousemuir,1,0,1,W
93078,8,SCO4,2009-02-28,East Stirling,Dumbarton,3,1,2,W
93079,8,SCO4,2009-02-28,Elgin City,Montrose,1,0,1,W
93080,8,SCO4,2009-02-28,Forfar Athletic,Berwick Rangers,5,4,1,W
93081,8,SCO4,2009-03-03,Albion Rovers,Elgin City,2,1,1,W
93082,8,SCO4,2009-03-03,Dumbarton,East Stirling,2,0,2,W
93083,8,SCO4,2009-03-03,Forfar Athletic,Annan Athletic,2,1,1,W
93084,8,SCO4,2009-03-03,Stenhousemuir,Cowdenbeath,1,0,1,W
93085,8,SCO4,2009-03-07,Annan Athletic,Elgin City,6,0,6,W
93086,8,SCO4,2009-03-07,Berwick Rangers,Cowdenbeath,1,0,1,W
93087,8,SCO4,2009-03-07,Dumbarton,Albion Rovers,1,0,1,W
93088,8,SCO4,2009-03-07,Montrose,Forfar Athletic,1,3,-2,L
93089,8,SCO4,2009-03-07,Stenhousemuir,East Stirling,1,4,-3,L
93090,8,SCO4,2009-03-10,Albion Rovers,East Stirling,0,2,-2,L
93091,8,SCO4,2009-03-10,Cowdenbeath,Forfar Athletic,0,0,0,D
93092,8,SCO4,2009-03-10,Dumbarton,Elgin City,2,0,2,W
93093,8,SCO4,2009-03-14,Annan Athletic,Cowdenbeath,3,1,2,W
93094,8,SCO4,2009-03-14,East Stirling,Berwick Rangers,0,4,-4,L
93095,8,SCO4,2009-03-14,Elgin City,Stenhousemuir,2,0,2,W
93096,8,SCO4,2009-03-14,Forfar Athletic,Albion Rovers,4,0,4,W
93097,8,SCO4,2009-03-14,Montrose,Dumbarton,1,0,1,W
93098,8,SCO4,2009-03-17,Albion Rovers,Dumbarton,1,1,0,D
93099,8,SCO4,2009-03-17,Berwick Rangers,Forfar Athletic,0,2,-2,L
93100,8,SCO4,2009-03-17,Cowdenbeath,Montrose,2,1,1,W
93101,8,SCO4,2009-03-21,Albion Rovers,Montrose,0,1,-1,L
93102,8,SCO4,2009-03-21,Berwick Rangers,Elgin City,2,1,1,W
93103,8,SCO4,2009-03-21,Cowdenbeath,East Stirling,2,0,2,W
93104,8,SCO4,2009-03-21,Dumbarton,Annan Athletic,0,2,-2,L
93105,8,SCO4,2009-03-21,Stenhousemuir,Forfar Athletic,0,1,-1,L
93106,8,SCO4,2009-03-24,Forfar Athletic,Elgin City,1,1,0,D
93107,8,SCO4,2009-03-25,Annan Athletic,Albion Rovers,1,1,0,D
93108,8,SCO4,2009-03-28,Berwick Rangers,East Stirling,1,2,-1,L
93109,8,SCO4,2009-03-28,Elgin City,Annan Athletic,0,1,-1,L
93110,8,SCO4,2009-03-28,Forfar Athletic,Montrose,0,3,-3,L
93111,8,SCO4,2009-03-31,Albion Rovers,Stenhousemuir,1,2,-1,L
93112,8,SCO4,2009-03-31,Elgin City,Dumbarton,0,2,-2,L
93113,8,SCO4,2009-03-31,Forfar Athletic,Cowdenbeath,1,1,0,D
93114,8,SCO4,2009-04-04,Annan Athletic,Montrose,2,1,1,W
93115,8,SCO4,2009-04-04,Berwick Rangers,Albion Rovers,1,1,0,D
93116,8,SCO4,2009-04-04,Cowdenbeath,Elgin City,1,1,0,D
93117,8,SCO4,2009-04-04,Forfar Athletic,East Stirling,0,2,-2,L
93118,8,SCO4,2009-04-04,Stenhousemuir,Dumbarton,0,2,-2,L
93119,8,SCO4,2009-04-07,Forfar Athletic,Dumbarton,0,2,-2,L
93120,8,SCO4,2009-04-11,Albion Rovers,Cowdenbeath,0,0,0,D
93121,8,SCO4,2009-04-11,Dumbarton,Berwick Rangers,2,0,2,W
93122,8,SCO4,2009-04-11,East Stirling,Annan Athletic,1,1,0,D
93123,8,SCO4,2009-04-11,Elgin City,Forfar Athletic,1,4,-3,L
93124,8,SCO4,2009-04-11,Montrose,Stenhousemuir,5,3,2,W
93125,8,SCO4,2009-04-18,Albion Rovers,Elgin City,0,3,-3,L
93126,8,SCO4,2009-04-18,Berwick Rangers,Stenhousemuir,0,3,-3,L
93127,8,SCO4,2009-04-18,Cowdenbeath,Dumbarton,0,0,0,D
93128,8,SCO4,2009-04-18,East Stirling,Montrose,2,1,1,W
93129,8,SCO4,2009-04-18,Forfar Athletic,Annan Athletic,2,1,1,W
93130,8,SCO4,2009-04-25,Annan Athletic,Berwick Rangers,1,1,0,D
93131,8,SCO4,2009-04-25,Dumbarton,Forfar Athletic,4,0,4,W
93132,8,SCO4,2009-04-25,Elgin City,East Stirling,0,2,-2,L
93133,8,SCO4,2009-04-25,Montrose,Cowdenbeath,2,1,1,W
93134,8,SCO4,2009-04-25,Stenhousemuir,Albion Rovers,2,0,2,W
93135,8,SCO4,2009-05-02,Albion Rovers,East Stirling,0,2,-2,L
93136,8,SCO4,2009-05-02,Berwick Rangers,Montrose,0,1,-1,L
93137,8,SCO4,2009-05-02,Cowdenbeath,Forfar Athletic,2,2,0,D
93138,8,SCO4,2009-05-02,Dumbarton,Elgin City,6,0,6,W
93139,8,SCO4,2009-05-02,Stenhousemuir,Annan Athletic,1,0,1,W
93140,8,SCO4,2009-05-09,Annan Athletic,Dumbarton,1,3,-2,L
93141,8,SCO4,2009-05-09,East Stirling,Cowdenbeath,0,2,-2,L
93142,8,SCO4,2009-05-09,Elgin City,Berwick Rangers,2,0,2,W
93143,8,SCO4,2009-05-09,Forfar Athletic,Stenhousemuir,4,4,0,D
93144,8,SCO4,2009-05-09,Montrose,Albion Rovers,1,0,1,W
93145,9,SCO4,2009-08-08,Berwick Rangers,Annan Athletic,2,1,1,W
93146,9,SCO4,2009-08-08,Montrose,Elgin City,1,1,0,D
93147,9,SCO4,2009-08-08,Queens Park,Forfar Athletic,2,2,0,D
93148,9,SCO4,2009-08-08,Stranraer,Albion Rovers,1,1,0,D
93149,9,SCO4,2009-08-15,Albion Rovers,Berwick Rangers,2,1,1,W
93150,9,SCO4,2009-08-15,Annan Athletic,East Stirling,0,1,-1,L
93151,9,SCO4,2009-08-15,Elgin City,Queens Park,0,1,-1,L
93152,9,SCO4,2009-08-15,Forfar Athletic,Stranraer,1,0,1,W
93153,9,SCO4,2009-08-15,Livingston,Montrose,2,0,2,W
93154,9,SCO4,2009-08-22,Berwick Rangers,Livingston,1,0,1,W
93155,9,SCO4,2009-08-22,East Stirling,Elgin City,1,1,0,D
93156,9,SCO4,2009-08-22,Montrose,Forfar Athletic,1,2,-1,L
93157,9,SCO4,2009-08-22,Stranraer,Annan Athletic,2,0,2,W
93158,9,SCO4,2009-08-29,Albion Rovers,Livingston,1,0,1,W
93159,9,SCO4,2009-08-29,Berwick Rangers,Queens Park,1,0,1,W
93160,9,SCO4,2009-08-29,Elgin City,Annan Athletic,1,1,0,D
93161,9,SCO4,2009-08-29,Forfar Athletic,East Stirling,5,1,4,W
93162,9,SCO4,2009-08-29,Stranraer,Montrose,2,0,2,W
93163,9,SCO4,2009-09-12,Annan Athletic,Forfar Athletic,1,0,1,W
93164,9,SCO4,2009-09-12,East Stirling,Queens Park,1,0,1,W
93165,9,SCO4,2009-09-12,Livingston,Elgin City,3,2,1,W
93166,9,SCO4,2009-09-12,Montrose,Albion Rovers,0,0,0,D
93167,9,SCO4,2009-09-19,Albion Rovers,Forfar Athletic,1,1,0,D
93168,9,SCO4,2009-09-19,Elgin City,Berwick Rangers,3,3,0,D
93169,9,SCO4,2009-09-19,Montrose,East Stirling,0,3,-3,L
93170,9,SCO4,2009-09-19,Queens Park,Annan Athletic,0,0,0,D
93171,9,SCO4,2009-09-19,Stranraer,Livingston,0,3,-3,L
93172,9,SCO4,2009-09-22,Berwick Rangers,Stranraer,1,0,1,W
93173,9,SCO4,2009-09-26,Annan Athletic,Albion Rovers,0,0,0,D
93174,9,SCO4,2009-09-26,Berwick Rangers,Montrose,2,0,2,W
93175,9,SCO4,2009-09-26,East Stirling,Stranraer,1,1,0,D
93176,9,SCO4,2009-09-26,Forfar Athletic,Elgin City,3,3,0,D
93177,9,SCO4,2009-09-26,Livingston,Queens Park,2,1,1,W
93178,9,SCO4,2009-09-29,Queens Park,Albion Rovers,0,1,-1,L
93179,9,SCO4,2009-09-30,East Stirling,Livingston,3,1,2,W
93180,9,SCO4,2009-10-03,Albion Rovers,East Stirling,3,0,3,W
93181,9,SCO4,2009-10-03,Berwick Rangers,Forfar Athletic,0,1,-1,L
93182,9,SCO4,2009-10-03,Stranraer,Elgin City,0,2,-2,L
93183,9,SCO4,2009-10-10,Annan Athletic,Montrose,2,0,2,W
93184,9,SCO4,2009-10-10,East Stirling,Berwick Rangers,1,0,1,W
93185,9,SCO4,2009-10-10,Elgin City,Albion Rovers,0,2,-2,L
93186,9,SCO4,2009-10-10,Forfar Athletic,Livingston,0,1,-1,L
93187,9,SCO4,2009-10-10,Queens Park,Stranraer,1,2,-1,L
93188,9,SCO4,2009-10-13,Livingston,Annan Athletic,2,0,2,W
93189,9,SCO4,2009-10-13,Montrose,Queens Park,1,2,-1,L
93190,9,SCO4,2009-10-17,Albion Rovers,Queens Park,0,1,-1,L
93191,9,SCO4,2009-10-17,Annan Athletic,Stranraer,1,0,1,W
93192,9,SCO4,2009-10-17,Elgin City,East Stirling,1,2,-1,L
93193,9,SCO4,2009-10-17,Forfar Athletic,Montrose,2,2,0,D
93194,9,SCO4,2009-10-17,Livingston,Berwick Rangers,1,1,0,D
93195,9,SCO4,2009-10-31,Berwick Rangers,Albion Rovers,2,0,2,W
93196,9,SCO4,2009-10-31,East Stirling,Annan Athletic,1,3,-2,L
93197,9,SCO4,2009-10-31,Montrose,Livingston,0,3,-3,L
93198,9,SCO4,2009-10-31,Queens Park,Elgin City,0,3,-3,L
93199,9,SCO4,2009-10-31,Stranraer,Forfar Athletic,1,0,1,W
93200,9,SCO4,2009-11-07,Albion Rovers,Montrose,0,0,0,D
93201,9,SCO4,2009-11-07,Elgin City,Livingston,1,6,-5,L
93202,9,SCO4,2009-11-07,Forfar Athletic,Annan Athletic,2,1,1,W
93203,9,SCO4,2009-11-07,Queens Park,East Stirling,1,0,1,W
93204,9,SCO4,2009-11-07,Stranraer,Berwick Rangers,2,4,-2,L
93205,9,SCO4,2009-11-14,Annan Athletic,Elgin City,0,2,-2,L
93206,9,SCO4,2009-11-14,Berwick Rangers,Queens Park,1,1,0,D
93207,9,SCO4,2009-11-14,East Stirling,Forfar Athletic,2,1,1,W
93208,9,SCO4,2009-11-14,Montrose,Stranraer,1,1,0,D
93209,9,SCO4,2009-11-21,Albion Rovers,Annan Athletic,0,0,0,D
93210,9,SCO4,2009-11-21,Elgin City,Forfar Athletic,0,2,-2,L
93211,9,SCO4,2009-11-21,Queens Park,Livingston,1,2,-1,L
93212,9,SCO4,2009-11-21,Stranraer,East Stirling,1,2,-1,L
93213,9,SCO4,2009-11-24,Livingston,Albion Rovers,2,0,2,W
93214,9,SCO4,2009-12-01,Montrose,Berwick Rangers,1,3,-2,L
93215,9,SCO4,2009-12-05,Annan Athletic,Queens Park,3,1,2,W
93216,9,SCO4,2009-12-05,Berwick Rangers,Elgin City,2,0,2,W
93217,9,SCO4,2009-12-05,Forfar Athletic,Albion Rovers,2,2,0,D
93218,9,SCO4,2009-12-05,Livingston,Stranraer,3,0,3,W
93219,9,SCO4,2009-12-06,East Stirling,Montrose,1,0,1,W
93220,9,SCO4,2009-12-12,Albion Rovers,Elgin City,1,1,0,D
93221,9,SCO4,2009-12-12,Berwick Rangers,East Stirling,0,1,-1,L
93222,9,SCO4,2009-12-12,Livingston,Forfar Athletic,1,2,-1,L
93223,9,SCO4,2009-12-12,Montrose,Annan Athletic,0,0,0,D
93224,9,SCO4,2009-12-12,Stranraer,Queens Park,1,1,0,D
93225,9,SCO4,2009-12-19,Queens Park,Montrose,3,2,1,W
93226,9,SCO4,2010-01-16,Montrose,Stranraer,4,5,-1,L
93227,9,SCO4,2010-01-16,Queens Park,Berwick Rangers,2,0,2,W
93228,9,SCO4,2010-01-23,Albion Rovers,Forfar Athletic,0,1,-1,L
93229,9,SCO4,2010-01-23,Elgin City,Berwick Rangers,1,5,-4,L
93230,9,SCO4,2010-01-23,Montrose,East Stirling,0,1,-1,L
93231,9,SCO4,2010-01-23,Queens Park,Annan Athletic,3,2,1,W
93232,9,SCO4,2010-01-23,Stranraer,Livingston,1,1,0,D
93233,9,SCO4,2010-01-26,Livingston,Elgin City,1,0,1,W
93234,9,SCO4,2010-01-30,Berwick Rangers,Montrose,0,2,-2,L
93235,9,SCO4,2010-01-30,East Stirling,Stranraer,2,0,2,W
93236,9,SCO4,2010-02-02,Livingston,Queens Park,2,0,2,W
93237,9,SCO4,2010-02-06,East Stirling,Berwick Rangers,3,2,1,W
93238,9,SCO4,2010-02-06,Elgin City,Albion Rovers,3,1,2,W
93239,9,SCO4,2010-02-06,Forfar Athletic,Livingston,2,2,0,D
93240,9,SCO4,2010-02-06,Queens Park,Stranraer,2,5,-3,L
93241,9,SCO4,2010-02-09,Albion Rovers,Livingston,0,2,-2,L
93242,9,SCO4,2010-02-09,Annan Athletic,Berwick Rangers,1,1,0,D
93243,9,SCO4,2010-02-10,East Stirling,Elgin City,2,0,2,W
93244,9,SCO4,2010-02-13,Berwick Rangers,Forfar Athletic,0,4,-4,L
93245,9,SCO4,2010-02-13,Livingston,Annan Athletic,3,2,1,W
93246,9,SCO4,2010-02-13,Montrose,Queens Park,1,2,-1,L
93247,9,SCO4,2010-02-16,Forfar Athletic,Elgin City,1,0,1,W
93248,9,SCO4,2010-02-17,Annan Athletic,Albion Rovers,1,2,-1,L
93249,9,SCO4,2010-02-20,Berwick Rangers,Annan Athletic,0,2,-2,L
93250,9,SCO4,2010-02-20,East Stirling,Livingston,0,2,-2,L
93251,9,SCO4,2010-02-20,Montrose,Elgin City,0,4,-4,L
93252,9,SCO4,2010-02-20,Queens Park,Forfar Athletic,1,3,-2,L
93253,9,SCO4,2010-02-27,Annan Athletic,East Stirling,1,0,1,W
93254,9,SCO4,2010-03-02,Annan Athletic,Forfar Athletic,1,1,0,D
93255,9,SCO4,2010-03-02,East Stirling,Queens Park,0,3,-3,L
93256,9,SCO4,2010-03-02,Montrose,Albion Rovers,0,0,0,D
93257,9,SCO4,2010-03-06,Annan Athletic,Elgin City,3,3,0,D
93258,9,SCO4,2010-03-06,East Stirling,Forfar Athletic,4,0,4,W
93259,9,SCO4,2010-03-06,Queens Park,Berwick Rangers,2,3,-1,L
93260,9,SCO4,2010-03-06,Stranraer,Montrose,0,2,-2,L
93261,9,SCO4,2010-03-09,Albion Rovers,Berwick Rangers,4,1,3,W
93262,9,SCO4,2010-03-09,Forfar Athletic,Queens Park,0,1,-1,L
93263,9,SCO4,2010-03-09,Livingston,East Stirling,2,0,2,W
93264,9,SCO4,2010-03-13,Albion Rovers,Montrose,1,0,1,W
93265,9,SCO4,2010-03-13,Elgin City,Livingston,0,1,-1,L
93266,9,SCO4,2010-03-13,Forfar Athletic,Annan Athletic,1,5,-4,L
93267,9,SCO4,2010-03-13,Queens Park,East Stirling,2,0,2,W
93268,9,SCO4,2010-03-13,Stranraer,Berwick Rangers,3,1,2,W
93269,9,SCO4,2010-03-16,Annan Athletic,Livingston,0,0,0,D
93270,9,SCO4,2010-03-16,Montrose,Forfar Athletic,4,0,4,W
93271,9,SCO4,2010-03-16,Stranraer,Elgin City,2,1,1,W
93272,9,SCO4,2010-03-17,East Stirling,Albion Rovers,2,0,2,W
93273,9,SCO4,2010-03-20,Annan Athletic,Queens Park,0,2,-2,L
93274,9,SCO4,2010-03-20,Berwick Rangers,Elgin City,2,1,1,W
93275,9,SCO4,2010-03-20,East Stirling,Montrose,2,3,-1,L
93276,9,SCO4,2010-03-20,Forfar Athletic,Albion Rovers,1,1,0,D
93277,9,SCO4,2010-03-20,Livingston,Stranraer,2,1,1,W
93278,9,SCO4,2010-03-23,Albion Rovers,East Stirling,2,1,1,W
93279,9,SCO4,2010-03-23,Elgin City,Montrose,0,1,-1,L
93280,9,SCO4,2010-03-23,Forfar Athletic,Berwick Rangers,3,0,3,W
93281,9,SCO4,2010-03-24,Stranraer,Annan Athletic,3,2,1,W
93282,9,SCO4,2010-03-27,Albion Rovers,Annan Athletic,1,0,1,W
93283,9,SCO4,2010-03-27,Elgin City,Forfar Athletic,0,2,-2,L
93284,9,SCO4,2010-03-27,Montrose,Berwick Rangers,1,1,0,D
93285,9,SCO4,2010-03-27,Queens Park,Livingston,0,1,-1,L
93286,9,SCO4,2010-03-27,Stranraer,East Stirling,2,2,0,D
93287,9,SCO4,2010-03-30,Elgin City,Queens Park,0,1,-1,L
93288,9,SCO4,2010-03-30,Forfar Athletic,East Stirling,4,1,3,W
93289,9,SCO4,2010-04-03,Annan Athletic,Livingston,2,0,2,W
93290,9,SCO4,2010-04-03,East Stirling,Albion Rovers,3,1,2,W
93291,9,SCO4,2010-04-03,Elgin City,Stranraer,1,2,-1,L
93292,9,SCO4,2010-04-03,Forfar Athletic,Berwick Rangers,2,0,2,W
93293,9,SCO4,2010-04-03,Queens Park,Montrose,3,0,3,W
93294,9,SCO4,2010-04-06,Berwick Rangers,Stranraer,1,0,1,W
93295,9,SCO4,2010-04-06,Elgin City,Annan Athletic,1,0,1,W
93296,9,SCO4,2010-04-06,Livingston,Montrose,1,0,1,W
93297,9,SCO4,2010-04-10,Albion Rovers,Elgin City,1,2,-1,L
93298,9,SCO4,2010-04-10,Berwick Rangers,East Stirling,2,2,0,D
93299,9,SCO4,2010-04-10,Livingston,Forfar Athletic,2,3,-1,L
93300,9,SCO4,2010-04-10,Montrose,Annan Athletic,1,2,-1,L
93301,9,SCO4,2010-04-10,Stranraer,Queens Park,0,0,0,D
93302,9,SCO4,2010-04-12,Albion Rovers,Stranraer,3,1,2,W
93303,9,SCO4,2010-04-13,Annan Athletic,Montrose,0,0,0,D
93304,9,SCO4,2010-04-13,Berwick Rangers,Livingston,1,1,0,D
93305,9,SCO4,2010-04-14,Stranraer,Albion Rovers,2,1,1,W
93306,9,SCO4,2010-04-17,Albion Rovers,Queens Park,1,0,1,W
93307,9,SCO4,2010-04-17,Annan Athletic,Stranraer,3,2,1,W
93308,9,SCO4,2010-04-17,Elgin City,East Stirling,0,1,-1,L
93309,9,SCO4,2010-04-17,Forfar Athletic,Montrose,2,0,2,W
93310,9,SCO4,2010-04-17,Livingston,Berwick Rangers,0,0,0,D
93311,9,SCO4,2010-04-20,Forfar Athletic,Stranraer,2,0,2,W
93312,9,SCO4,2010-04-20,Queens Park,Albion Rovers,1,0,1,W
93313,9,SCO4,2010-04-24,Berwick Rangers,Albion Rovers,1,2,-1,L
93314,9,SCO4,2010-04-24,East Stirling,Annan Athletic,3,1,2,W
93315,9,SCO4,2010-04-24,Montrose,Livingston,0,5,-5,L
93316,9,SCO4,2010-04-24,Queens Park,Elgin City,0,1,-1,L
93317,9,SCO4,2010-04-24,Stranraer,Forfar Athletic,2,0,2,W
93318,9,SCO4,2010-04-27,Elgin City,Stranraer,2,3,-1,L
93319,9,SCO4,2010-04-27,Livingston,Albion Rovers,2,0,2,W
93320,9,SCO4,2010-05-01,Albion Rovers,Stranraer,0,0,0,D
93321,9,SCO4,2010-05-01,Annan Athletic,Berwick Rangers,0,1,-1,L
93322,9,SCO4,2010-05-01,Elgin City,Montrose,5,2,3,W
93323,9,SCO4,2010-05-01,Forfar Athletic,Queens Park,1,1,0,D
93324,9,SCO4,2010-05-01,Livingston,East Stirling,1,0,1,W
93325,10,SCO4,2010-08-07,Albion Rovers,Berwick Rangers,2,2,0,D
93326,10,SCO4,2010-08-07,Annan Athletic,East Stirling,3,1,2,W
93327,10,SCO4,2010-08-07,Clyde,Stranraer,2,2,0,D
93328,10,SCO4,2010-08-07,Elgin City,Arbroath,3,5,-2,L
93329,10,SCO4,2010-08-07,Montrose,Queens Park,1,2,-1,L
93330,10,SCO4,2010-08-14,Arbroath,Annan Athletic,0,2,-2,L
93331,10,SCO4,2010-08-14,Berwick Rangers,Elgin City,6,2,4,W
93332,10,SCO4,2010-08-14,East Stirling,Montrose,2,1,1,W
93333,10,SCO4,2010-08-14,Queens Park,Clyde,0,1,-1,L
93334,10,SCO4,2010-08-14,Stranraer,Albion Rovers,3,2,1,W
93335,10,SCO4,2010-08-21,Albion Rovers,Queens Park,2,1,1,W
93336,10,SCO4,2010-08-21,Annan Athletic,Stranraer,2,2,0,D
93337,10,SCO4,2010-08-21,Clyde,Berwick Rangers,1,4,-3,L
93338,10,SCO4,2010-08-21,Elgin City,East Stirling,0,2,-2,L
93339,10,SCO4,2010-08-21,Montrose,Arbroath,3,0,3,W
93340,10,SCO4,2010-08-28,Arbroath,East Stirling,2,0,2,W
93341,10,SCO4,2010-08-28,Clyde,Albion Rovers,1,2,-1,L
93342,10,SCO4,2010-08-28,Elgin City,Stranraer,1,2,-1,L
93343,10,SCO4,2010-08-28,Montrose,Annan Athletic,1,1,0,D
93344,10,SCO4,2010-08-28,Queens Park,Berwick Rangers,0,2,-2,L
93345,10,SCO4,2010-09-04,Arbroath,Queens Park,1,0,1,W
93346,10,SCO4,2010-09-11,Albion Rovers,Montrose,3,1,2,W
93347,10,SCO4,2010-09-11,Annan Athletic,Elgin City,0,1,-1,L
93348,10,SCO4,2010-09-11,Berwick Rangers,Arbroath,4,1,3,W
93349,10,SCO4,2010-09-11,East Stirling,Clyde,0,0,0,D
93350,10,SCO4,2010-09-11,Stranraer,Queens Park,1,0,1,W
93351,10,SCO4,2010-09-18,Arbroath,Albion Rovers,1,1,0,D
93352,10,SCO4,2010-09-18,Berwick Rangers,Stranraer,2,2,0,D
93353,10,SCO4,2010-09-18,Clyde,Annan Athletic,0,2,-2,L
93354,10,SCO4,2010-09-18,Elgin City,Montrose,3,2,1,W
93355,10,SCO4,2010-09-18,Queens Park,East Stirling,2,0,2,W
93356,10,SCO4,2010-09-25,Albion Rovers,Elgin City,3,1,2,W
93357,10,SCO4,2010-09-25,Annan Athletic,Queens Park,2,1,1,W
93358,10,SCO4,2010-09-25,East Stirling,Berwick Rangers,0,0,0,D
93359,10,SCO4,2010-09-25,Montrose,Clyde,8,1,7,W
93360,10,SCO4,2010-09-25,Stranraer,Arbroath,4,1,3,W
93361,10,SCO4,2010-10-02,Albion Rovers,East Stirling,1,0,1,W
93362,10,SCO4,2010-10-02,Berwick Rangers,Annan Athletic,2,2,0,D
93363,10,SCO4,2010-10-02,Clyde,Elgin City,1,1,0,D
93364,10,SCO4,2010-10-02,Queens Park,Arbroath,5,2,3,W
93365,10,SCO4,2010-10-02,Stranraer,Montrose,1,2,-1,L
93366,10,SCO4,2010-10-09,Elgin City,East Stirling,2,0,2,W
93367,10,SCO4,2010-10-09,Montrose,Stranraer,3,3,0,D
93368,10,SCO4,2010-10-16,Annan Athletic,Albion Rovers,4,1,3,W
93369,10,SCO4,2010-10-16,Arbroath,Clyde,3,2,1,W
93370,10,SCO4,2010-10-16,East Stirling,Stranraer,0,1,-1,L
93371,10,SCO4,2010-10-16,Elgin City,Queens Park,4,2,2,W
93372,10,SCO4,2010-10-16,Montrose,Berwick Rangers,1,1,0,D
93373,10,SCO4,2010-10-30,Albion Rovers,Clyde,3,1,2,W
93374,10,SCO4,2010-10-30,Berwick Rangers,Queens Park,1,1,0,D
93375,10,SCO4,2010-10-30,Stranraer,Elgin City,2,1,1,W
93376,10,SCO4,2010-11-06,Arbroath,Berwick Rangers,3,2,1,W
93377,10,SCO4,2010-11-06,Clyde,East Stirling,1,2,-1,L
93378,10,SCO4,2010-11-06,Elgin City,Annan Athletic,2,0,2,W
93379,10,SCO4,2010-11-06,Montrose,Albion Rovers,0,2,-2,L
93380,10,SCO4,2010-11-06,Queens Park,Stranraer,1,3,-2,L
93381,10,SCO4,2010-11-09,Annan Athletic,Montrose,2,2,0,D
93382,10,SCO4,2010-11-10,East Stirling,Arbroath,1,3,-2,L
93383,10,SCO4,2010-11-13,Arbroath,Montrose,4,0,4,W
93384,10,SCO4,2010-11-13,Berwick Rangers,Clyde,2,1,1,W
93385,10,SCO4,2010-11-13,East Stirling,Elgin City,0,2,-2,L
93386,10,SCO4,2010-11-13,Queens Park,Albion Rovers,0,1,-1,L
93387,10,SCO4,2010-11-13,Stranraer,Annan Athletic,2,2,0,D
93388,10,SCO4,2010-12-11,Montrose,Elgin City,0,1,-1,L
93389,10,SCO4,2010-12-11,Stranraer,Berwick Rangers,1,1,0,D
93390,10,SCO4,2010-12-14,Elgin City,Albion Rovers,2,2,0,D
93391,10,SCO4,2010-12-15,Arbroath,Stranraer,0,0,0,D
93392,10,SCO4,2010-12-18,Queens Park,Elgin City,1,1,0,D
93393,10,SCO4,2011-01-02,Montrose,Arbroath,0,5,-5,L
93394,10,SCO4,2011-01-15,Albion Rovers,Montrose,0,2,-2,L
93395,10,SCO4,2011-01-15,Annan Athletic,Elgin City,2,2,0,D
93396,10,SCO4,2011-01-15,Berwick Rangers,Arbroath,0,4,-4,L
93397,10,SCO4,2011-01-15,East Stirling,Clyde,2,0,2,W
93398,10,SCO4,2011-01-15,Stranraer,Queens Park,2,1,1,W
93399,10,SCO4,2011-01-18,Albion Rovers,Queens Park,1,2,-1,L
93400,10,SCO4,2011-01-22,Elgin City,Stranraer,2,1,1,W
93401,10,SCO4,2011-01-22,Montrose,Annan Athletic,0,1,-1,L
93402,10,SCO4,2011-01-22,Queens Park,Berwick Rangers,1,0,1,W
93403,10,SCO4,2011-01-25,Albion Rovers,Annan Athletic,0,0,0,D
93404,10,SCO4,2011-01-25,Arbroath,East Stirling,3,5,-2,L
93405,10,SCO4,2011-01-29,Albion Rovers,Elgin City,2,0,2,W
93406,10,SCO4,2011-01-29,East Stirling,Berwick Rangers,1,0,1,W
93407,10,SCO4,2011-01-29,Montrose,Clyde,3,1,2,W
93408,10,SCO4,2011-01-29,Stranraer,Arbroath,3,4,-1,L
93409,10,SCO4,2011-02-01,Annan Athletic,Queens Park,1,2,-1,L
93410,10,SCO4,2011-02-05,Arbroath,Albion Rovers,3,0,3,W
93411,10,SCO4,2011-02-05,Clyde,Annan Athletic,0,2,-2,L
93412,10,SCO4,2011-02-05,Elgin City,Montrose,1,0,1,W
93413,10,SCO4,2011-02-05,Queens Park,East Stirling,2,0,2,W
93414,10,SCO4,2011-02-12,Albion Rovers,East Stirling,2,0,2,W
93415,10,SCO4,2011-02-12,Berwick Rangers,Annan Athletic,2,3,-1,L
93416,10,SCO4,2011-02-12,Clyde,Elgin City,3,3,0,D
93417,10,SCO4,2011-02-12,Queens Park,Arbroath,1,1,0,D
93418,10,SCO4,2011-02-12,Stranraer,Montrose,2,2,0,D
93419,10,SCO4,2011-02-15,Albion Rovers,Stranraer,1,2,-1,L
93420,10,SCO4,2011-02-15,Annan Athletic,Arbroath,1,2,-1,L
93421,10,SCO4,2011-02-15,Clyde,Berwick Rangers,2,0,2,W
93422,10,SCO4,2011-02-16,East Stirling,Queens Park,0,1,-1,L
93423,10,SCO4,2011-02-19,Annan Athletic,Albion Rovers,2,2,0,D
93424,10,SCO4,2011-02-19,East Stirling,Stranraer,0,2,-2,L
93425,10,SCO4,2011-02-19,Elgin City,Queens Park,0,1,-1,L
93426,10,SCO4,2011-02-19,Montrose,Berwick Rangers,1,1,0,D
93427,10,SCO4,2011-02-22,Berwick Rangers,Montrose,1,0,1,W
93428,10,SCO4,2011-02-22,Clyde,Albion Rovers,0,1,-1,L
93429,10,SCO4,2011-02-22,Queens Park,Annan Athletic,3,0,3,W
93430,10,SCO4,2011-02-23,Arbroath,Elgin City,2,0,2,W
93431,10,SCO4,2011-02-23,Stranraer,East Stirling,4,1,3,W
93432,10,SCO4,2011-02-26,Albion Rovers,Berwick Rangers,0,1,-1,L
93433,10,SCO4,2011-02-26,Annan Athletic,East Stirling,2,1,1,W
93434,10,SCO4,2011-02-26,Clyde,Stranraer,4,2,2,W
93435,10,SCO4,2011-02-26,Elgin City,Arbroath,3,2,1,W
93436,10,SCO4,2011-02-26,Montrose,Queens Park,0,2,-2,L
93437,10,SCO4,2011-03-01,Annan Athletic,Berwick Rangers,1,1,0,D
93438,10,SCO4,2011-03-01,Stranraer,Clyde,3,1,2,W
93439,10,SCO4,2011-03-02,East Stirling,Albion Rovers,0,0,0,D
93440,10,SCO4,2011-03-05,Arbroath,Annan Athletic,2,1,1,W
93441,10,SCO4,2011-03-05,Berwick Rangers,Elgin City,4,0,4,W
93442,10,SCO4,2011-03-05,East Stirling,Montrose,1,2,-1,L
93443,10,SCO4,2011-03-05,Queens Park,Clyde,4,0,4,W
93444,10,SCO4,2011-03-05,Stranraer,Albion Rovers,1,3,-2,L
93445,10,SCO4,2011-03-08,Albion Rovers,Arbroath,0,2,-2,L
93446,10,SCO4,2011-03-08,Annan Athletic,Stranraer,2,1,1,W
93447,10,SCO4,2011-03-08,Berwick Rangers,East Stirling,3,0,3,W
93448,10,SCO4,2011-03-08,Clyde,Queens Park,2,3,-1,L
93449,10,SCO4,2011-03-12,Arbroath,Berwick Rangers,2,1,1,W
93450,10,SCO4,2011-03-12,Elgin City,Annan Athletic,2,3,-1,L
93451,10,SCO4,2011-03-12,Montrose,Albion Rovers,0,2,-2,L
93452,10,SCO4,2011-03-12,Queens Park,Stranraer,3,3,0,D
93453,10,SCO4,2011-03-15,Berwick Rangers,Albion Rovers,1,6,-5,L
93454,10,SCO4,2011-03-15,East Stirling,Annan Athletic,1,5,-4,L
93455,10,SCO4,2011-03-19,Albion Rovers,Clyde,1,1,0,D
93456,10,SCO4,2011-03-19,Annan Athletic,Montrose,2,1,1,W
93457,10,SCO4,2011-03-19,Berwick Rangers,Queens Park,3,1,2,W
93458,10,SCO4,2011-03-19,East Stirling,Arbroath,2,5,-3,L
93459,10,SCO4,2011-03-19,Stranraer,Elgin City,1,2,-1,L
93460,10,SCO4,2011-03-22,Clyde,Arbroath,1,1,0,D
93461,10,SCO4,2011-03-22,Elgin City,Berwick Rangers,1,2,-1,L
93462,10,SCO4,2011-03-22,Montrose,East Stirling,0,2,-2,L
93463,10,SCO4,2011-03-26,Arbroath,Stranraer,2,2,0,D
93464,10,SCO4,2011-03-26,Berwick Rangers,East Stirling,1,1,0,D
93465,10,SCO4,2011-03-26,Clyde,Montrose,2,0,2,W
93466,10,SCO4,2011-03-26,Elgin City,Albion Rovers,1,1,0,D
93467,10,SCO4,2011-03-26,Queens Park,Annan Athletic,0,1,-1,L
93468,10,SCO4,2011-03-29,Annan Athletic,Clyde,0,2,-2,L
93469,10,SCO4,2011-03-29,Berwick Rangers,Stranraer,3,3,0,D
93470,10,SCO4,2011-03-29,Queens Park,Montrose,1,0,1,W
93471,10,SCO4,2011-04-02,Albion Rovers,Arbroath,3,0,3,W
93472,10,SCO4,2011-04-02,Annan Athletic,Clyde,1,0,1,W
93473,10,SCO4,2011-04-02,East Stirling,Queens Park,3,2,1,W
93474,10,SCO4,2011-04-02,Montrose,Elgin City,1,0,1,W
93475,10,SCO4,2011-04-02,Stranraer,Berwick Rangers,3,1,2,W
93476,10,SCO4,2011-04-05,Clyde,Montrose,1,1,0,D
93477,10,SCO4,2011-04-09,Albion Rovers,Annan Athletic,0,0,0,D
93478,10,SCO4,2011-04-09,Berwick Rangers,Montrose,0,1,-1,L
93479,10,SCO4,2011-04-09,Clyde,Arbroath,0,3,-3,L
93480,10,SCO4,2011-04-09,Queens Park,Elgin City,1,0,1,W
93481,10,SCO4,2011-04-09,Stranraer,East Stirling,2,0,2,W
93482,10,SCO4,2011-04-13,Arbroath,Clyde,2,0,2,W
93483,10,SCO4,2011-04-16,Annan Athletic,Berwick Rangers,2,3,-1,L
93484,10,SCO4,2011-04-16,Arbroath,Queens Park,2,2,0,D
93485,10,SCO4,2011-04-16,East Stirling,Albion Rovers,1,2,-1,L
93486,10,SCO4,2011-04-16,Elgin City,Clyde,0,1,-1,L
93487,10,SCO4,2011-04-16,Montrose,Stranraer,3,2,1,W
93488,10,SCO4,2011-04-19,Clyde,East Stirling,2,0,2,W
93489,10,SCO4,2011-04-23,Arbroath,Montrose,4,1,3,W
93490,10,SCO4,2011-04-23,Berwick Rangers,Clyde,1,1,0,D
93491,10,SCO4,2011-04-23,East Stirling,Elgin City,2,1,1,W
93492,10,SCO4,2011-04-23,Queens Park,Albion Rovers,2,1,1,W
93493,10,SCO4,2011-04-23,Stranraer,Annan Athletic,1,1,0,D
93494,10,SCO4,2011-04-26,Elgin City,Clyde,0,1,-1,L
93495,10,SCO4,2011-04-30,Albion Rovers,Stranraer,1,0,1,W
93496,10,SCO4,2011-04-30,Annan Athletic,Arbroath,3,0,3,W
93497,10,SCO4,2011-04-30,Clyde,Queens Park,0,2,-2,L
93498,10,SCO4,2011-04-30,Elgin City,Berwick Rangers,3,2,1,W
93499,10,SCO4,2011-04-30,Montrose,East Stirling,3,0,3,W
93500,10,SCO4,2011-05-07,Arbroath,Elgin City,3,5,-2,L
93501,10,SCO4,2011-05-07,Berwick Rangers,Albion Rovers,2,2,0,D
93502,10,SCO4,2011-05-07,East Stirling,Annan Athletic,2,0,2,W
93503,10,SCO4,2011-05-07,Queens Park,Montrose,4,1,3,W
93504,10,SCO4,2011-05-07,Stranraer,Clyde,3,0,3,W
93505,12,SCO4,2012-08-11,Berwick Rangers,Elgin City,0,0,0,D
93506,12,SCO4,2012-08-11,East Stirling,Queens Park,0,2,-2,L
93507,12,SCO4,2012-08-11,Montrose,Clyde,2,3,-1,L
93508,12,SCO4,2012-08-11,Peterhead,Glasgow Rangers,2,2,0,D
93509,12,SCO4,2012-08-11,Stirling Albion,Annan Athletic,5,1,4,W
93510,12,SCO4,2012-08-18,Annan Athletic,Berwick Rangers,3,2,1,W
93511,12,SCO4,2012-08-18,Clyde,Peterhead,0,2,-2,L
93512,12,SCO4,2012-08-18,Elgin City,Stirling Albion,3,1,2,W
93513,12,SCO4,2012-08-18,Queens Park,Montrose,2,2,0,D
93514,12,SCO4,2012-08-18,Glasgow Rangers,East Stirling,5,1,4,W
93515,12,SCO4,2012-08-25,East Stirling,Elgin City,1,4,-3,L
93516,12,SCO4,2012-08-25,Montrose,Annan Athletic,0,0,0,D
93517,12,SCO4,2012-08-25,Peterhead,Queens Park,1,0,1,W
93518,12,SCO4,2012-08-25,Stirling Albion,Clyde,0,1,-1,L
93519,12,SCO4,2012-08-26,Berwick Rangers,Glasgow Rangers,1,1,0,D
93520,12,SCO4,2012-09-01,Berwick Rangers,East Stirling,3,0,3,W
93521,12,SCO4,2012-09-01,Clyde,Annan Athletic,2,1,1,W
93522,12,SCO4,2012-09-01,Peterhead,Montrose,2,0,2,W
93523,12,SCO4,2012-09-01,Stirling Albion,Queens Park,1,2,-1,L
93524,12,SCO4,2012-09-02,Glasgow Rangers,Elgin City,5,1,4,W
93525,12,SCO4,2012-09-15,Annan Athletic,Glasgow Rangers,0,0,0,D
93526,12,SCO4,2012-09-15,East Stirling,Stirling Albion,3,1,2,W
93527,12,SCO4,2012-09-15,Elgin City,Peterhead,2,0,2,W
93528,12,SCO4,2012-09-15,Montrose,Berwick Rangers,3,1,2,W
93529,12,SCO4,2012-09-15,Queens Park,Clyde,1,0,1,W
93530,12,SCO4,2012-09-22,Annan Athletic,Peterhead,2,1,1,W
93531,12,SCO4,2012-09-22,Berwick Rangers,Stirling Albion,4,1,3,W
93532,12,SCO4,2012-09-22,East Stirling,Clyde,3,0,3,W
93533,12,SCO4,2012-09-22,Elgin City,Queens Park,0,4,-4,L
93534,12,SCO4,2012-09-23,Glasgow Rangers,Montrose,4,1,3,W
93535,12,SCO4,2012-10-06,Montrose,East Stirling,3,1,2,W
93536,12,SCO4,2012-10-06,Peterhead,Berwick Rangers,1,0,1,W
93537,12,SCO4,2012-10-06,Stirling Albion,Glasgow Rangers,1,0,1,W
93538,12,SCO4,2012-10-13,Elgin City,Montrose,6,1,5,W
93539,12,SCO4,2012-10-13,Queens Park,Annan Athletic,2,2,0,D
93540,12,SCO4,2012-10-17,Clyde,Elgin City,2,2,0,D
93541,12,SCO4,2012-10-20,Berwick Rangers,Clyde,2,1,1,W
93542,12,SCO4,2012-10-20,East Stirling,Peterhead,2,1,1,W
93543,12,SCO4,2012-10-20,Elgin City,Annan Athletic,2,2,0,D
93544,12,SCO4,2012-10-20,Glasgow Rangers,Queens Park,2,0,2,W
93545,12,SCO4,2012-10-20,Stirling Albion,Montrose,1,3,-2,L
93546,12,SCO4,2012-10-27,Annan Athletic,East Stirling,5,2,3,W
93547,12,SCO4,2012-10-27,Montrose,Elgin City,2,2,0,D
93548,12,SCO4,2012-10-27,Peterhead,Stirling Albion,2,2,0,D
93549,12,SCO4,2012-10-27,Queens Park,Berwick Rangers,1,1,0,D
93550,12,SCO4,2012-10-28,Clyde,Glasgow Rangers,0,2,-2,L
93551,12,SCO4,2012-11-10,Annan Athletic,Stirling Albion,5,2,3,W
93552,12,SCO4,2012-11-10,Clyde,Montrose,1,2,-1,L
93553,12,SCO4,2012-11-10,Elgin City,Berwick Rangers,3,1,2,W
93554,12,SCO4,2012-11-10,Glasgow Rangers,Peterhead,2,0,2,W
93555,12,SCO4,2012-11-13,Queens Park,East Stirling,1,2,-1,L
93556,12,SCO4,2012-11-17,Berwick Rangers,Annan Athletic,3,1,2,W
93557,12,SCO4,2012-11-17,East Stirling,Glasgow Rangers,2,6,-4,L
93558,12,SCO4,2012-11-17,Montrose,Queens Park,1,1,0,D
93559,12,SCO4,2012-11-17,Peterhead,Clyde,1,0,1,W
93560,12,SCO4,2012-11-17,Stirling Albion,Elgin City,1,4,-3,L
93561,12,SCO4,2012-11-23,Queens Park,Stirling Albion,2,1,1,W
93562,12,SCO4,2012-11-24,Annan Athletic,Clyde,1,3,-2,L
93563,12,SCO4,2012-11-24,Montrose,Peterhead,2,0,2,W
93564,12,SCO4,2012-11-25,East Stirling,Berwick Rangers,0,1,-1,L
93565,12,SCO4,2012-12-01,Berwick Rangers,Montrose,1,4,-3,L
93566,12,SCO4,2012-12-05,Peterhead,Elgin City,1,1,0,D
93567,12,SCO4,2012-12-08,Annan Athletic,Queens Park,2,3,-1,L
93568,12,SCO4,2012-12-08,Berwick Rangers,Peterhead,1,1,0,D
93569,12,SCO4,2012-12-08,Elgin City,Clyde,2,1,1,W
93570,12,SCO4,2012-12-08,Glasgow Rangers,Stirling Albion,2,0,2,W
93571,12,SCO4,2012-12-15,Clyde,East Stirling,2,1,1,W
93572,12,SCO4,2012-12-15,Montrose,Glasgow Rangers,2,4,-2,L
93573,12,SCO4,2012-12-15,Peterhead,Annan Athletic,2,0,2,W
93574,12,SCO4,2012-12-15,Queens Park,Elgin City,1,1,0,D
93575,12,SCO4,2012-12-15,Stirling Albion,Berwick Rangers,6,3,3,W
93576,12,SCO4,2012-12-18,Glasgow Rangers,Annan Athletic,3,0,3,W
93577,12,SCO4,2012-12-19,East Stirling,Montrose,2,2,0,D
93578,12,SCO4,2012-12-22,East Stirling,Annan Athletic,2,2,0,D
93579,12,SCO4,2012-12-22,Elgin City,Glasgow Rangers,2,6,-4,L
93580,12,SCO4,2012-12-22,Stirling Albion,Peterhead,1,0,1,W
93581,12,SCO4,2012-12-26,Glasgow Rangers,Clyde,3,0,3,W
93582,12,SCO4,2012-12-29,Annan Athletic,Elgin City,2,0,2,W
93583,12,SCO4,2012-12-29,Clyde,Berwick Rangers,2,1,1,W
93584,12,SCO4,2012-12-29,Montrose,Stirling Albion,3,2,1,W
93585,12,SCO4,2012-12-29,Peterhead,East Stirling,2,0,2,W
93586,12,SCO4,2012-12-29,Queens Park,Glasgow Rangers,0,1,-1,L
93587,12,SCO4,2013-01-02,Annan Athletic,Glasgow Rangers,1,3,-2,L
93588,12,SCO4,2013-01-02,East Stirling,Stirling Albion,1,1,0,D
93589,12,SCO4,2013-01-02,Elgin City,Peterhead,0,3,-3,L
93590,12,SCO4,2013-01-02,Montrose,Berwick Rangers,1,3,-2,L
93591,12,SCO4,2013-01-02,Queens Park,Clyde,4,1,3,W
93592,12,SCO4,2013-01-05,Berwick Rangers,East Stirling,2,0,2,W
93593,12,SCO4,2013-01-05,Clyde,Annan Athletic,2,3,-1,L
93594,12,SCO4,2013-01-05,Peterhead,Montrose,0,1,-1,L
93595,12,SCO4,2013-01-05,Glasgow Rangers,Elgin City,1,1,0,D
93596,12,SCO4,2013-01-05,Stirling Albion,Queens Park,2,3,-1,L
93597,12,SCO4,2013-01-12,Annan Athletic,Montrose,2,1,1,W
93598,12,SCO4,2013-01-12,Clyde,Stirling Albion,2,1,1,W
93599,12,SCO4,2013-01-12,Elgin City,East Stirling,3,4,-1,L
93600,12,SCO4,2013-01-12,Queens Park,Peterhead,0,0,0,D
93601,12,SCO4,2013-01-12,Glasgow Rangers,Berwick Rangers,4,2,2,W
93602,12,SCO4,2013-01-19,East Stirling,Queens Park,0,2,-2,L
93603,12,SCO4,2013-01-19,Montrose,Clyde,1,1,0,D
93604,12,SCO4,2013-01-20,Peterhead,Glasgow Rangers,0,1,-1,L
93605,12,SCO4,2013-01-26,Glasgow Rangers,Montrose,1,1,0,D
93606,12,SCO4,2013-01-29,Annan Athletic,Peterhead,0,0,0,D
93607,12,SCO4,2013-02-02,Clyde,Elgin City,1,1,0,D
93608,12,SCO4,2013-02-02,Montrose,East Stirling,2,2,0,D
93609,12,SCO4,2013-02-02,Peterhead,Berwick Rangers,1,1,0,D
93610,12,SCO4,2013-02-02,Queens Park,Annan Athletic,2,2,0,D
93611,12,SCO4,2013-02-09,Berwick Rangers,Clyde,3,3,0,D
93612,12,SCO4,2013-02-09,East Stirling,Peterhead,2,4,-2,L
93613,12,SCO4,2013-02-09,Elgin City,Annan Athletic,3,1,2,W
93614,12,SCO4,2013-02-09,Glasgow Rangers,Queens Park,4,0,4,W
93615,12,SCO4,2013-02-09,Stirling Albion,Montrose,3,1,2,W
93616,12,SCO4,2013-02-12,Stirling Albion,East Stirling,1,1,0,D
93617,12,SCO4,2013-02-16,Annan Athletic,East Stirling,1,2,-1,L
93618,12,SCO4,2013-02-16,Clyde,Glasgow Rangers,1,4,-3,L
93619,12,SCO4,2013-02-16,Montrose,Elgin City,4,1,3,W
93620,12,SCO4,2013-02-16,Peterhead,Stirling Albion,0,0,0,D
93621,12,SCO4,2013-02-16,Queens Park,Berwick Rangers,2,1,1,W
93622,12,SCO4,2013-02-19,East Stirling,Clyde,3,0,3,W
93623,12,SCO4,2013-02-19,Stirling Albion,Annan Athletic,2,1,1,W
93624,12,SCO4,2013-02-23,Berwick Rangers,Glasgow Rangers,1,3,-2,L
93625,12,SCO4,2013-02-23,East Stirling,Elgin City,3,2,1,W
93626,12,SCO4,2013-02-23,Montrose,Annan Athletic,5,1,4,W
93627,12,SCO4,2013-02-23,Peterhead,Queens Park,0,2,-2,L
93628,12,SCO4,2013-02-23,Stirling Albion,Clyde,2,0,2,W
93629,12,SCO4,2013-02-26,Berwick Rangers,Elgin City,2,1,1,W
93630,12,SCO4,2013-02-26,Clyde,Queens Park,0,3,-3,L
93631,12,SCO4,2013-02-26,Stirling Albion,Glasgow Rangers,1,1,0,D
93632,12,SCO4,2013-03-02,Annan Athletic,Berwick Rangers,2,2,0,D
93633,12,SCO4,2013-03-02,Clyde,Peterhead,2,0,2,W
93634,12,SCO4,2013-03-02,Elgin City,Stirling Albion,1,2,-1,L
93635,12,SCO4,2013-03-02,Queens Park,Montrose,1,2,-1,L
93636,12,SCO4,2013-03-02,Glasgow Rangers,East Stirling,3,1,2,W
93637,12,SCO4,2013-03-05,Berwick Rangers,Stirling Albion,1,0,1,W
93638,12,SCO4,2013-03-05,Elgin City,Queens Park,3,5,-2,L
93639,12,SCO4,2013-03-09,Berwick Rangers,Montrose,4,0,4,W
93640,12,SCO4,2013-03-09,Clyde,Queens Park,2,3,-1,L
93641,12,SCO4,2013-03-09,Peterhead,Elgin City,0,1,-1,L
93642,12,SCO4,2013-03-09,Glasgow Rangers,Annan Athletic,1,2,-1,L
93643,12,SCO4,2013-03-09,Stirling Albion,East Stirling,9,1,8,W
93644,12,SCO4,2013-03-12,Berwick Rangers,Queens Park,2,0,2,W
93645,12,SCO4,2013-03-16,Annan Athletic,Clyde,0,1,-1,L
93646,12,SCO4,2013-03-16,East Stirling,Berwick Rangers,0,3,-3,L
93647,12,SCO4,2013-03-16,Elgin City,Glasgow Rangers,0,1,-1,L
93648,12,SCO4,2013-03-16,Montrose,Peterhead,0,6,-6,L
93649,12,SCO4,2013-03-23,Berwick Rangers,Peterhead,0,2,-2,L
93650,12,SCO4,2013-03-23,East Stirling,Montrose,1,2,-1,L
93651,12,SCO4,2013-03-23,Glasgow Rangers,Stirling Albion,0,0,0,D
93652,12,SCO4,2013-03-30,Clyde,East Stirling,2,0,2,W
93653,12,SCO4,2013-03-30,Montrose,Glasgow Rangers,0,0,0,D
93654,12,SCO4,2013-03-30,Peterhead,Annan Athletic,2,0,2,W
93655,12,SCO4,2013-03-30,Queens Park,Elgin City,0,1,-1,L
93656,12,SCO4,2013-03-30,Stirling Albion,Berwick Rangers,1,0,1,W
93657,12,SCO4,2013-04-02,Elgin City,Clyde,4,2,2,W
93658,12,SCO4,2013-04-02,Queens Park,Stirling Albion,2,2,0,D
93659,12,SCO4,2013-04-06,Annan Athletic,Elgin City,2,2,0,D
93660,12,SCO4,2013-04-06,Clyde,Berwick Rangers,2,1,1,W
93661,12,SCO4,2013-04-06,Montrose,Stirling Albion,2,2,0,D
93662,12,SCO4,2013-04-06,Peterhead,East Stirling,6,0,6,W
93663,12,SCO4,2013-04-07,Queens Park,Glasgow Rangers,1,4,-3,L
93664,12,SCO4,2013-04-10,Annan Athletic,Queens Park,2,0,2,W
93665,12,SCO4,2013-04-13,Berwick Rangers,Queens Park,4,1,3,W
93666,12,SCO4,2013-04-13,East Stirling,Annan Athletic,1,2,-1,L
93667,12,SCO4,2013-04-13,Elgin City,Montrose,3,2,1,W
93668,12,SCO4,2013-04-13,Glasgow Rangers,Clyde,2,0,2,W
93669,12,SCO4,2013-04-13,Stirling Albion,Peterhead,0,1,-1,L
93670,12,SCO4,2013-04-20,Annan Athletic,Stirling Albion,0,1,-1,L
93671,12,SCO4,2013-04-20,Clyde,Montrose,1,0,1,W
93672,12,SCO4,2013-04-20,Elgin City,Berwick Rangers,1,2,-1,L
93673,12,SCO4,2013-04-20,Queens Park,East Stirling,5,1,4,W
93674,12,SCO4,2013-04-20,Glasgow Rangers,Peterhead,1,2,-1,L
93675,12,SCO4,2013-04-27,Berwick Rangers,Annan Athletic,0,2,-2,L
93676,12,SCO4,2013-04-27,East Stirling,Glasgow Rangers,2,4,-2,L
93677,12,SCO4,2013-04-27,Montrose,Queens Park,1,2,-1,L
93678,12,SCO4,2013-04-27,Peterhead,Clyde,3,0,3,W
93679,12,SCO4,2013-04-27,Stirling Albion,Elgin City,1,1,0,D
93680,12,SCO4,2013-05-04,Annan Athletic,Montrose,1,1,0,D
93681,12,SCO4,2013-05-04,Clyde,Stirling Albion,1,2,-1,L
93682,12,SCO4,2013-05-04,Elgin City,East Stirling,3,2,1,W
93683,12,SCO4,2013-05-04,Queens Park,Peterhead,0,3,-3,L
93684,12,SCO4,2013-05-04,Glasgow Rangers,Berwick Rangers,1,0,1,W
93685,13,SCO4,2013-08-10,Clyde,Berwick Rangers,1,0,1,W
93686,13,SCO4,2013-08-10,Elgin City,Albion Rovers,1,2,-1,L
93687,13,SCO4,2013-08-10,Montrose,Stirling Albion,1,2,-1,L
93688,13,SCO4,2013-08-10,Peterhead,Annan Athletic,2,2,0,D
93689,13,SCO4,2013-08-10,Queens Park,East Stirling,1,3,-2,L
93690,13,SCO4,2013-08-17,Albion Rovers,Clyde,3,0,3,W
93691,13,SCO4,2013-08-17,Annan Athletic,Montrose,2,1,1,W
93692,13,SCO4,2013-08-17,Berwick Rangers,Queens Park,4,0,4,W
93693,13,SCO4,2013-08-17,East Stirling,Elgin City,3,0,3,W
93694,13,SCO4,2013-08-17,Stirling Albion,Peterhead,2,0,2,W
93695,13,SCO4,2013-08-24,Annan Athletic,Albion Rovers,1,1,0,D
93696,13,SCO4,2013-08-24,Clyde,Queens Park,3,0,3,W
93697,13,SCO4,2013-08-24,Montrose,Berwick Rangers,1,1,0,D
93698,13,SCO4,2013-08-24,Peterhead,Elgin City,2,2,0,D
93699,13,SCO4,2013-08-24,Stirling Albion,East Stirling,1,3,-2,L
93700,13,SCO4,2013-08-31,Albion Rovers,Montrose,0,2,-2,L
93701,13,SCO4,2013-08-31,Berwick Rangers,Annan Athletic,4,2,2,W
93702,13,SCO4,2013-08-31,East Stirling,Peterhead,1,4,-3,L
93703,13,SCO4,2013-08-31,Elgin City,Clyde,1,0,1,W
93704,13,SCO4,2013-08-31,Queens Park,Stirling Albion,0,2,-2,L
93705,13,SCO4,2013-09-14,Albion Rovers,Berwick Rangers,0,2,-2,L
93706,13,SCO4,2013-09-14,Clyde,East Stirling,1,2,-1,L
93707,13,SCO4,2013-09-14,Elgin City,Montrose,3,3,0,D
93708,13,SCO4,2013-09-14,Peterhead,Queens Park,2,1,1,W
93709,13,SCO4,2013-09-14,Stirling Albion,Annan Athletic,0,2,-2,L
93710,13,SCO4,2013-09-21,Annan Athletic,Clyde,1,2,-1,L
93711,13,SCO4,2013-09-21,Berwick Rangers,Stirling Albion,1,1,0,D
93712,13,SCO4,2013-09-21,East Stirling,Albion Rovers,1,4,-3,L
93713,13,SCO4,2013-09-21,Montrose,Peterhead,2,1,1,W
93714,13,SCO4,2013-09-21,Queens Park,Elgin City,3,3,0,D
93715,13,SCO4,2013-09-28,Albion Rovers,Peterhead,1,2,-1,L
93716,13,SCO4,2013-09-28,Clyde,Montrose,0,3,-3,L
93717,13,SCO4,2013-09-28,East Stirling,Berwick Rangers,1,0,1,W
93718,13,SCO4,2013-09-28,Elgin City,Stirling Albion,4,0,4,W
93719,13,SCO4,2013-09-28,Queens Park,Annan Athletic,2,5,-3,L
93720,13,SCO4,2013-10-12,Berwick Rangers,Elgin City,2,3,-1,L
93721,13,SCO4,2013-10-12,Peterhead,Clyde,1,1,0,D
93722,13,SCO4,2013-10-19,Albion Rovers,Elgin City,0,0,0,D
93723,13,SCO4,2013-10-19,Berwick Rangers,Clyde,0,1,-1,L
93724,13,SCO4,2013-10-19,East Stirling,Queens Park,1,1,0,D
93725,13,SCO4,2013-10-19,Stirling Albion,Montrose,3,1,2,W
93726,13,SCO4,2013-10-26,Clyde,Stirling Albion,2,1,1,W
93727,13,SCO4,2013-10-26,Elgin City,Annan Athletic,2,3,-1,L
93728,13,SCO4,2013-10-26,Montrose,East Stirling,2,0,2,W
93729,13,SCO4,2013-10-26,Peterhead,Berwick Rangers,1,1,0,D
93730,13,SCO4,2013-10-26,Queens Park,Albion Rovers,1,1,0,D
93731,13,SCO4,2013-10-29,Annan Athletic,East Stirling,1,2,-1,L
93732,13,SCO4,2013-10-29,Montrose,Queens Park,1,2,-1,L
93733,13,SCO4,2013-10-29,Stirling Albion,Albion Rovers,2,1,1,W
93734,13,SCO4,2013-11-05,Annan Athletic,Peterhead,2,0,2,W
93735,13,SCO4,2013-11-09,Albion Rovers,Annan Athletic,2,0,2,W
93736,13,SCO4,2013-11-09,East Stirling,Stirling Albion,2,2,0,D
93737,13,SCO4,2013-11-09,Elgin City,Peterhead,2,4,-2,L
93738,13,SCO4,2013-11-09,Queens Park,Clyde,1,1,0,D
93739,13,SCO4,2013-11-16,Annan Athletic,Berwick Rangers,3,2,1,W
93740,13,SCO4,2013-11-16,Clyde,Elgin City,2,1,1,W
93741,13,SCO4,2013-11-16,Montrose,Albion Rovers,2,1,1,W
93742,13,SCO4,2013-11-16,Peterhead,East Stirling,1,1,0,D
93743,13,SCO4,2013-11-16,Stirling Albion,Queens Park,3,0,3,W
93744,13,SCO4,2013-11-20,Berwick Rangers,Montrose,1,1,0,D
93745,13,SCO4,2013-11-23,Annan Athletic,Stirling Albion,4,4,0,D
93746,13,SCO4,2013-11-23,Berwick Rangers,Albion Rovers,2,1,1,W
93747,13,SCO4,2013-11-23,East Stirling,Clyde,0,1,-1,L
93748,13,SCO4,2013-11-23,Montrose,Elgin City,3,3,0,D
93749,13,SCO4,2013-11-23,Queens Park,Peterhead,0,5,-5,L
93750,13,SCO4,2013-11-30,Elgin City,Queens Park,3,2,1,W
93751,13,SCO4,2013-11-30,Peterhead,Montrose,3,0,3,W
93752,13,SCO4,2013-12-03,Albion Rovers,East Stirling,3,2,1,W
93753,13,SCO4,2013-12-03,Clyde,Annan Athletic,2,1,1,W
93754,13,SCO4,2013-12-03,Stirling Albion,Berwick Rangers,3,1,2,W
93755,13,SCO4,2013-12-07,Albion Rovers,Stirling Albion,2,1,1,W
93756,13,SCO4,2013-12-07,Clyde,Peterhead,1,3,-2,L
93757,13,SCO4,2013-12-07,East Stirling,Annan Athletic,1,1,0,D
93758,13,SCO4,2013-12-07,Elgin City,Berwick Rangers,2,0,2,W
93759,13,SCO4,2013-12-07,Queens Park,Montrose,0,1,-1,L
93760,13,SCO4,2013-12-14,Berwick Rangers,East Stirling,2,0,2,W
93761,13,SCO4,2013-12-14,Montrose,Clyde,0,2,-2,L
93762,13,SCO4,2013-12-14,Peterhead,Albion Rovers,1,1,0,D
93763,13,SCO4,2013-12-21,Clyde,Albion Rovers,2,2,0,D
93764,13,SCO4,2013-12-21,Elgin City,East Stirling,0,1,-1,L
93765,13,SCO4,2013-12-21,Peterhead,Stirling Albion,3,1,2,W
93766,13,SCO4,2013-12-21,Queens Park,Berwick Rangers,0,4,-4,L
93767,13,SCO4,2013-12-26,Montrose,Annan Athletic,0,2,-2,L
93768,13,SCO4,2013-12-28,Albion Rovers,Queens Park,2,1,1,W
93769,13,SCO4,2013-12-28,Annan Athletic,Elgin City,2,1,1,W
93770,13,SCO4,2013-12-28,Berwick Rangers,Peterhead,1,3,-2,L
93771,13,SCO4,2013-12-28,East Stirling,Montrose,2,2,0,D
93772,13,SCO4,2013-12-28,Stirling Albion,Clyde,1,1,0,D
93773,13,SCO4,2014-01-02,Montrose,Berwick Rangers,0,0,0,D
93774,13,SCO4,2014-01-02,Peterhead,Elgin City,2,1,1,W
93775,13,SCO4,2014-01-04,Annan Athletic,Albion Rovers,2,0,2,W
93776,13,SCO4,2014-01-04,Clyde,Queens Park,1,2,-1,L
93777,13,SCO4,2014-01-04,Stirling Albion,East Stirling,2,1,1,W
93778,13,SCO4,2014-01-11,Albion Rovers,Montrose,1,0,1,W
93779,13,SCO4,2014-01-11,Berwick Rangers,Annan Athletic,1,4,-3,L
93780,13,SCO4,2014-01-11,East Stirling,Peterhead,2,0,2,W
93781,13,SCO4,2014-01-11,Elgin City,Clyde,3,1,2,W
93782,13,SCO4,2014-01-11,Queens Park,Stirling Albion,0,1,-1,L
93783,13,SCO4,2014-01-18,Annan Athletic,Clyde,0,1,-1,L
93784,13,SCO4,2014-01-18,Berwick Rangers,Stirling Albion,4,0,4,W
93785,13,SCO4,2014-01-18,East Stirling,Albion Rovers,1,1,0,D
93786,13,SCO4,2014-01-18,Montrose,Peterhead,2,3,-1,L
93787,13,SCO4,2014-01-18,Queens Park,Elgin City,2,0,2,W
93788,13,SCO4,2014-01-25,Albion Rovers,Berwick Rangers,0,3,-3,L
93789,13,SCO4,2014-01-25,Clyde,East Stirling,1,0,1,W
93790,13,SCO4,2014-01-25,Elgin City,Montrose,2,3,-1,L
93791,13,SCO4,2014-01-25,Peterhead,Queens Park,1,0,1,W
93792,13,SCO4,2014-01-25,Stirling Albion,Annan Athletic,1,1,0,D
93793,13,SCO4,2014-02-01,Clyde,Berwick Rangers,3,3,0,D
93794,13,SCO4,2014-02-01,Elgin City,Albion Rovers,1,1,0,D
93795,13,SCO4,2014-02-01,Montrose,Stirling Albion,0,0,0,D
93796,13,SCO4,2014-02-01,Queens Park,East Stirling,0,0,0,D
93797,13,SCO4,2014-02-08,Annan Athletic,Montrose,1,0,1,W
93798,13,SCO4,2014-02-08,Berwick Rangers,Queens Park,1,0,1,W
93799,13,SCO4,2014-02-08,East Stirling,Elgin City,3,0,3,W
93800,13,SCO4,2014-02-08,Stirling Albion,Peterhead,1,2,-1,L
93801,13,SCO4,2014-02-15,Annan Athletic,East Stirling,2,3,-1,L
93802,13,SCO4,2014-02-15,Berwick Rangers,Elgin City,2,3,-1,L
93803,13,SCO4,2014-02-15,Montrose,Queens Park,1,0,1,W
93804,13,SCO4,2014-02-15,Peterhead,Clyde,2,0,2,W
93805,13,SCO4,2014-02-15,Stirling Albion,Albion Rovers,2,0,2,W
93806,13,SCO4,2014-02-22,Albion Rovers,Peterhead,0,0,0,D
93807,13,SCO4,2014-02-22,Clyde,Montrose,1,1,0,D
93808,13,SCO4,2014-02-22,East Stirling,Berwick Rangers,1,1,0,D
93809,13,SCO4,2014-02-22,Elgin City,Stirling Albion,2,3,-1,L
93810,13,SCO4,2014-02-22,Queens Park,Annan Athletic,0,1,-1,L
93811,13,SCO4,2014-02-25,Albion Rovers,Clyde,1,0,1,W
93812,13,SCO4,2014-02-25,Annan Athletic,Queens Park,3,2,1,W
93813,13,SCO4,2014-03-01,Annan Athletic,Berwick Rangers,4,0,4,W
93814,13,SCO4,2014-03-01,Clyde,Elgin City,4,0,4,W
93815,13,SCO4,2014-03-01,Montrose,Albion Rovers,2,1,1,W
93816,13,SCO4,2014-03-01,Peterhead,East Stirling,4,0,4,W
93817,13,SCO4,2014-03-01,Stirling Albion,Queens Park,2,2,0,D
93818,13,SCO4,2014-03-04,Peterhead,Annan Athletic,3,1,2,W
93819,13,SCO4,2014-03-08,Berwick Rangers,Montrose,5,0,5,W
93820,13,SCO4,2014-03-08,East Stirling,Stirling Albion,1,0,1,W
93821,13,SCO4,2014-03-08,Elgin City,Peterhead,2,3,-1,L
93822,13,SCO4,2014-03-08,Queens Park,Clyde,1,3,-2,L
93823,13,SCO4,2014-03-11,Stirling Albion,Elgin City,1,1,0,D
93824,13,SCO4,2014-03-15,Clyde,Stirling Albion,1,0,1,W
93825,13,SCO4,2014-03-15,Elgin City,Annan Athletic,2,3,-1,L
93826,13,SCO4,2014-03-15,Montrose,East Stirling,2,0,2,W
93827,13,SCO4,2014-03-15,Peterhead,Berwick Rangers,3,0,3,W
93828,13,SCO4,2014-03-15,Queens Park,Albion Rovers,4,0,4,W
93829,13,SCO4,2014-03-22,Albion Rovers,Elgin City,5,2,3,W
93830,13,SCO4,2014-03-22,Annan Athletic,Peterhead,2,1,1,W
93831,13,SCO4,2014-03-22,Berwick Rangers,Clyde,3,0,3,W
93832,13,SCO4,2014-03-22,East Stirling,Queens Park,1,4,-3,L
93833,13,SCO4,2014-03-22,Stirling Albion,Montrose,2,2,0,D
93834,13,SCO4,2014-03-25,Albion Rovers,Annan Athletic,0,2,-2,L
93835,13,SCO4,2014-03-29,Annan Athletic,Stirling Albion,1,2,-1,L
93836,13,SCO4,2014-03-29,Berwick Rangers,Albion Rovers,3,1,2,W
93837,13,SCO4,2014-03-29,East Stirling,Clyde,2,4,-2,L
93838,13,SCO4,2014-03-29,Montrose,Elgin City,0,3,-3,L
93839,13,SCO4,2014-03-29,Queens Park,Peterhead,0,2,-2,L
93840,13,SCO4,2014-04-05,Albion Rovers,East Stirling,2,1,1,W
93841,13,SCO4,2014-04-05,Clyde,Annan Athletic,0,3,-3,L
93842,13,SCO4,2014-04-05,Elgin City,Queens Park,1,1,0,D
93843,13,SCO4,2014-04-05,Peterhead,Montrose,4,0,4,W
93844,13,SCO4,2014-04-05,Stirling Albion,Berwick Rangers,2,1,1,W
93845,13,SCO4,2014-04-12,Albion Rovers,Stirling Albion,0,2,-2,L
93846,13,SCO4,2014-04-12,Clyde,Peterhead,0,2,-2,L
93847,13,SCO4,2014-04-12,East Stirling,Annan Athletic,2,1,1,W
93848,13,SCO4,2014-04-12,Elgin City,Berwick Rangers,1,3,-2,L
93849,13,SCO4,2014-04-12,Queens Park,Montrose,1,1,0,D
93850,13,SCO4,2014-04-19,Annan Athletic,Queens Park,1,1,0,D
93851,13,SCO4,2014-04-19,Berwick Rangers,East Stirling,1,0,1,W
93852,13,SCO4,2014-04-19,Montrose,Clyde,0,2,-2,L
93853,13,SCO4,2014-04-19,Peterhead,Albion Rovers,2,0,2,W
93854,13,SCO4,2014-04-19,Stirling Albion,Elgin City,2,2,0,D
93855,13,SCO4,2014-04-26,Clyde,Albion Rovers,4,0,4,W
93856,13,SCO4,2014-04-26,Elgin City,East Stirling,5,0,5,W
93857,13,SCO4,2014-04-26,Montrose,Annan Athletic,2,1,1,W
93858,13,SCO4,2014-04-26,Peterhead,Stirling Albion,0,4,-4,L
93859,13,SCO4,2014-04-26,Queens Park,Berwick Rangers,1,3,-2,L
93860,13,SCO4,2014-05-03,Albion Rovers,Queens Park,1,0,1,W
93861,13,SCO4,2014-05-03,Annan Athletic,Elgin City,2,0,2,W
93862,13,SCO4,2014-05-03,Berwick Rangers,Peterhead,1,2,-1,L
93863,13,SCO4,2014-05-03,East Stirling,Montrose,1,2,-1,L
93864,13,SCO4,2014-05-03,Stirling Albion,Clyde,4,1,3,W
93865,14,SCO4,2014-08-09,Albion Rovers,Annan Athletic,2,1,1,W
93866,14,SCO4,2014-08-09,Berwick Rangers,Arbroath,1,2,-1,L
93867,14,SCO4,2014-08-09,Elgin City,East Fife,1,0,1,W
93868,14,SCO4,2014-08-09,Montrose,East Stirling,4,1,3,W
93869,14,SCO4,2014-08-09,Queens Park,Clyde,1,2,-1,L
93870,14,SCO4,2014-08-16,Annan Athletic,Queens Park,0,1,-1,L
93871,14,SCO4,2014-08-16,Arbroath,Albion Rovers,1,0,1,W
93872,14,SCO4,2014-08-16,East Fife,Berwick Rangers,2,3,-1,L
93873,14,SCO4,2014-08-16,East Stirling,Elgin City,2,1,1,W
93874,14,SCO4,2014-08-23,Albion Rovers,East Fife,2,0,2,W
93875,14,SCO4,2014-08-23,Berwick Rangers,East Stirling,5,0,5,W
93876,14,SCO4,2014-08-23,Elgin City,Clyde,1,0,1,W
93877,14,SCO4,2014-08-23,Montrose,Annan Athletic,2,0,2,W
93878,14,SCO4,2014-08-23,Queens Park,Arbroath,0,2,-2,L
93879,14,SCO4,2014-08-30,Albion Rovers,Queens Park,1,0,1,W
93880,14,SCO4,2014-08-30,Annan Athletic,Elgin City,3,3,0,D
93881,14,SCO4,2014-08-30,Arbroath,Montrose,3,1,2,W
93882,14,SCO4,2014-08-30,Clyde,Berwick Rangers,3,3,0,D
93883,14,SCO4,2014-08-30,East Fife,East Stirling,3,1,2,W
93884,14,SCO4,2014-09-13,Annan Athletic,Berwick Rangers,2,0,2,W
93885,14,SCO4,2014-09-13,Arbroath,East Fife,0,2,-2,L
93886,14,SCO4,2014-09-13,East Stirling,Clyde,1,0,1,W
93887,14,SCO4,2014-09-13,Montrose,Albion Rovers,0,2,-2,L
93888,14,SCO4,2014-09-13,Queens Park,Elgin City,2,1,1,W
93889,14,SCO4,2014-09-20,Berwick Rangers,Albion Rovers,1,1,0,D
93890,14,SCO4,2014-09-20,Clyde,Arbroath,2,5,-3,L
93891,14,SCO4,2014-09-20,East Fife,Queens Park,2,2,0,D
93892,14,SCO4,2014-09-20,East Stirling,Annan Athletic,0,1,-1,L
93893,14,SCO4,2014-09-20,Elgin City,Montrose,0,1,-1,L
93894,14,SCO4,2014-09-23,Clyde,Montrose,1,2,-1,L
93895,14,SCO4,2014-09-27,Albion Rovers,East Stirling,1,2,-1,L
93896,14,SCO4,2014-09-27,Arbroath,Elgin City,1,0,1,W
93897,14,SCO4,2014-09-27,Clyde,Annan Athletic,1,1,0,D
93898,14,SCO4,2014-09-27,Montrose,East Fife,0,4,-4,L
93899,14,SCO4,2014-09-27,Queens Park,Berwick Rangers,2,0,2,W
93900,14,SCO4,2014-10-11,East Fife,Clyde,0,1,-1,L
93901,14,SCO4,2014-10-11,East Stirling,Queens Park,1,3,-2,L
93902,14,SCO4,2014-10-15,Berwick Rangers,Montrose,2,2,0,D
93903,14,SCO4,2014-10-18,Albion Rovers,Clyde,2,2,0,D
93904,14,SCO4,2014-10-18,Arbroath,East Stirling,4,0,4,W
93905,14,SCO4,2014-10-18,Berwick Rangers,Elgin City,1,1,0,D
93906,14,SCO4,2014-10-18,East Fife,Annan Athletic,1,1,0,D
93907,14,SCO4,2014-10-18,Queens Park,Montrose,2,0,2,W
93908,14,SCO4,2014-10-21,Annan Athletic,Arbroath,0,1,-1,L
93909,14,SCO4,2014-10-25,Albion Rovers,Berwick Rangers,2,1,1,W
93910,14,SCO4,2014-10-25,Annan Athletic,East Stirling,4,3,1,W
93911,14,SCO4,2014-10-25,Clyde,Elgin City,2,1,1,W
93912,14,SCO4,2014-10-25,Montrose,Arbroath,1,5,-4,L
93913,14,SCO4,2014-10-25,Queens Park,East Fife,3,0,3,W
93914,14,SCO4,2014-10-28,Elgin City,Albion Rovers,0,4,-4,L
93915,14,SCO4,2014-11-08,Arbroath,Queens Park,1,2,-1,L
93916,14,SCO4,2014-11-08,East Fife,Albion Rovers,0,0,0,D
93917,14,SCO4,2014-11-08,East Stirling,Berwick Rangers,0,2,-2,L
93918,14,SCO4,2014-11-08,Montrose,Clyde,0,3,-3,L
93919,14,SCO4,2014-11-11,Elgin City,Annan Athletic,0,0,0,D
93920,14,SCO4,2014-11-15,Albion Rovers,Arbroath,2,1,1,W
93921,14,SCO4,2014-11-15,Annan Athletic,Montrose,2,2,0,D
93922,14,SCO4,2014-11-15,Berwick Rangers,East Fife,2,3,-1,L
93923,14,SCO4,2014-11-15,Clyde,East Stirling,0,1,-1,L
93924,14,SCO4,2014-11-15,Elgin City,Queens Park,1,4,-3,L
93925,14,SCO4,2014-11-22,Arbroath,Clyde,4,0,4,W
93926,14,SCO4,2014-11-22,Berwick Rangers,Annan Athletic,2,0,2,W
93927,14,SCO4,2014-11-22,East Fife,Elgin City,1,1,0,D
93928,14,SCO4,2014-11-22,East Stirling,Montrose,4,0,4,W
93929,14,SCO4,2014-11-22,Queens Park,Albion Rovers,0,1,-1,L
93930,14,SCO4,2014-11-29,Clyde,Queens Park,0,2,-2,L
93931,14,SCO4,2014-11-29,East Stirling,East Fife,1,1,0,D
93932,14,SCO4,2014-12-02,Annan Athletic,Albion Rovers,2,1,1,W
93933,14,SCO4,2014-12-02,Elgin City,Arbroath,1,1,0,D
93934,14,SCO4,2014-12-02,Montrose,Berwick Rangers,2,1,1,W
93935,14,SCO4,2014-12-06,Albion Rovers,Elgin City,3,0,3,W
93936,14,SCO4,2014-12-06,Arbroath,Annan Athletic,3,2,1,W
93937,14,SCO4,2014-12-06,Berwick Rangers,Clyde,4,0,4,W
93938,14,SCO4,2014-12-06,East Fife,Montrose,3,0,3,W
93939,14,SCO4,2014-12-06,Queens Park,East Stirling,3,0,3,W
93940,14,SCO4,2014-12-13,Annan Athletic,East Fife,2,1,1,W
93941,14,SCO4,2014-12-13,Clyde,Albion Rovers,0,1,-1,L
93942,14,SCO4,2014-12-13,East Stirling,Arbroath,2,3,-1,L
93943,14,SCO4,2014-12-13,Montrose,Queens Park,1,2,-1,L
93944,14,SCO4,2014-12-20,Albion Rovers,Montrose,0,0,0,D
93945,14,SCO4,2014-12-20,Arbroath,Berwick Rangers,2,0,2,W
93946,14,SCO4,2014-12-20,Clyde,East Fife,3,1,2,W
93947,14,SCO4,2014-12-20,Queens Park,Annan Athletic,0,0,0,D
93948,14,SCO4,2014-12-27,Annan Athletic,Clyde,2,1,1,W
93949,14,SCO4,2014-12-27,Berwick Rangers,Queens Park,0,0,0,D
93950,14,SCO4,2014-12-27,East Fife,Arbroath,1,5,-4,L
93951,14,SCO4,2014-12-27,East Stirling,Albion Rovers,1,4,-3,L
93952,14,SCO4,2014-12-27,Montrose,Elgin City,2,3,-1,L
93953,14,SCO4,2015-01-03,Albion Rovers,Annan Athletic,2,0,2,W
93954,14,SCO4,2015-01-03,Arbroath,Montrose,2,2,0,D
93955,14,SCO4,2015-01-03,Berwick Rangers,East Stirling,3,0,3,W
93956,14,SCO4,2015-01-03,Queens Park,Clyde,1,1,0,D
93957,14,SCO4,2015-01-10,Annan Athletic,Elgin City,2,3,-1,L
93958,14,SCO4,2015-01-10,Clyde,Berwick Rangers,0,3,-3,L
93959,14,SCO4,2015-01-10,East Fife,Queens Park,0,0,0,D
93960,14,SCO4,2015-01-10,Montrose,East Stirling,0,1,-1,L
93961,14,SCO4,2015-01-17,Berwick Rangers,Montrose,3,3,0,D
93962,14,SCO4,2015-01-17,East Stirling,Annan Athletic,1,3,-2,L
93963,14,SCO4,2015-01-17,Queens Park,Arbroath,2,1,1,W
93964,14,SCO4,2015-01-24,Annan Athletic,Berwick Rangers,4,2,2,W
93965,14,SCO4,2015-01-24,Clyde,Arbroath,1,1,0,D
93966,14,SCO4,2015-01-24,Montrose,Albion Rovers,3,4,-1,L
93967,14,SCO4,2015-01-24,Queens Park,Elgin City,1,1,0,D
93968,14,SCO4,2015-01-31,Albion Rovers,Queens Park,2,1,1,W
93969,14,SCO4,2015-01-31,Arbroath,East Fife,1,1,0,D
93970,14,SCO4,2015-01-31,Berwick Rangers,Elgin City,0,2,-2,L
93971,14,SCO4,2015-01-31,East Stirling,Clyde,1,2,-1,L
93972,14,SCO4,2015-01-31,Montrose,Annan Athletic,2,1,1,W
93973,14,SCO4,2015-02-07,Elgin City,Albion Rovers,2,0,2,W
93974,14,SCO4,2015-02-07,Queens Park,Montrose,4,1,3,W
93975,14,SCO4,2015-02-10,Albion Rovers,East Fife,2,3,-1,L
93976,14,SCO4,2015-02-14,Albion Rovers,Clyde,0,2,-2,L
93977,14,SCO4,2015-02-14,Annan Athletic,Queens Park,2,0,2,W
93978,14,SCO4,2015-02-14,Berwick Rangers,Arbroath,3,1,2,W
93979,14,SCO4,2015-02-14,East Stirling,Elgin City,1,0,1,W
93980,14,SCO4,2015-02-14,Montrose,East Fife,0,3,-3,L
93981,14,SCO4,2015-02-21,Albion Rovers,East Stirling,0,1,-1,L
93982,14,SCO4,2015-02-21,Annan Athletic,Arbroath,2,0,2,W
93983,14,SCO4,2015-02-21,East Fife,Clyde,1,1,0,D
93984,14,SCO4,2015-02-21,Elgin City,Montrose,4,0,4,W
93985,14,SCO4,2015-02-21,Queens Park,Berwick Rangers,2,1,1,W
93986,14,SCO4,2015-02-24,East Fife,East Stirling,2,1,1,W
93987,14,SCO4,2015-02-24,Elgin City,Berwick Rangers,2,1,1,W
93988,14,SCO4,2015-02-28,Arbroath,Elgin City,3,3,0,D
93989,14,SCO4,2015-02-28,Berwick Rangers,Albion Rovers,0,2,-2,L
93990,14,SCO4,2015-02-28,Clyde,Montrose,2,0,2,W
93991,14,SCO4,2015-02-28,East Fife,Annan Athletic,2,1,1,W
93992,14,SCO4,2015-02-28,East Stirling,Queens Park,3,1,2,W
93993,14,SCO4,2015-03-03,Clyde,Annan Athletic,1,0,1,W
93994,14,SCO4,2015-03-03,Elgin City,East Fife,3,5,-2,L
93995,14,SCO4,2015-03-04,Arbroath,East Stirling,0,1,-1,L
93996,14,SCO4,2015-03-07,Annan Athletic,Albion Rovers,1,3,-2,L
93997,14,SCO4,2015-03-07,Clyde,East Stirling,1,1,0,D
93998,14,SCO4,2015-03-07,Montrose,Arbroath,3,0,3,W
93999,14,SCO4,2015-03-07,Queens Park,East Fife,1,0,1,W
94000,14,SCO4,2015-03-10,Elgin City,Clyde,2,0,2,W
94001,14,SCO4,2015-03-14,Albion Rovers,Montrose,3,0,3,W
94002,14,SCO4,2015-03-14,Arbroath,Clyde,3,1,2,W
94003,14,SCO4,2015-03-14,Berwick Rangers,Annan Athletic,2,2,0,D
94004,14,SCO4,2015-03-14,East Stirling,East Fife,2,0,2,W
94005,14,SCO4,2015-03-14,Elgin City,Queens Park,1,2,-1,L
94006,14,SCO4,2015-03-17,Elgin City,East Stirling,1,2,-1,L
94007,14,SCO4,2015-03-18,Arbroath,Albion Rovers,0,2,-2,L
94008,14,SCO4,2015-03-21,Annan Athletic,East Stirling,3,2,1,W
94009,14,SCO4,2015-03-21,Clyde,Elgin City,0,2,-2,L
94010,14,SCO4,2015-03-21,East Fife,Arbroath,2,0,2,W
94011,14,SCO4,2015-03-21,Montrose,Berwick Rangers,0,2,-2,L
94012,14,SCO4,2015-03-21,Queens Park,Albion Rovers,0,1,-1,L
94013,14,SCO4,2015-03-24,East Fife,Berwick Rangers,1,4,-3,L
94014,14,SCO4,2015-03-28,Albion Rovers,Elgin City,0,3,-3,L
94015,14,SCO4,2015-03-28,Annan Athletic,Clyde,0,1,-1,L
94016,14,SCO4,2015-03-28,Berwick Rangers,Queens Park,1,1,0,D
94017,14,SCO4,2015-03-28,East Fife,Montrose,3,0,3,W
94018,14,SCO4,2015-03-28,East Stirling,Arbroath,1,0,1,W
94019,14,SCO4,2015-03-31,Elgin City,Berwick Rangers,3,3,0,D
94020,14,SCO4,2015-04-04,Albion Rovers,Berwick Rangers,2,0,2,W
94021,14,SCO4,2015-04-04,Arbroath,Annan Athletic,1,1,0,D
94022,14,SCO4,2015-04-04,Clyde,East Fife,1,0,1,W
94023,14,SCO4,2015-04-04,Elgin City,East Stirling,0,0,0,D
94024,14,SCO4,2015-04-04,Montrose,Queens Park,2,2,0,D
94025,14,SCO4,2015-04-11,Berwick Rangers,Clyde,0,0,0,D
94026,14,SCO4,2015-04-11,East Fife,Albion Rovers,1,0,1,W
94027,14,SCO4,2015-04-11,East Stirling,Montrose,0,1,-1,L
94028,14,SCO4,2015-04-11,Elgin City,Arbroath,2,1,1,W
94029,14,SCO4,2015-04-11,Queens Park,Annan Athletic,2,0,2,W
94030,14,SCO4,2015-04-18,Annan Athletic,East Fife,2,1,1,W
94031,14,SCO4,2015-04-18,Arbroath,Queens Park,1,1,0,D
94032,14,SCO4,2015-04-18,Clyde,Albion Rovers,2,3,-1,L
94033,14,SCO4,2015-04-18,East Stirling,Berwick Rangers,0,4,-4,L
94034,14,SCO4,2015-04-18,Montrose,Elgin City,2,1,1,W
94035,14,SCO4,2015-04-25,Albion Rovers,Arbroath,1,1,0,D
94036,14,SCO4,2015-04-25,Berwick Rangers,East Fife,0,3,-3,L
94037,14,SCO4,2015-04-25,Elgin City,Annan Athletic,4,5,-1,L
94038,14,SCO4,2015-04-25,Montrose,Clyde,0,1,-1,L
94039,14,SCO4,2015-04-25,Queens Park,East Stirling,1,1,0,D
94040,14,SCO4,2015-05-02,Annan Athletic,Montrose,4,3,1,W
94041,14,SCO4,2015-05-02,Arbroath,Berwick Rangers,5,0,5,W
94042,14,SCO4,2015-05-02,Clyde,Queens Park,2,0,2,W
94043,14,SCO4,2015-05-02,East Fife,Elgin City,3,1,2,W
94044,14,SCO4,2015-05-02,East Stirling,Albion Rovers,1,5,-4,L
94045,15,SCO4,2015-08-08,Arbroath,Elgin City,0,3,-3,L
94046,15,SCO4,2015-08-08,Berwick Rangers,Montrose,2,1,1,W
94047,15,SCO4,2015-08-08,East Stirling,East Fife,1,0,1,W
94048,15,SCO4,2015-08-08,Queens Park,Annan Athletic,0,1,-1,L
94049,15,SCO4,2015-08-08,Stirling Albion,Clyde,0,1,-1,L
94050,15,SCO4,2015-08-15,Annan Athletic,Stirling Albion,1,1,0,D
94051,15,SCO4,2015-08-15,Clyde,Queens Park,0,2,-2,L
94052,15,SCO4,2015-08-15,East Fife,Berwick Rangers,5,0,5,W
94053,15,SCO4,2015-08-15,Elgin City,East Stirling,4,0,4,W
94054,15,SCO4,2015-08-15,Montrose,Arbroath,3,0,3,W
94055,15,SCO4,2015-08-22,Arbroath,Queens Park,1,2,-1,L
94056,15,SCO4,2015-08-22,East Fife,Elgin City,2,1,1,W
94057,15,SCO4,2015-08-22,East Stirling,Annan Athletic,3,1,2,W
94058,15,SCO4,2015-08-22,Montrose,Clyde,2,0,2,W
94059,15,SCO4,2015-08-22,Stirling Albion,Berwick Rangers,1,3,-2,L
94060,15,SCO4,2015-08-29,Annan Athletic,Montrose,3,2,1,W
94061,15,SCO4,2015-08-29,Berwick Rangers,Arbroath,2,2,0,D
94062,15,SCO4,2015-08-29,Clyde,East Stirling,3,1,2,W
94063,15,SCO4,2015-08-29,Elgin City,Stirling Albion,1,0,1,W
94064,15,SCO4,2015-08-29,Queens Park,East Fife,0,2,-2,L
94065,15,SCO4,2015-09-05,Annan Athletic,East Fife,2,0,2,W
94066,15,SCO4,2015-09-05,Arbroath,Clyde,0,1,-1,L
94067,15,SCO4,2015-09-05,Berwick Rangers,Queens Park,1,0,1,W
94068,15,SCO4,2015-09-05,East Stirling,Stirling Albion,2,3,-1,L
94069,15,SCO4,2015-09-05,Montrose,Elgin City,2,0,2,W
94070,15,SCO4,2015-09-12,Clyde,Annan Athletic,4,2,2,W
94071,15,SCO4,2015-09-12,East Fife,Arbroath,0,1,-1,L
94072,15,SCO4,2015-09-12,Elgin City,Berwick Rangers,4,1,3,W
94073,15,SCO4,2015-09-12,Queens Park,East Stirling,5,1,4,W
94074,15,SCO4,2015-09-12,Stirling Albion,Montrose,1,0,1,W
94075,15,SCO4,2015-09-19,Arbroath,Stirling Albion,2,0,2,W
94076,15,SCO4,2015-09-19,Berwick Rangers,Annan Athletic,0,2,-2,L
94077,15,SCO4,2015-09-19,East Fife,Clyde,1,0,1,W
94078,15,SCO4,2015-09-19,Montrose,East Stirling,2,1,1,W
94079,15,SCO4,2015-09-19,Queens Park,Elgin City,3,1,2,W
94080,15,SCO4,2015-09-26,Annan Athletic,Elgin City,1,1,0,D
94081,15,SCO4,2015-09-26,Clyde,Berwick Rangers,1,1,0,D
94082,15,SCO4,2015-09-26,East Stirling,Arbroath,0,4,-4,L
94083,15,SCO4,2015-09-26,Montrose,East Fife,1,4,-3,L
94084,15,SCO4,2015-09-26,Stirling Albion,Queens Park,1,2,-1,L
94085,15,SCO4,2015-10-03,Arbroath,Annan Athletic,0,2,-2,L
94086,15,SCO4,2015-10-03,Berwick Rangers,East Stirling,2,1,1,W
94087,15,SCO4,2015-10-03,East Fife,Stirling Albion,1,1,0,D
94088,15,SCO4,2015-10-03,Elgin City,Clyde,1,1,0,D
94089,15,SCO4,2015-10-03,Queens Park,Montrose,0,1,-1,L
94090,15,SCO4,2015-10-17,Annan Athletic,Queens Park,3,1,2,W
94091,15,SCO4,2015-10-17,Arbroath,Montrose,3,1,2,W
94092,15,SCO4,2015-10-17,Berwick Rangers,East Fife,1,1,0,D
94093,15,SCO4,2015-10-17,Clyde,Stirling Albion,0,1,-1,L
94094,15,SCO4,2015-10-17,East Stirling,Elgin City,2,0,2,W
94095,15,SCO4,2015-10-31,East Fife,Annan Athletic,0,1,-1,L
94096,15,SCO4,2015-10-31,Elgin City,Arbroath,2,0,2,W
94097,15,SCO4,2015-10-31,Montrose,Berwick Rangers,4,1,3,W
94098,15,SCO4,2015-10-31,Queens Park,Clyde,1,1,0,D
94099,15,SCO4,2015-10-31,Stirling Albion,East Stirling,0,0,0,D
94100,15,SCO4,2015-11-07,Arbroath,East Fife,1,1,0,D
94101,15,SCO4,2015-11-07,Berwick Rangers,Stirling Albion,1,2,-1,L
94102,15,SCO4,2015-11-07,Clyde,Montrose,3,1,2,W
94103,15,SCO4,2015-11-07,East Stirling,Queens Park,2,1,1,W
94104,15,SCO4,2015-11-07,Elgin City,Annan Athletic,3,2,1,W
94105,15,SCO4,2015-11-14,Annan Athletic,Berwick Rangers,1,0,1,W
94106,15,SCO4,2015-11-14,Clyde,Elgin City,4,2,2,W
94107,15,SCO4,2015-11-14,East Fife,East Stirling,5,3,2,W
94108,15,SCO4,2015-11-14,Stirling Albion,Arbroath,3,1,2,W
94109,15,SCO4,2015-11-17,Montrose,Queens Park,1,6,-5,L
94110,15,SCO4,2015-11-21,Annan Athletic,Arbroath,2,2,0,D
94111,15,SCO4,2015-11-21,Berwick Rangers,Clyde,0,5,-5,L
94112,15,SCO4,2015-11-21,East Stirling,Montrose,3,1,2,W
94113,15,SCO4,2015-11-21,Elgin City,East Fife,4,2,2,W
94114,15,SCO4,2015-11-21,Queens Park,Stirling Albion,1,0,1,W
94115,15,SCO4,2015-12-05,Stirling Albion,Elgin City,3,1,2,W
94116,15,SCO4,2015-12-08,East Fife,Queens Park,0,2,-2,L
94117,15,SCO4,2015-12-12,Annan Athletic,East Stirling,3,1,2,W
94118,15,SCO4,2015-12-12,Berwick Rangers,Elgin City,2,3,-1,L
94119,15,SCO4,2015-12-12,Clyde,East Fife,2,0,2,W
94120,15,SCO4,2015-12-12,Montrose,Stirling Albion,1,3,-2,L
94121,15,SCO4,2015-12-12,Queens Park,Arbroath,1,0,1,W
94122,15,SCO4,2015-12-15,Arbroath,Berwick Rangers,3,1,2,W
94123,15,SCO4,2015-12-15,Montrose,Annan Athletic,1,1,0,D
94124,15,SCO4,2015-12-19,Clyde,Arbroath,0,2,-2,L
94125,15,SCO4,2015-12-19,East Fife,Montrose,1,1,0,D
94126,15,SCO4,2015-12-19,East Stirling,Berwick Rangers,0,4,-4,L
94127,15,SCO4,2015-12-19,Elgin City,Queens Park,0,0,0,D
94128,15,SCO4,2015-12-19,Stirling Albion,Annan Athletic,1,0,1,W
94129,15,SCO4,2015-12-26,Annan Athletic,Clyde,2,3,-1,L
94130,15,SCO4,2015-12-26,Elgin City,Montrose,2,0,2,W
94131,15,SCO4,2015-12-26,Queens Park,Berwick Rangers,0,1,-1,L
94132,15,SCO4,2015-12-26,Stirling Albion,East Fife,1,3,-2,L
94133,15,SCO4,2016-01-02,Clyde,Queens Park,0,1,-1,L
94134,15,SCO4,2016-01-02,East Fife,Elgin City,0,2,-2,L
94135,15,SCO4,2016-01-02,East Stirling,Stirling Albion,3,2,1,W
94136,15,SCO4,2016-01-02,Montrose,Arbroath,0,2,-2,L
94137,15,SCO4,2016-01-09,Arbroath,Elgin City,2,3,-1,L
94138,15,SCO4,2016-01-09,East Fife,Berwick Rangers,1,0,1,W
94139,15,SCO4,2016-01-09,Montrose,East Stirling,3,2,1,W
94140,15,SCO4,2016-01-16,Annan Athletic,East Fife,2,4,-2,L
94141,15,SCO4,2016-01-16,Queens Park,Montrose,1,1,0,D
94142,15,SCO4,2016-01-23,Arbroath,Annan Athletic,2,1,1,W
94143,15,SCO4,2016-01-23,East Stirling,East Fife,1,3,-2,L
94144,15,SCO4,2016-01-23,Elgin City,Berwick Rangers,1,0,1,W
94145,15,SCO4,2016-01-23,Montrose,Clyde,2,1,1,W
94146,15,SCO4,2016-01-23,Stirling Albion,Queens Park,0,0,0,D
94147,15,SCO4,2016-01-30,Annan Athletic,Elgin City,4,2,2,W
94148,15,SCO4,2016-01-30,East Fife,Clyde,2,0,2,W
94149,15,SCO4,2016-01-30,East Stirling,Arbroath,0,3,-3,L
94150,15,SCO4,2016-02-06,Arbroath,Stirling Albion,1,1,0,D
94151,15,SCO4,2016-02-06,Berwick Rangers,East Stirling,2,2,0,D
94152,15,SCO4,2016-02-06,Montrose,East Fife,2,2,0,D
94153,15,SCO4,2016-02-06,Queens Park,Elgin City,0,0,0,D
94154,15,SCO4,2016-02-09,Stirling Albion,Montrose,7,0,7,W
94155,15,SCO4,2016-02-13,Annan Athletic,Montrose,3,3,0,D
94156,15,SCO4,2016-02-13,East Fife,Arbroath,2,1,1,W
94157,15,SCO4,2016-02-13,Elgin City,Clyde,1,0,1,W
94158,15,SCO4,2016-02-13,Queens Park,East Stirling,0,3,-3,L
94159,15,SCO4,2016-02-13,Stirling Albion,Berwick Rangers,2,1,1,W
94160,15,SCO4,2016-02-16,Berwick Rangers,Annan Athletic,3,2,1,W
94161,15,SCO4,2016-02-20,Arbroath,Queens Park,0,1,-1,L
94162,15,SCO4,2016-02-20,Clyde,Berwick Rangers,2,1,1,W
94163,15,SCO4,2016-02-20,East Fife,Stirling Albion,1,0,1,W
94164,15,SCO4,2016-02-20,East Stirling,Annan Athletic,0,1,-1,L
94165,15,SCO4,2016-02-20,Montrose,Elgin City,3,1,2,W
94166,15,SCO4,2016-02-23,Arbroath,East Stirling,0,0,0,D
94167,15,SCO4,2016-02-23,Berwick Rangers,Queens Park,1,1,0,D
94168,15,SCO4,2016-02-23,Stirling Albion,Clyde,1,2,-1,L
94169,15,SCO4,2016-02-27,Annan Athletic,Stirling Albion,2,2,0,D
94170,15,SCO4,2016-02-27,Arbroath,Clyde,0,1,-1,L
94171,15,SCO4,2016-02-27,Berwick Rangers,Montrose,1,0,1,W
94172,15,SCO4,2016-02-27,Elgin City,East Stirling,2,0,2,W
94173,15,SCO4,2016-02-27,Queens Park,East Fife,3,0,3,W
94174,15,SCO4,2016-03-01,Clyde,East Stirling,0,1,-1,L
94175,15,SCO4,2016-03-05,Annan Athletic,Clyde,3,3,0,D
94176,15,SCO4,2016-03-05,East Stirling,Montrose,2,4,-2,L
94177,15,SCO4,2016-03-05,Elgin City,East Fife,1,3,-2,L
94178,15,SCO4,2016-03-05,Queens Park,Berwick Rangers,0,0,0,D
94179,15,SCO4,2016-03-05,Stirling Albion,Arbroath,1,0,1,W
94180,15,SCO4,2016-03-08,Berwick Rangers,Arbroath,3,0,3,W
94181,15,SCO4,2016-03-08,East Stirling,Clyde,0,3,-3,L
94182,15,SCO4,2016-03-08,Elgin City,Stirling Albion,2,1,1,W
94183,15,SCO4,2016-03-12,Arbroath,East Stirling,3,0,3,W
94184,15,SCO4,2016-03-12,Berwick Rangers,Stirling Albion,1,0,1,W
94185,15,SCO4,2016-03-12,Clyde,Elgin City,1,0,1,W
94186,15,SCO4,2016-03-12,East Fife,Annan Athletic,4,2,2,W
94187,15,SCO4,2016-03-12,Montrose,Queens Park,1,1,0,D
94188,15,SCO4,2016-03-15,Queens Park,Annan Athletic,1,3,-2,L
94189,15,SCO4,2016-03-19,Annan Athletic,Berwick Rangers,1,0,1,W
94190,15,SCO4,2016-03-19,East Stirling,Clyde,2,4,-2,L
94191,15,SCO4,2016-03-19,Elgin City,Montrose,1,1,0,D
94192,15,SCO4,2016-03-19,Queens Park,Arbroath,2,1,1,W
94193,15,SCO4,2016-03-19,Stirling Albion,East Fife,0,6,-6,L
94194,15,SCO4,2016-03-22,Clyde,Annan Athletic,2,1,1,W
94195,15,SCO4,2016-03-26,Berwick Rangers,Elgin City,2,0,2,W
94196,15,SCO4,2016-03-26,Clyde,Arbroath,1,2,-1,L
94197,15,SCO4,2016-03-26,East Fife,Queens Park,1,1,0,D
94198,15,SCO4,2016-03-26,Montrose,Annan Athletic,0,5,-5,L
94199,15,SCO4,2016-03-26,Stirling Albion,East Stirling,3,0,3,W
94200,15,SCO4,2016-04-02,Arbroath,East Fife,0,1,-1,L
94201,15,SCO4,2016-04-02,Clyde,Montrose,3,3,0,D
94202,15,SCO4,2016-04-02,East Stirling,Berwick Rangers,0,0,0,D
94203,15,SCO4,2016-04-02,Elgin City,Annan Athletic,2,2,0,D
94204,15,SCO4,2016-04-02,Queens Park,Stirling Albion,1,1,0,D
94205,15,SCO4,2016-04-09,Annan Athletic,Arbroath,4,1,3,W
94206,15,SCO4,2016-04-09,Berwick Rangers,Clyde,3,0,3,W
94207,15,SCO4,2016-04-09,East Fife,Montrose,3,0,3,W
94208,15,SCO4,2016-04-09,East Stirling,Queens Park,0,3,-3,L
94209,15,SCO4,2016-04-09,Stirling Albion,Elgin City,0,0,0,D
94210,15,SCO4,2016-04-16,Annan Athletic,East Stirling,1,3,-2,L
94211,15,SCO4,2016-04-16,Arbroath,Berwick Rangers,1,2,-1,L
94212,15,SCO4,2016-04-16,Clyde,East Fife,0,0,0,D
94213,15,SCO4,2016-04-16,Elgin City,Queens Park,1,1,0,D
94214,15,SCO4,2016-04-16,Montrose,Stirling Albion,1,1,0,D
94215,15,SCO4,2016-04-23,Arbroath,Montrose,0,0,0,D
94216,15,SCO4,2016-04-23,Berwick Rangers,East Fife,2,0,2,W
94217,15,SCO4,2016-04-23,East Stirling,Elgin City,0,3,-3,L
94218,15,SCO4,2016-04-23,Queens Park,Clyde,2,1,1,W
94219,15,SCO4,2016-04-23,Stirling Albion,Annan Athletic,2,1,1,W
94220,15,SCO4,2016-04-30,Annan Athletic,Queens Park,1,0,1,W
94221,15,SCO4,2016-04-30,Clyde,Stirling Albion,3,1,2,W
94222,15,SCO4,2016-04-30,East Fife,East Stirling,1,1,0,D
94223,15,SCO4,2016-04-30,Elgin City,Arbroath,4,1,3,W
94224,15,SCO4,2016-04-30,Montrose,Berwick Rangers,1,0,1,W
94225,16,SCO4,2016-08-06,Arbroath,Berwick Rangers,1,1,0,D
94226,16,SCO4,2016-08-06,Cowdenbeath,Elgin City,0,1,-1,L
94227,16,SCO4,2016-08-06,Edinburgh City,Forfar Athletic,2,3,-1,L
94228,16,SCO4,2016-08-06,Clyde,Montrose,2,1,1,W
94229,16,SCO4,2016-08-06,Annan Athletic,Stirling Albion,3,2,1,W
94230,16,SCO4,2016-08-13,Elgin City,Edinburgh City,3,0,3,W
94231,16,SCO4,2016-08-13,Montrose,Arbroath,1,1,0,D
94232,16,SCO4,2016-08-13,Berwick Rangers,Annan Athletic,2,0,2,W
94233,16,SCO4,2016-08-13,Forfar Athletic,Cowdenbeath,4,3,1,W
94234,16,SCO4,2016-08-13,Stirling Albion,Clyde,1,1,0,D
94235,16,SCO4,2016-08-20,Elgin City,Arbroath,0,1,-1,L
94236,16,SCO4,2016-08-20,Annan Athletic,Clyde,3,2,1,W
94237,16,SCO4,2016-08-20,Stirling Albion,Montrose,2,0,2,W
94238,16,SCO4,2016-08-20,Berwick Rangers,Forfar Athletic,1,2,-1,L
94239,16,SCO4,2016-08-20,Cowdenbeath,Edinburgh City,2,0,2,W
94240,16,SCO4,2016-08-27,Clyde,Cowdenbeath,5,3,2,W
94241,16,SCO4,2016-08-27,Montrose,Annan Athletic,2,2,0,D
94242,16,SCO4,2016-08-27,Arbroath,Stirling Albion,5,3,2,W
94243,16,SCO4,2016-08-27,Edinburgh City,Berwick Rangers,1,2,-1,L
94244,16,SCO4,2016-08-27,Forfar Athletic,Elgin City,3,2,1,W
94245,16,SCO4,2016-09-10,Stirling Albion,Edinburgh City,1,1,0,D
94246,16,SCO4,2016-09-10,Annan Athletic,Forfar Athletic,1,2,-1,L
94247,16,SCO4,2016-09-10,Berwick Rangers,Elgin City,2,4,-2,L
94248,16,SCO4,2016-09-10,Montrose,Cowdenbeath,1,2,-1,L
94249,16,SCO4,2016-09-10,Clyde,Arbroath,3,2,1,W
94250,16,SCO4,2016-09-17,Arbroath,Annan Athletic,1,1,0,D
94251,16,SCO4,2016-09-17,Cowdenbeath,Berwick Rangers,0,2,-2,L
94252,16,SCO4,2016-09-17,Edinburgh City,Montrose,0,1,-1,L
94253,16,SCO4,2016-09-17,Elgin City,Clyde,0,2,-2,L
94254,16,SCO4,2016-09-17,Forfar Athletic,Stirling Albion,4,1,3,W
94255,16,SCO4,2016-09-24,Stirling Albion,Elgin City,0,4,-4,L
94256,16,SCO4,2016-09-24,Annan Athletic,Edinburgh City,1,1,0,D
94257,16,SCO4,2016-09-24,Arbroath,Cowdenbeath,0,0,0,D
94258,16,SCO4,2016-09-24,Clyde,Forfar Athletic,0,1,-1,L
94259,16,SCO4,2016-09-24,Montrose,Berwick Rangers,0,0,0,D
94260,16,SCO4,2016-10-01,Cowdenbeath,Stirling Albion,0,2,-2,L
94261,16,SCO4,2016-10-01,Edinburgh City,Arbroath,3,3,0,D
94262,16,SCO4,2016-10-01,Elgin City,Annan Athletic,0,2,-2,L
94263,16,SCO4,2016-10-01,Forfar Athletic,Montrose,1,3,-2,L
94264,16,SCO4,2016-10-01,Berwick Rangers,Clyde,1,1,0,D
94265,16,SCO4,2016-10-08,Edinburgh City,Elgin City,1,2,-1,L
94266,16,SCO4,2016-10-15,Stirling Albion,Berwick Rangers,0,0,0,D
94267,16,SCO4,2016-10-15,Arbroath,Forfar Athletic,2,0,2,W
94268,16,SCO4,2016-10-15,Cowdenbeath,Annan Athletic,2,2,0,D
94269,16,SCO4,2016-10-15,Edinburgh City,Clyde,0,1,-1,L
94270,16,SCO4,2016-10-15,Montrose,Elgin City,0,5,-5,L
94271,16,SCO4,2016-10-29,Berwick Rangers,Arbroath,1,1,0,D
94272,16,SCO4,2016-10-29,Clyde,Stirling Albion,1,1,0,D
94273,16,SCO4,2016-10-29,Forfar Athletic,Edinburgh City,1,1,0,D
94274,16,SCO4,2016-10-29,Elgin City,Cowdenbeath,3,1,2,W
94275,16,SCO4,2016-11-05,Stirling Albion,Forfar Athletic,0,3,-3,L
94276,16,SCO4,2016-11-05,Annan Athletic,Arbroath,1,2,-1,L
94277,16,SCO4,2016-11-05,Berwick Rangers,Cowdenbeath,1,1,0,D
94278,16,SCO4,2016-11-05,Clyde,Elgin City,2,1,1,W
94279,16,SCO4,2016-11-05,Montrose,Edinburgh City,0,1,-1,L
94280,16,SCO4,2016-11-08,Annan Athletic,Montrose,2,3,-1,L
94281,16,SCO4,2016-11-12,Arbroath,Clyde,4,0,4,W
94282,16,SCO4,2016-11-12,Cowdenbeath,Montrose,2,0,2,W
94283,16,SCO4,2016-11-12,Edinburgh City,Annan Athletic,1,0,1,W
94284,16,SCO4,2016-11-12,Elgin City,Stirling Albion,2,3,-1,L
94285,16,SCO4,2016-11-12,Forfar Athletic,Berwick Rangers,2,0,2,W
94286,16,SCO4,2016-11-19,Stirling Albion,Arbroath,2,2,0,D
94287,16,SCO4,2016-11-19,Annan Athletic,Elgin City,1,0,1,W
94288,16,SCO4,2016-11-19,Clyde,Berwick Rangers,3,2,1,W
94289,16,SCO4,2016-11-19,Edinburgh City,Cowdenbeath,1,1,0,D
94290,16,SCO4,2016-11-19,Montrose,Forfar Athletic,1,1,0,D
94291,16,SCO4,2016-12-03,Arbroath,Edinburgh City,0,1,-1,L
94292,16,SCO4,2016-12-03,Cowdenbeath,Clyde,1,0,1,W
94293,16,SCO4,2016-12-03,Elgin City,Montrose,4,1,3,W
94294,16,SCO4,2016-12-06,Berwick Rangers,Stirling Albion,3,2,1,W
94295,16,SCO4,2016-12-10,Annan Athletic,Cowdenbeath,2,0,2,W
94296,16,SCO4,2016-12-10,Edinburgh City,Stirling Albion,2,0,2,W
94297,16,SCO4,2016-12-10,Elgin City,Berwick Rangers,6,0,6,W
94298,16,SCO4,2016-12-10,Forfar Athletic,Arbroath,0,1,-1,L
94299,16,SCO4,2016-12-10,Montrose,Clyde,2,1,1,W
94300,16,SCO4,2016-12-13,Forfar Athletic,Annan Athletic,5,1,4,W
94301,16,SCO4,2016-12-17,Stirling Albion,Annan Athletic,3,1,2,W
94302,16,SCO4,2016-12-17,Arbroath,Elgin City,3,2,1,W
94303,16,SCO4,2016-12-17,Berwick Rangers,Montrose,1,2,-1,L
94304,16,SCO4,2016-12-17,Clyde,Edinburgh City,0,0,0,D
94305,16,SCO4,2016-12-17,Cowdenbeath,Forfar Athletic,3,4,-1,L
94306,16,SCO4,2016-12-24,Annan Athletic,Berwick Rangers,3,1,2,W
94307,16,SCO4,2016-12-24,Cowdenbeath,Arbroath,0,2,-2,L
94308,16,SCO4,2016-12-24,Montrose,Stirling Albion,2,2,0,D
94309,16,SCO4,2016-12-26,Forfar Athletic,Clyde,4,3,1,W
94310,16,SCO4,2016-12-31,Stirling Albion,Cowdenbeath,1,2,-1,L
94311,16,SCO4,2016-12-31,Clyde,Annan Athletic,2,3,-1,L
94312,16,SCO4,2016-12-31,Berwick Rangers,Edinburgh City,1,3,-2,L
94313,16,SCO4,2017-01-02,Arbroath,Montrose,0,0,0,D
94314,16,SCO4,2017-01-02,Elgin City,Forfar Athletic,2,2,0,D
94315,16,SCO4,2017-01-07,Stirling Albion,Clyde,3,0,3,W
94316,16,SCO4,2017-01-07,Annan Athletic,Forfar Athletic,1,2,-1,L
94317,16,SCO4,2017-01-07,Cowdenbeath,Berwick Rangers,0,1,-1,L
94318,16,SCO4,2017-01-07,Edinburgh City,Arbroath,0,2,-2,L
94319,16,SCO4,2017-01-07,Montrose,Elgin City,0,3,-3,L
94320,16,SCO4,2017-01-14,Arbroath,Berwick Rangers,4,1,3,W
94321,16,SCO4,2017-01-14,Elgin City,Annan Athletic,3,2,1,W
94322,16,SCO4,2017-01-14,Forfar Athletic,Stirling Albion,1,1,0,D
94323,16,SCO4,2017-01-21,Arbroath,Annan Athletic,1,2,-1,L
94324,16,SCO4,2017-01-21,Edinburgh City,Forfar Athletic,0,1,-1,L
94325,16,SCO4,2017-01-21,Montrose,Cowdenbeath,2,1,1,W
94326,16,SCO4,2017-01-28,Annan Athletic,Stirling Albion,4,1,3,W
94327,16,SCO4,2017-01-28,Clyde,Arbroath,1,2,-1,L
94328,16,SCO4,2017-01-28,Elgin City,Edinburgh City,3,1,2,W
94329,16,SCO4,2017-01-28,Forfar Athletic,Cowdenbeath,3,1,2,W
94330,16,SCO4,2017-01-28,Montrose,Berwick Rangers,2,1,1,W
94331,16,SCO4,2017-02-04,Stirling Albion,Montrose,1,2,-1,L
94332,16,SCO4,2017-02-04,Arbroath,Forfar Athletic,0,1,-1,L
94333,16,SCO4,2017-02-04,Berwick Rangers,Annan Athletic,4,1,3,W
94334,16,SCO4,2017-02-04,Edinburgh City,Clyde,0,0,0,D
94335,16,SCO4,2017-02-11,Stirling Albion,Berwick Rangers,2,2,0,D
94336,16,SCO4,2017-02-11,Annan Athletic,Edinburgh City,1,0,1,W
94337,16,SCO4,2017-02-11,Forfar Athletic,Elgin City,1,1,0,D
94338,16,SCO4,2017-02-11,Montrose,Arbroath,1,3,-2,L
94339,16,SCO4,2017-02-18,Arbroath,Stirling Albion,1,1,0,D
94340,16,SCO4,2017-02-18,Berwick Rangers,Forfar Athletic,3,2,1,W
94341,16,SCO4,2017-02-18,Cowdenbeath,Annan Athletic,0,1,-1,L
94342,16,SCO4,2017-02-18,Edinburgh City,Montrose,1,1,0,D
94343,16,SCO4,2017-02-18,Elgin City,Clyde,4,1,3,W
94344,16,SCO4,2017-02-25,Stirling Albion,Edinburgh City,1,0,1,W
94345,16,SCO4,2017-02-25,Annan Athletic,Clyde,1,0,1,W
94346,16,SCO4,2017-02-25,Arbroath,Cowdenbeath,4,1,3,W
94347,16,SCO4,2017-02-25,Berwick Rangers,Elgin City,0,1,-1,L
94348,16,SCO4,2017-02-25,Forfar Athletic,Montrose,0,0,0,D
94349,16,SCO4,2017-02-28,Clyde,Montrose,1,2,-1,L
94350,16,SCO4,2017-02-28,Cowdenbeath,Edinburgh City,1,2,-1,L
94351,16,SCO4,2017-02-28,Stirling Albion,Elgin City,1,0,1,W
94352,16,SCO4,2017-03-04,Clyde,Forfar Athletic,2,2,0,D
94353,16,SCO4,2017-03-04,Cowdenbeath,Stirling Albion,0,2,-2,L
94354,16,SCO4,2017-03-04,Elgin City,Arbroath,0,0,0,D
94355,16,SCO4,2017-03-04,Montrose,Annan Athletic,2,3,-1,L
94356,16,SCO4,2017-03-07,Berwick Rangers,Clyde,4,3,1,W
94357,16,SCO4,2017-03-11,Annan Athletic,Elgin City,1,0,1,W
94358,16,SCO4,2017-03-11,Arbroath,Clyde,1,0,1,W
94359,16,SCO4,2017-03-11,Berwick Rangers,Cowdenbeath,1,3,-2,L
94360,16,SCO4,2017-03-11,Forfar Athletic,Edinburgh City,1,2,-1,L
94361,16,SCO4,2017-03-11,Montrose,Stirling Albion,1,3,-2,L
94362,16,SCO4,2017-03-14,Cowdenbeath,Elgin City,1,1,0,D
94363,16,SCO4,2017-03-15,Edinburgh City,Berwick Rangers,2,2,0,D
94364,16,SCO4,2017-03-18,Stirling Albion,Annan Athletic,1,0,1,W
94365,16,SCO4,2017-03-18,Berwick Rangers,Arbroath,0,2,-2,L
94366,16,SCO4,2017-03-18,Clyde,Edinburgh City,3,1,2,W
94367,16,SCO4,2017-03-18,Cowdenbeath,Montrose,0,2,-2,L
94368,16,SCO4,2017-03-18,Elgin City,Forfar Athletic,1,1,0,D
94369,16,SCO4,2017-03-21,Clyde,Cowdenbeath,0,2,-2,L
94370,16,SCO4,2017-03-25,Annan Athletic,Cowdenbeath,1,0,1,W
94371,16,SCO4,2017-03-25,Arbroath,Montrose,0,1,-1,L
94372,16,SCO4,2017-03-25,Clyde,Stirling Albion,2,3,-1,L
94373,16,SCO4,2017-03-25,Edinburgh City,Elgin City,3,0,3,W
94374,16,SCO4,2017-03-25,Forfar Athletic,Berwick Rangers,2,3,-1,L
94375,16,SCO4,2017-04-01,Stirling Albion,Forfar Athletic,0,3,-3,L
94376,16,SCO4,2017-04-01,Annan Athletic,Arbroath,2,5,-3,L
94377,16,SCO4,2017-04-01,Cowdenbeath,Clyde,1,0,1,W
94378,16,SCO4,2017-04-01,Elgin City,Berwick Rangers,2,2,0,D
94379,16,SCO4,2017-04-01,Montrose,Edinburgh City,3,0,3,W
94380,16,SCO4,2017-04-08,Berwick Rangers,Stirling Albion,0,1,-1,L
94381,16,SCO4,2017-04-08,Clyde,Annan Athletic,2,1,1,W
94382,16,SCO4,2017-04-08,Edinburgh City,Cowdenbeath,1,1,0,D
94383,16,SCO4,2017-04-08,Elgin City,Montrose,1,1,0,D
94384,16,SCO4,2017-04-08,Forfar Athletic,Arbroath,1,1,0,D
94385,16,SCO4,2017-04-15,Stirling Albion,Cowdenbeath,0,3,-3,L
94386,16,SCO4,2017-04-15,Annan Athletic,Berwick Rangers,2,1,1,W
94387,16,SCO4,2017-04-15,Arbroath,Edinburgh City,0,1,-1,L
94388,16,SCO4,2017-04-15,Clyde,Elgin City,3,2,1,W
94389,16,SCO4,2017-04-15,Montrose,Forfar Athletic,1,0,1,W
94390,16,SCO4,2017-04-22,Berwick Rangers,Montrose,0,1,-1,L
94391,16,SCO4,2017-04-22,Cowdenbeath,Arbroath,1,2,-1,L
94392,16,SCO4,2017-04-22,Edinburgh City,Annan Athletic,2,0,2,W
94393,16,SCO4,2017-04-22,Elgin City,Stirling Albion,2,2,0,D
94394,16,SCO4,2017-04-22,Forfar Athletic,Clyde,3,0,3,W
94395,16,SCO4,2017-04-29,Annan Athletic,Montrose,5,1,4,W
94396,16,SCO4,2017-04-29,Arbroath,Elgin City,3,2,1,W
94397,16,SCO4,2017-04-29,Clyde,Berwick Rangers,1,1,0,D
94398,16,SCO4,2017-04-29,Cowdenbeath,Forfar Athletic,1,1,0,D
94399,16,SCO4,2017-04-29,Edinburgh City,Stirling Albion,1,0,1,W
94400,16,SCO4,2017-05-06,Stirling Albion,Arbroath,1,1,0,D
94401,16,SCO4,2017-05-06,Elgin City,Cowdenbeath,0,0,0,D
94402,16,SCO4,2017-05-06,Forfar Athletic,Annan Athletic,2,4,-2,L
94403,16,SCO4,2017-05-06,Montrose,Clyde,1,1,0,D
94404,16,SCO4,2017-05-06,Berwick Rangers,Edinburgh City,3,2,1,W
94405,17,SCO4,2017-08-05,Annan Athletic,Peterhead,1,2,-1,L
94406,17,SCO4,2017-08-05,Berwick Rangers,Clyde,3,1,2,W
94407,17,SCO4,2017-08-05,Edinburgh City,Montrose,1,3,-2,L
94408,17,SCO4,2017-08-05,Elgin City,Cowdenbeath,1,1,0,D
94409,17,SCO4,2017-08-05,Stenhousemuir,Stirling Albion,2,3,-1,L
94410,17,SCO4,2017-08-12,Clyde,Annan Athletic,2,1,1,W
94411,17,SCO4,2017-08-12,Cowdenbeath,Edinburgh City,1,0,1,W
94412,17,SCO4,2017-08-12,Montrose,Stenhousemuir,1,1,0,D
94413,17,SCO4,2017-08-12,Peterhead,Elgin City,3,0,3,W
94414,17,SCO4,2017-08-12,Stirling Albion,Berwick Rangers,4,0,4,W
94415,17,SCO4,2017-08-19,Berwick Rangers,Annan Athletic,1,5,-4,L
94416,17,SCO4,2017-08-19,Elgin City,Clyde,3,2,1,W
94417,17,SCO4,2017-08-19,Montrose,Cowdenbeath,1,0,1,W
94418,17,SCO4,2017-08-19,Stenhousemuir,Peterhead,3,1,2,W
94419,17,SCO4,2017-08-19,Stirling Albion,Edinburgh City,2,0,2,W
94420,17,SCO4,2017-08-26,Annan Athletic,Montrose,0,1,-1,L
94421,17,SCO4,2017-08-26,Clyde,Stenhousemuir,1,1,0,D
94422,17,SCO4,2017-08-26,Cowdenbeath,Berwick Rangers,0,1,-1,L
94423,17,SCO4,2017-08-26,Edinburgh City,Elgin City,0,3,-3,L
94424,17,SCO4,2017-08-26,Peterhead,Stirling Albion,2,4,-2,L
94425,17,SCO4,2017-09-09,Edinburgh City,Berwick Rangers,1,0,1,W
94426,17,SCO4,2017-09-09,Elgin City,Annan Athletic,0,1,-1,L
94427,17,SCO4,2017-09-09,Peterhead,Montrose,1,1,0,D
94428,17,SCO4,2017-09-09,Stenhousemuir,Cowdenbeath,1,0,1,W
94429,17,SCO4,2017-09-09,Stirling Albion,Clyde,2,3,-1,L
94430,17,SCO4,2017-09-16,Annan Athletic,Stenhousemuir,1,1,0,D
94431,17,SCO4,2017-09-16,Berwick Rangers,Elgin City,3,2,1,W
94432,17,SCO4,2017-09-16,Clyde,Edinburgh City,2,3,-1,L
94433,17,SCO4,2017-09-16,Cowdenbeath,Peterhead,0,4,-4,L
94434,17,SCO4,2017-09-16,Montrose,Stirling Albion,1,3,-2,L
94435,17,SCO4,2017-09-23,Clyde,Cowdenbeath,1,1,0,D
94436,17,SCO4,2017-09-23,Edinburgh City,Peterhead,0,3,-3,L
94437,17,SCO4,2017-09-23,Elgin City,Montrose,3,0,3,W
94438,17,SCO4,2017-09-23,Stenhousemuir,Berwick Rangers,3,0,3,W
94439,17,SCO4,2017-09-23,Stirling Albion,Annan Athletic,3,2,1,W
94440,17,SCO4,2017-09-30,Annan Athletic,Cowdenbeath,1,0,1,W
94441,17,SCO4,2017-09-30,Montrose,Clyde,3,2,1,W
94442,17,SCO4,2017-09-30,Peterhead,Berwick Rangers,0,2,-2,L
94443,17,SCO4,2017-09-30,Stenhousemuir,Edinburgh City,3,0,3,W
94444,17,SCO4,2017-09-30,Stirling Albion,Elgin City,2,2,0,D
94445,17,SCO4,2017-10-21,Berwick Rangers,Montrose,0,1,-1,L
94446,17,SCO4,2017-10-21,Clyde,Peterhead,1,4,-3,L
94447,17,SCO4,2017-10-21,Cowdenbeath,Stirling Albion,0,3,-3,L
94448,17,SCO4,2017-10-21,Edinburgh City,Annan Athletic,0,1,-1,L
94449,17,SCO4,2017-10-21,Elgin City,Stenhousemuir,2,0,2,W
94450,17,SCO4,2017-10-28,Berwick Rangers,Cowdenbeath,1,0,1,W
94451,17,SCO4,2017-10-28,Clyde,Elgin City,2,4,-2,L
94452,17,SCO4,2017-10-28,Montrose,Edinburgh City,1,0,1,W
94453,17,SCO4,2017-10-28,Peterhead,Annan Athletic,1,0,1,W
94454,17,SCO4,2017-10-28,Stirling Albion,Stenhousemuir,1,2,-1,L
94455,17,SCO4,2017-11-04,Annan Athletic,Berwick Rangers,0,0,0,D
94456,17,SCO4,2017-11-04,Cowdenbeath,Montrose,1,3,-2,L
94457,17,SCO4,2017-11-04,Edinburgh City,Stirling Albion,1,2,-1,L
94458,17,SCO4,2017-11-04,Elgin City,Peterhead,0,2,-2,L
94459,17,SCO4,2017-11-04,Stenhousemuir,Clyde,1,1,0,D
94460,17,SCO4,2017-11-11,Berwick Rangers,Edinburgh City,1,1,0,D
94461,17,SCO4,2017-11-11,Clyde,Stirling Albion,1,1,0,D
94462,17,SCO4,2017-11-11,Cowdenbeath,Elgin City,1,3,-2,L
94463,17,SCO4,2017-11-11,Montrose,Annan Athletic,1,1,0,D
94464,17,SCO4,2017-11-11,Peterhead,Stenhousemuir,2,3,-1,L
94465,17,SCO4,2017-11-18,Cowdenbeath,Annan Athletic,1,1,0,D
94466,17,SCO4,2017-11-25,Annan Athletic,Clyde,0,0,0,D
94467,17,SCO4,2017-11-25,Edinburgh City,Cowdenbeath,0,0,0,D
94468,17,SCO4,2017-11-25,Elgin City,Berwick Rangers,5,1,4,W
94469,17,SCO4,2017-11-25,Stenhousemuir,Montrose,0,1,-1,L
94470,17,SCO4,2017-12-02,Annan Athletic,Elgin City,2,0,2,W
94471,17,SCO4,2017-12-02,Berwick Rangers,Stirling Albion,1,0,1,W
94472,17,SCO4,2017-12-02,Clyde,Montrose,0,0,0,D
94473,17,SCO4,2017-12-02,Peterhead,Edinburgh City,3,0,3,W
94474,17,SCO4,2017-12-05,Stirling Albion,Peterhead,0,1,-1,L
94475,17,SCO4,2017-12-09,Elgin City,Edinburgh City,1,1,0,D
94476,17,SCO4,2017-12-09,Montrose,Berwick Rangers,3,0,3,W
94477,17,SCO4,2017-12-09,Stenhousemuir,Annan Athletic,1,3,-2,L
94478,17,SCO4,2017-12-16,Annan Athletic,Stirling Albion,1,1,0,D
94479,17,SCO4,2017-12-16,Edinburgh City,Stenhousemuir,1,2,-1,L
94480,17,SCO4,2017-12-16,Montrose,Elgin City,3,0,3,W
94481,17,SCO4,2017-12-19,Cowdenbeath,Stenhousemuir,1,1,0,D
94482,17,SCO4,2017-12-23,Annan Athletic,Edinburgh City,2,1,1,W
94483,17,SCO4,2017-12-23,Clyde,Berwick Rangers,0,0,0,D
94484,17,SCO4,2017-12-23,Peterhead,Cowdenbeath,3,2,1,W
94485,17,SCO4,2017-12-23,Stenhousemuir,Elgin City,4,1,3,W
94486,17,SCO4,2017-12-23,Stirling Albion,Montrose,0,1,-1,L
94487,17,SCO4,2017-12-30,Montrose,Peterhead,2,6,-4,L
94488,17,SCO4,2018-01-02,Clyde,Annan Athletic,0,0,0,D
94489,17,SCO4,2018-01-02,Edinburgh City,Berwick Rangers,3,0,3,W
94490,17,SCO4,2018-01-02,Montrose,Cowdenbeath,1,1,0,D
94491,17,SCO4,2018-01-02,Peterhead,Elgin City,7,0,7,W
94492,17,SCO4,2018-01-02,Stenhousemuir,Stirling Albion,2,1,1,W
94493,17,SCO4,2018-01-06,Annan Athletic,Montrose,0,1,-1,L
94494,17,SCO4,2018-01-06,Cowdenbeath,Edinburgh City,0,2,-2,L
94495,17,SCO4,2018-01-06,Elgin City,Clyde,2,1,1,W
94496,17,SCO4,2018-01-06,Stenhousemuir,Peterhead,1,4,-3,L
94497,17,SCO4,2018-01-06,Stirling Albion,Berwick Rangers,2,0,2,W
94498,17,SCO4,2018-01-13,Berwick Rangers,Annan Athletic,0,2,-2,L
94499,17,SCO4,2018-01-13,Clyde,Stenhousemuir,0,3,-3,L
94500,17,SCO4,2018-01-13,Edinburgh City,Montrose,0,2,-2,L
94501,17,SCO4,2018-01-13,Elgin City,Cowdenbeath,1,0,1,W
94502,17,SCO4,2018-01-13,Peterhead,Stirling Albion,4,3,1,W
94503,17,SCO4,2018-01-20,Montrose,Clyde,1,3,-2,L
94504,17,SCO4,2018-01-27,Clyde,Peterhead,1,0,1,W
94505,17,SCO4,2018-01-27,Cowdenbeath,Berwick Rangers,1,3,-2,L
94506,17,SCO4,2018-01-27,Edinburgh City,Annan Athletic,3,2,1,W
94507,17,SCO4,2018-01-27,Elgin City,Stenhousemuir,2,0,2,W
94508,17,SCO4,2018-01-27,Montrose,Stirling Albion,2,1,1,W
94509,17,SCO4,2018-01-30,Berwick Rangers,Peterhead,2,3,-1,L
94510,17,SCO4,2018-01-31,Stirling Albion,Cowdenbeath,1,0,1,W
94511,17,SCO4,2018-02-03,Annan Athletic,Cowdenbeath,1,1,0,D
94512,17,SCO4,2018-02-03,Clyde,Edinburgh City,3,2,1,W
94513,17,SCO4,2018-02-03,Peterhead,Montrose,0,1,-1,L
94514,17,SCO4,2018-02-03,Stenhousemuir,Berwick Rangers,4,0,4,W
94515,17,SCO4,2018-02-03,Stirling Albion,Elgin City,3,1,2,W
94516,17,SCO4,2018-02-10,Berwick Rangers,Clyde,0,1,-1,L
94517,17,SCO4,2018-02-10,Cowdenbeath,Stirling Albion,1,2,-1,L
94518,17,SCO4,2018-02-10,Edinburgh City,Peterhead,0,0,0,D
94519,17,SCO4,2018-02-10,Elgin City,Annan Athletic,2,1,1,W
94520,17,SCO4,2018-02-10,Montrose,Stenhousemuir,1,0,1,W
94521,17,SCO4,2018-02-17,Clyde,Cowdenbeath,2,0,2,W
94522,17,SCO4,2018-02-17,Elgin City,Montrose,2,2,0,D
94523,17,SCO4,2018-02-17,Peterhead,Berwick Rangers,1,1,0,D
94524,17,SCO4,2018-02-17,Stenhousemuir,Edinburgh City,1,0,1,W
94525,17,SCO4,2018-02-17,Stirling Albion,Annan Athletic,3,0,3,W
94526,17,SCO4,2018-02-20,Annan Athletic,Peterhead,3,3,0,D
94527,17,SCO4,2018-02-24,Annan Athletic,Stenhousemuir,2,0,2,W
94528,17,SCO4,2018-02-24,Berwick Rangers,Montrose,2,2,0,D
94529,17,SCO4,2018-02-24,Cowdenbeath,Peterhead,0,2,-2,L
94530,17,SCO4,2018-02-24,Edinburgh City,Elgin City,4,0,4,W
94531,17,SCO4,2018-02-24,Stirling Albion,Clyde,2,1,1,W
94532,17,SCO4,2018-02-27,Peterhead,Clyde,2,1,1,W
94533,17,SCO4,2018-03-10,Annan Athletic,Edinburgh City,2,3,-1,L
94534,17,SCO4,2018-03-10,Elgin City,Berwick Rangers,3,0,3,W
94535,17,SCO4,2018-03-10,Stenhousemuir,Clyde,2,3,-1,L
94536,17,SCO4,2018-03-10,Stirling Albion,Peterhead,0,1,-1,L
94537,17,SCO4,2018-03-13,Berwick Rangers,Stirling Albion,0,1,-1,L
94538,17,SCO4,2018-03-13,Clyde,Elgin City,1,0,1,W
94539,17,SCO4,2018-03-13,Edinburgh City,Cowdenbeath,1,1,0,D
94540,17,SCO4,2018-03-13,Montrose,Annan Athletic,2,1,1,W
94541,17,SCO4,2018-03-13,Peterhead,Stenhousemuir,1,2,-1,L
94542,17,SCO4,2018-03-17,Annan Athletic,Clyde,1,1,0,D
94543,17,SCO4,2018-03-17,Cowdenbeath,Elgin City,3,1,2,W
94544,17,SCO4,2018-03-17,Edinburgh City,Stirling Albion,2,2,0,D
94545,17,SCO4,2018-03-17,Montrose,Peterhead,3,2,1,W
94546,17,SCO4,2018-03-20,Edinburgh City,Clyde,0,3,-3,L
94547,17,SCO4,2018-03-20,Elgin City,Stirling Albion,0,2,-2,L
94548,17,SCO4,2018-03-20,Stenhousemuir,Cowdenbeath,1,2,-1,L
94549,17,SCO4,2018-03-24,Berwick Rangers,Edinburgh City,1,1,0,D
94550,17,SCO4,2018-03-24,Clyde,Montrose,3,0,3,W
94551,17,SCO4,2018-03-24,Peterhead,Annan Athletic,1,0,1,W
94552,17,SCO4,2018-03-24,Stenhousemuir,Elgin City,0,2,-2,L
94553,17,SCO4,2018-03-24,Stirling Albion,Cowdenbeath,2,2,0,D
94554,17,SCO4,2018-03-27,Cowdenbeath,Clyde,0,3,-3,L
94555,17,SCO4,2018-03-27,Berwick Rangers,Elgin City,2,2,0,D
94556,17,SCO4,2018-03-27,Stirling Albion,Edinburgh City,2,2,0,D
94557,17,SCO4,2018-03-31,Annan Athletic,Berwick Rangers,0,0,0,D
94558,17,SCO4,2018-03-31,Cowdenbeath,Stenhousemuir,1,1,0,D
94559,17,SCO4,2018-03-31,Elgin City,Stirling Albion,3,0,3,W
94560,17,SCO4,2018-03-31,Montrose,Edinburgh City,3,0,3,W
94561,17,SCO4,2018-03-31,Peterhead,Clyde,3,0,3,W
94562,17,SCO4,2018-04-07,Annan Athletic,Elgin City,4,1,3,W
94563,17,SCO4,2018-04-07,Berwick Rangers,Peterhead,1,3,-2,L
94564,17,SCO4,2018-04-07,Cowdenbeath,Clyde,1,0,1,W
94565,17,SCO4,2018-04-07,Edinburgh City,Stenhousemuir,1,4,-3,L
94566,17,SCO4,2018-04-07,Stirling Albion,Montrose,0,5,-5,L
94567,17,SCO4,2018-04-10,Cowdenbeath,Montrose,0,3,-3,L
94568,17,SCO4,2018-04-14,Clyde,Stirling Albion,2,1,1,W
94569,17,SCO4,2018-04-14,Elgin City,Edinburgh City,1,1,0,D
94570,17,SCO4,2018-04-14,Montrose,Berwick Rangers,1,0,1,W
94571,17,SCO4,2018-04-14,Peterhead,Cowdenbeath,1,0,1,W
94572,17,SCO4,2018-04-14,Stenhousemuir,Annan Athletic,3,2,1,W
94573,17,SCO4,2018-04-17,Berwick Rangers,Stenhousemuir,0,0,0,D
94574,17,SCO4,2018-04-21,Annan Athletic,Stirling Albion,3,1,2,W
94575,17,SCO4,2018-04-21,Berwick Rangers,Cowdenbeath,1,0,1,W
94576,17,SCO4,2018-04-21,Edinburgh City,Clyde,1,3,-2,L
94577,17,SCO4,2018-04-21,Elgin City,Peterhead,0,1,-1,L
94578,17,SCO4,2018-04-21,Stenhousemuir,Montrose,0,2,-2,L
94579,17,SCO4,2018-04-24,Berwick Rangers,Stenhousemuir,2,2,0,D
94580,17,SCO4,2018-04-28,Clyde,Berwick Rangers,1,2,-1,L
94581,17,SCO4,2018-04-28,Cowdenbeath,Annan Athletic,0,2,-2,L
94582,17,SCO4,2018-04-28,Montrose,Elgin City,1,1,0,D
94583,17,SCO4,2018-04-28,Peterhead,Edinburgh City,2,1,1,W
94584,17,SCO4,2018-04-28,Stirling Albion,Stenhousemuir,1,1,0,D
94585,18,SCO4,2018-08-04,Annan Athletic,Elgin City,1,1,0,D
94586,18,SCO4,2018-08-04,Berwick Rangers,Stirling Albion,1,0,1,W
94587,18,SCO4,2018-08-04,Clyde,Cowdenbeath,2,0,2,W
94588,18,SCO4,2018-08-04,Edinburgh City,Albion Rovers,4,0,4,W
94589,18,SCO4,2018-08-04,Peterhead,Queens Park,1,1,0,D
94590,18,SCO4,2018-08-11,Albion Rovers,Peterhead,0,4,-4,L
94591,18,SCO4,2018-08-11,Cowdenbeath,Annan Athletic,1,2,-1,L
94592,18,SCO4,2018-08-11,Elgin City,Edinburgh City,1,0,1,W
94593,18,SCO4,2018-08-11,Queens Park,Berwick Rangers,1,0,1,W
94594,18,SCO4,2018-08-11,Stirling Albion,Clyde,0,3,-3,L
94595,18,SCO4,2018-08-18,Albion Rovers,Elgin City,0,1,-1,L
94596,18,SCO4,2018-08-18,Annan Athletic,Queens Park,3,1,2,W
94597,18,SCO4,2018-08-18,Cowdenbeath,Berwick Rangers,4,0,4,W
94598,18,SCO4,2018-08-18,Edinburgh City,Stirling Albion,3,1,2,W
94599,18,SCO4,2018-08-18,Peterhead,Clyde,1,0,1,W
94600,18,SCO4,2018-08-25,Berwick Rangers,Annan Athletic,0,3,-3,L
94601,18,SCO4,2018-08-25,Clyde,Edinburgh City,0,2,-2,L
94602,18,SCO4,2018-08-25,Queens Park,Albion Rovers,2,0,2,W
94603,18,SCO4,2018-08-25,Stirling Albion,Peterhead,0,2,-2,L
94604,18,SCO4,2018-09-01,Albion Rovers,Berwick Rangers,3,5,-2,L
94605,18,SCO4,2018-09-01,Annan Athletic,Clyde,1,2,-1,L
94606,18,SCO4,2018-09-01,Elgin City,Stirling Albion,0,3,-3,L
94607,18,SCO4,2018-09-01,Peterhead,Edinburgh City,0,1,-1,L
94608,18,SCO4,2018-09-01,Queens Park,Cowdenbeath,0,0,0,D
94609,18,SCO4,2018-09-15,Berwick Rangers,Elgin City,0,3,-3,L
94610,18,SCO4,2018-09-15,Clyde,Albion Rovers,1,0,1,W
94611,18,SCO4,2018-09-15,Cowdenbeath,Peterhead,2,4,-2,L
94612,18,SCO4,2018-09-15,Edinburgh City,Annan Athletic,2,1,1,W
94613,18,SCO4,2018-09-15,Stirling Albion,Queens Park,1,0,1,W
94614,18,SCO4,2018-09-22,Clyde,Elgin City,4,1,3,W
94615,18,SCO4,2018-09-22,Cowdenbeath,Albion Rovers,1,1,0,D
94616,18,SCO4,2018-09-22,Peterhead,Berwick Rangers,1,0,1,W
94617,18,SCO4,2018-09-22,Queens Park,Edinburgh City,0,2,-2,L
94618,18,SCO4,2018-09-22,Stirling Albion,Annan Athletic,1,2,-1,L
94619,18,SCO4,2018-09-29,Albion Rovers,Stirling Albion,3,0,3,W
94620,18,SCO4,2018-09-29,Annan Athletic,Peterhead,1,3,-2,L
94621,18,SCO4,2018-09-29,Berwick Rangers,Clyde,2,3,-1,L
94622,18,SCO4,2018-09-29,Edinburgh City,Cowdenbeath,1,0,1,W
94623,18,SCO4,2018-09-29,Elgin City,Queens Park,2,1,1,W
94624,18,SCO4,2018-10-06,Annan Athletic,Albion Rovers,3,1,2,W
94625,18,SCO4,2018-10-06,Cowdenbeath,Stirling Albion,1,0,1,W
94626,18,SCO4,2018-10-06,Edinburgh City,Berwick Rangers,3,0,3,W
94627,18,SCO4,2018-10-06,Peterhead,Elgin City,3,0,3,W
94628,18,SCO4,2018-10-06,Queens Park,Clyde,1,0,1,W
94629,18,SCO4,2018-10-13,Elgin City,Cowdenbeath,3,1,2,W
94630,18,SCO4,2018-10-27,Albion Rovers,Queens Park,0,3,-3,L
94631,18,SCO4,2018-10-27,Berwick Rangers,Cowdenbeath,0,3,-3,L
94632,18,SCO4,2018-10-27,Clyde,Peterhead,1,3,-2,L
94633,18,SCO4,2018-10-27,Elgin City,Annan Athletic,0,1,-1,L
94634,18,SCO4,2018-10-27,Stirling Albion,Edinburgh City,0,1,-1,L
94635,18,SCO4,2018-11-03,Cowdenbeath,Elgin City,1,2,-1,L
94636,18,SCO4,2018-11-03,Edinburgh City,Clyde,0,1,-1,L
94637,18,SCO4,2018-11-03,Peterhead,Albion Rovers,2,1,1,W
94638,18,SCO4,2018-11-03,Queens Park,Annan Athletic,0,0,0,D
94639,18,SCO4,2018-11-03,Stirling Albion,Berwick Rangers,3,0,3,W
94640,18,SCO4,2018-11-10,Albion Rovers,Edinburgh City,1,2,-1,L
94641,18,SCO4,2018-11-10,Annan Athletic,Cowdenbeath,0,2,-2,L
94642,18,SCO4,2018-11-10,Clyde,Stirling Albion,1,1,0,D
94643,18,SCO4,2018-11-10,Elgin City,Berwick Rangers,2,4,-2,L
94644,18,SCO4,2018-11-10,Queens Park,Peterhead,2,0,2,W
94645,18,SCO4,2018-11-17,Annan Athletic,Stirling Albion,2,2,0,D
94646,18,SCO4,2018-11-17,Berwick Rangers,Albion Rovers,2,0,2,W
94647,18,SCO4,2018-11-17,Elgin City,Clyde,1,3,-2,L
94648,18,SCO4,2018-11-27,Cowdenbeath,Queens Park,2,0,2,W
94649,18,SCO4,2018-12-01,Albion Rovers,Cowdenbeath,1,1,0,D
94650,18,SCO4,2018-12-01,Clyde,Berwick Rangers,3,3,0,D
94651,18,SCO4,2018-12-01,Edinburgh City,Queens Park,2,0,2,W
94652,18,SCO4,2018-12-01,Peterhead,Annan Athletic,2,1,1,W
94653,18,SCO4,2018-12-01,Stirling Albion,Elgin City,5,2,3,W
94654,18,SCO4,2018-12-08,Annan Athletic,Edinburgh City,1,2,-1,L
94655,18,SCO4,2018-12-08,Berwick Rangers,Peterhead,0,5,-5,L
94656,18,SCO4,2018-12-08,Cowdenbeath,Clyde,1,1,0,D
94657,18,SCO4,2018-12-08,Elgin City,Albion Rovers,4,2,2,W
94658,18,SCO4,2018-12-08,Queens Park,Stirling Albion,1,1,0,D
94659,18,SCO4,2018-12-11,Edinburgh City,Peterhead,1,1,0,D
94660,18,SCO4,2018-12-15,Clyde,Annan Athletic,1,0,1,W
94661,18,SCO4,2018-12-15,Edinburgh City,Elgin City,4,1,3,W
94662,18,SCO4,2018-12-22,Albion Rovers,Clyde,0,3,-3,L
94663,18,SCO4,2018-12-22,Annan Athletic,Berwick Rangers,4,0,4,W
94664,18,SCO4,2018-12-22,Cowdenbeath,Edinburgh City,0,2,-2,L
94665,18,SCO4,2018-12-22,Peterhead,Stirling Albion,4,1,3,W
94666,18,SCO4,2018-12-22,Queens Park,Elgin City,0,4,-4,L
94667,18,SCO4,2018-12-29,Albion Rovers,Annan Athletic,1,1,0,D
94668,18,SCO4,2018-12-29,Berwick Rangers,Edinburgh City,2,2,0,D
94669,18,SCO4,2018-12-29,Clyde,Queens Park,2,0,2,W
94670,18,SCO4,2018-12-29,Elgin City,Peterhead,0,3,-3,L
94671,18,SCO4,2018-12-29,Stirling Albion,Cowdenbeath,2,1,1,W
94672,18,SCO4,2019-01-05,Annan Athletic,Elgin City,2,0,2,W
94673,18,SCO4,2019-01-05,Cowdenbeath,Berwick Rangers,2,0,2,W
94674,18,SCO4,2019-01-05,Edinburgh City,Stirling Albion,0,1,-1,L
94675,18,SCO4,2019-01-05,Peterhead,Clyde,1,2,-1,L
94676,18,SCO4,2019-01-05,Queens Park,Albion Rovers,2,2,0,D
94677,18,SCO4,2019-01-12,Albion Rovers,Peterhead,0,2,-2,L
94678,18,SCO4,2019-01-12,Berwick Rangers,Clyde,0,3,-3,L
94679,18,SCO4,2019-01-12,Elgin City,Cowdenbeath,1,4,-3,L
94680,18,SCO4,2019-01-12,Queens Park,Edinburgh City,0,4,-4,L
94681,18,SCO4,2019-01-12,Stirling Albion,Annan Athletic,2,1,1,W
94682,18,SCO4,2019-01-19,Edinburgh City,Annan Athletic,1,2,-1,L
94683,18,SCO4,2019-01-19,Peterhead,Berwick Rangers,2,0,2,W
94684,18,SCO4,2019-01-19,Stirling Albion,Queens Park,1,1,0,D
94685,18,SCO4,2019-01-26,Albion Rovers,Stirling Albion,0,5,-5,L
94686,18,SCO4,2019-01-26,Annan Athletic,Peterhead,3,0,3,W
94687,18,SCO4,2019-01-26,Clyde,Cowdenbeath,1,0,1,W
94688,18,SCO4,2019-01-26,Elgin City,Edinburgh City,3,3,0,D
94689,18,SCO4,2019-01-26,Queens Park,Berwick Rangers,7,1,6,W
94690,18,SCO4,2019-02-02,Edinburgh City,Albion Rovers,3,1,2,W
94691,18,SCO4,2019-02-09,Albion Rovers,Elgin City,0,3,-3,L
94692,18,SCO4,2019-02-09,Annan Athletic,Clyde,1,1,0,D
94693,18,SCO4,2019-02-09,Berwick Rangers,Stirling Albion,1,2,-1,L
94694,18,SCO4,2019-02-09,Peterhead,Edinburgh City,0,0,0,D
94695,18,SCO4,2019-02-09,Queens Park,Cowdenbeath,1,1,0,D
94696,18,SCO4,2019-02-12,Stirling Albion,Albion Rovers,1,0,1,W
94697,18,SCO4,2019-02-16,Cowdenbeath,Annan Athletic,2,4,-2,L
94698,18,SCO4,2019-02-16,Elgin City,Stirling Albion,3,2,1,W
94699,18,SCO4,2019-02-16,Peterhead,Queens Park,2,1,1,W
94700,18,SCO4,2019-02-19,Cowdenbeath,Albion Rovers,1,0,1,W
94701,18,SCO4,2019-02-23,Annan Athletic,Albion Rovers,4,0,4,W
94702,18,SCO4,2019-02-23,Berwick Rangers,Elgin City,0,3,-3,L
94703,18,SCO4,2019-02-23,Edinburgh City,Cowdenbeath,2,0,2,W
94704,18,SCO4,2019-02-23,Stirling Albion,Peterhead,0,1,-1,L
94705,18,SCO4,2019-02-26,Peterhead,Cowdenbeath,1,0,1,W
94706,18,SCO4,2019-02-26,Berwick Rangers,Annan Athletic,1,2,-1,L
94707,18,SCO4,2019-02-26,Elgin City,Queens Park,2,2,0,D
94708,18,SCO4,2019-02-26,Stirling Albion,Clyde,0,1,-1,L
94709,18,SCO4,2019-03-02,Albion Rovers,Berwick Rangers,1,1,0,D
94710,18,SCO4,2019-03-02,Annan Athletic,Queens Park,2,1,1,W
94711,18,SCO4,2019-03-02,Clyde,Edinburgh City,1,0,1,W
94712,18,SCO4,2019-03-02,Cowdenbeath,Stirling Albion,1,2,-1,L
94713,18,SCO4,2019-03-02,Peterhead,Elgin City,1,0,1,W
94714,18,SCO4,2019-03-05,Cowdenbeath,Peterhead,1,3,-2,L
94715,18,SCO4,2019-03-05,Edinburgh City,Berwick Rangers,1,0,1,W
94716,18,SCO4,2019-03-09,Berwick Rangers,Cowdenbeath,1,1,0,D
94717,18,SCO4,2019-03-09,Edinburgh City,Queens Park,2,0,2,W
94718,18,SCO4,2019-03-09,Elgin City,Clyde,2,1,1,W
94719,18,SCO4,2019-03-09,Peterhead,Annan Athletic,2,1,1,W
94720,18,SCO4,2019-03-09,Stirling Albion,Albion Rovers,0,1,-1,L
94721,18,SCO4,2019-03-12,Berwick Rangers,Queens Park,1,2,-1,L
94722,18,SCO4,2019-03-16,Annan Athletic,Edinburgh City,3,1,2,W
94723,18,SCO4,2019-03-16,Clyde,Stirling Albion,3,1,2,W
94724,18,SCO4,2019-03-16,Queens Park,Elgin City,4,1,3,W
94725,18,SCO4,2019-03-19,Clyde,Elgin City,2,0,2,W
94726,18,SCO4,2019-03-19,Berwick Rangers,Peterhead,2,0,2,W
94727,18,SCO4,2019-03-23,Clyde,Annan Athletic,2,1,1,W
94728,18,SCO4,2019-03-23,Cowdenbeath,Queens Park,0,0,0,D
94729,18,SCO4,2019-03-23,Edinburgh City,Peterhead,0,0,0,D
94730,18,SCO4,2019-03-23,Elgin City,Albion Rovers,0,2,-2,L
94731,18,SCO4,2019-03-23,Stirling Albion,Berwick Rangers,1,0,1,W
94732,18,SCO4,2019-03-26,Albion Rovers,Cowdenbeath,1,0,1,W
94733,18,SCO4,2019-03-30,Albion Rovers,Clyde,0,1,-1,L
94734,18,SCO4,2019-03-30,Berwick Rangers,Edinburgh City,0,2,-2,L
94735,18,SCO4,2019-03-30,Elgin City,Annan Athletic,0,1,-1,L
94736,18,SCO4,2019-03-30,Peterhead,Cowdenbeath,2,1,1,W
94737,18,SCO4,2019-03-30,Queens Park,Stirling Albion,0,0,0,D
94738,18,SCO4,2019-04-06,Albion Rovers,Queens Park,0,4,-4,L
94739,18,SCO4,2019-04-06,Annan Athletic,Berwick Rangers,6,0,6,W
94740,18,SCO4,2019-04-06,Clyde,Peterhead,3,3,0,D
94741,18,SCO4,2019-04-06,Cowdenbeath,Edinburgh City,4,1,3,W
94742,18,SCO4,2019-04-06,Stirling Albion,Elgin City,2,1,1,W
94743,18,SCO4,2019-04-13,Annan Athletic,Stirling Albion,2,2,0,D
94744,18,SCO4,2019-04-13,Berwick Rangers,Queens Park,0,3,-3,L
94745,18,SCO4,2019-04-13,Cowdenbeath,Elgin City,2,1,1,W
94746,18,SCO4,2019-04-13,Edinburgh City,Clyde,1,2,-1,L
94747,18,SCO4,2019-04-13,Peterhead,Albion Rovers,1,1,0,D
94748,18,SCO4,2019-04-20,Albion Rovers,Edinburgh City,3,2,1,W
94749,18,SCO4,2019-04-20,Clyde,Berwick Rangers,5,0,5,W
94750,18,SCO4,2019-04-20,Elgin City,Peterhead,1,2,-1,L
94751,18,SCO4,2019-04-20,Queens Park,Annan Athletic,0,3,-3,L
94752,18,SCO4,2019-04-20,Stirling Albion,Cowdenbeath,0,1,-1,L
94753,18,SCO4,2019-04-27,Annan Athletic,Cowdenbeath,3,2,1,W
94754,18,SCO4,2019-04-27,Berwick Rangers,Albion Rovers,0,3,-3,L
94755,18,SCO4,2019-04-27,Clyde,Queens Park,3,0,3,W
94756,18,SCO4,2019-04-27,Edinburgh City,Elgin City,1,1,0,D
94757,18,SCO4,2019-04-27,Peterhead,Stirling Albion,1,1,0,D
94758,18,SCO4,2019-05-04,Albion Rovers,Annan Athletic,0,2,-2,L
94759,18,SCO4,2019-05-04,Cowdenbeath,Clyde,2,1,1,W
94760,18,SCO4,2019-05-04,Elgin City,Berwick Rangers,2,0,2,W
94761,18,SCO4,2019-05-04,Queens Park,Peterhead,0,2,-2,L
94762,18,SCO4,2019-05-04,Stirling Albion,Edinburgh City,0,0,0,D
94763,19,SCO4,2019-08-03,Brechin City,Annan Athletic,0,1,-1,L
94764,19,SCO4,2019-08-03,Cove Rangers,Edinburgh City,5,0,5,W
94765,19,SCO4,2019-08-03,Elgin City,Cowdenbeath,3,0,3,W
94766,19,SCO4,2019-08-03,Stenhousemuir,Albion Rovers,2,3,-1,L
94767,19,SCO4,2019-08-03,Stirling Albion,Queens Park,0,1,-1,L
94768,19,SCO4,2019-08-10,Albion Rovers,Cove Rangers,4,4,0,D
94769,19,SCO4,2019-08-10,Annan Athletic,Elgin City,1,1,0,D
94770,19,SCO4,2019-08-10,Cowdenbeath,Stirling Albion,1,0,1,W
94771,19,SCO4,2019-08-10,Edinburgh City,Brechin City,2,1,1,W
94772,19,SCO4,2019-08-10,Queens Park,Stenhousemuir,1,1,0,D
94773,19,SCO4,2019-08-17,Annan Athletic,Albion Rovers,3,2,1,W
94774,19,SCO4,2019-08-17,Brechin City,Queens Park,0,3,-3,L
94775,19,SCO4,2019-08-17,Cove Rangers,Cowdenbeath,3,2,1,W
94776,19,SCO4,2019-08-17,Edinburgh City,Stirling Albion,1,0,1,W
94777,19,SCO4,2019-08-17,Elgin City,Stenhousemuir,0,1,-1,L
94778,19,SCO4,2019-08-24,Albion Rovers,Brechin City,0,1,-1,L
94779,19,SCO4,2019-08-24,Cowdenbeath,Annan Athletic,3,1,2,W
94780,19,SCO4,2019-08-24,Queens Park,Elgin City,0,0,0,D
94781,19,SCO4,2019-08-24,Stenhousemuir,Edinburgh City,1,3,-2,L
94782,19,SCO4,2019-08-24,Stirling Albion,Cove Rangers,1,2,-1,L
94783,19,SCO4,2019-08-31,Albion Rovers,Stirling Albion,2,1,1,W
94784,19,SCO4,2019-08-31,Annan Athletic,Stenhousemuir,1,1,0,D
94785,19,SCO4,2019-08-31,Cove Rangers,Queens Park,3,0,3,W
94786,19,SCO4,2019-08-31,Cowdenbeath,Brechin City,2,1,1,W
94787,19,SCO4,2019-08-31,Elgin City,Edinburgh City,3,3,0,D
94788,19,SCO4,2019-09-14,Brechin City,Cove Rangers,2,4,-2,L
94789,19,SCO4,2019-09-14,Edinburgh City,Annan Athletic,4,0,4,W
94790,19,SCO4,2019-09-14,Queens Park,Albion Rovers,1,1,0,D
94791,19,SCO4,2019-09-14,Stenhousemuir,Cowdenbeath,0,3,-3,L
94792,19,SCO4,2019-09-14,Stirling Albion,Elgin City,1,0,1,W
94793,19,SCO4,2019-09-21,Albion Rovers,Edinburgh City,1,3,-2,L
94794,19,SCO4,2019-09-21,Annan Athletic,Stirling Albion,0,0,0,D
94795,19,SCO4,2019-09-21,Elgin City,Cove Rangers,0,2,-2,L
94796,19,SCO4,2019-09-21,Queens Park,Cowdenbeath,0,3,-3,L
94797,19,SCO4,2019-09-21,Stenhousemuir,Brechin City,1,0,1,W
94798,19,SCO4,2019-09-28,Brechin City,Elgin City,2,1,1,W
94799,19,SCO4,2019-09-28,Cove Rangers,Annan Athletic,3,0,3,W
94800,19,SCO4,2019-09-28,Cowdenbeath,Albion Rovers,1,0,1,W
94801,19,SCO4,2019-09-28,Edinburgh City,Queens Park,2,1,1,W
94802,19,SCO4,2019-09-28,Stirling Albion,Stenhousemuir,1,1,0,D
94803,19,SCO4,2019-10-05,Albion Rovers,Elgin City,1,3,-2,L
94804,19,SCO4,2019-10-05,Brechin City,Stirling Albion,1,1,0,D
94805,19,SCO4,2019-10-05,Cowdenbeath,Edinburgh City,1,0,1,W
94806,19,SCO4,2019-10-05,Queens Park,Annan Athletic,1,2,-1,L
94807,19,SCO4,2019-10-05,Stenhousemuir,Cove Rangers,3,2,1,W
94808,19,SCO4,2019-10-26,Elgin City,Queens Park,3,1,2,W
94809,19,SCO4,2019-10-29,Cove Rangers,Albion Rovers,3,0,3,W
94810,19,SCO4,2019-10-29,Edinburgh City,Stenhousemuir,4,0,4,W
94811,19,SCO4,2019-10-29,Stirling Albion,Cowdenbeath,0,0,0,D
94812,19,SCO4,2019-11-02,Brechin City,Edinburgh City,2,3,-1,L
94813,19,SCO4,2019-11-02,Cowdenbeath,Cove Rangers,1,3,-2,L
94814,19,SCO4,2019-11-02,Elgin City,Annan Athletic,4,0,4,W
94815,19,SCO4,2019-11-02,Stenhousemuir,Queens Park,0,3,-3,L
94816,19,SCO4,2019-11-02,Stirling Albion,Albion Rovers,3,0,3,W
94817,19,SCO4,2019-11-09,Albion Rovers,Stenhousemuir,2,1,1,W
94818,19,SCO4,2019-11-09,Annan Athletic,Cowdenbeath,1,0,1,W
94819,19,SCO4,2019-11-09,Cove Rangers,Stirling Albion,1,0,1,W
94820,19,SCO4,2019-11-09,Edinburgh City,Elgin City,1,1,0,D
94821,19,SCO4,2019-11-09,Queens Park,Brechin City,5,2,3,W
94822,19,SCO4,2019-11-12,Annan Athletic,Brechin City,5,2,3,W
94823,19,SCO4,2019-11-16,Cove Rangers,Brechin City,3,0,3,W
94824,19,SCO4,2019-11-16,Cowdenbeath,Queens Park,1,0,1,W
94825,19,SCO4,2019-11-16,Edinburgh City,Albion Rovers,3,2,1,W
94826,19,SCO4,2019-11-16,Stirling Albion,Annan Athletic,2,0,2,W
94827,19,SCO4,2019-11-30,Annan Athletic,Cove Rangers,6,1,5,W
94828,19,SCO4,2019-11-30,Brechin City,Stenhousemuir,1,2,-1,L
94829,19,SCO4,2019-11-30,Elgin City,Stirling Albion,1,2,-1,L
94830,19,SCO4,2019-11-30,Queens Park,Edinburgh City,2,1,1,W
94831,19,SCO4,2019-12-03,Stenhousemuir,Elgin City,2,2,0,D
94832,19,SCO4,2019-12-07,Albion Rovers,Queens Park,2,0,2,W
94833,19,SCO4,2019-12-07,Cowdenbeath,Elgin City,0,0,0,D
94834,19,SCO4,2019-12-07,Edinburgh City,Cove Rangers,2,1,1,W
94835,19,SCO4,2019-12-07,Stenhousemuir,Annan Athletic,1,2,-1,L
94836,19,SCO4,2019-12-07,Stirling Albion,Brechin City,2,4,-2,L
94837,19,SCO4,2019-12-14,Annan Athletic,Edinburgh City,0,2,-2,L
94838,19,SCO4,2019-12-14,Brechin City,Cowdenbeath,2,1,1,W
94839,19,SCO4,2019-12-14,Cove Rangers,Stenhousemuir,2,1,1,W
94840,19,SCO4,2019-12-14,Elgin City,Albion Rovers,2,2,0,D
94841,19,SCO4,2019-12-14,Queens Park,Stirling Albion,1,1,0,D
94842,19,SCO4,2019-12-21,Albion Rovers,Annan Athletic,4,2,2,W
94843,19,SCO4,2019-12-21,Cowdenbeath,Stenhousemuir,3,1,2,W
94844,19,SCO4,2019-12-21,Elgin City,Brechin City,3,1,2,W
94845,19,SCO4,2019-12-21,Queens Park,Cove Rangers,1,3,-2,L
94846,19,SCO4,2019-12-21,Stirling Albion,Edinburgh City,0,1,-1,L
94847,19,SCO4,2019-12-28,Annan Athletic,Queens Park,3,2,1,W
94848,19,SCO4,2019-12-28,Brechin City,Albion Rovers,0,0,0,D
94849,19,SCO4,2019-12-28,Cove Rangers,Elgin City,2,0,2,W
94850,19,SCO4,2019-12-28,Edinburgh City,Cowdenbeath,2,0,2,W
94851,19,SCO4,2019-12-28,Stenhousemuir,Stirling Albion,0,2,-2,L
94852,19,SCO4,2020-01-04,Albion Rovers,Stirling Albion,0,3,-3,L
94853,19,SCO4,2020-01-04,Brechin City,Cove Rangers,1,5,-4,L
94854,19,SCO4,2020-01-04,Cowdenbeath,Annan Athletic,3,1,2,W
94855,19,SCO4,2020-01-04,Elgin City,Edinburgh City,0,1,-1,L
94856,19,SCO4,2020-01-04,Queens Park,Stenhousemuir,2,1,1,W
94857,19,SCO4,2020-01-11,Annan Athletic,Elgin City,0,4,-4,L
94858,19,SCO4,2020-01-11,Edinburgh City,Queens Park,1,2,-1,L
94859,19,SCO4,2020-01-11,Stenhousemuir,Brechin City,2,2,0,D
94860,19,SCO4,2020-01-18,Annan Athletic,Stirling Albion,2,3,-1,L
94861,19,SCO4,2020-01-18,Cove Rangers,Cowdenbeath,3,1,2,W
94862,19,SCO4,2020-01-18,Elgin City,Stenhousemuir,2,3,-1,L
94863,19,SCO4,2020-01-25,Cove Rangers,Annan Athletic,2,0,2,W
94864,19,SCO4,2020-01-25,Cowdenbeath,Brechin City,3,2,1,W
94865,19,SCO4,2020-01-25,Queens Park,Albion Rovers,2,2,0,D
94866,19,SCO4,2020-01-25,Stenhousemuir,Edinburgh City,1,2,-1,L
94867,19,SCO4,2020-01-25,Stirling Albion,Elgin City,1,2,-1,L
94868,19,SCO4,2020-02-01,Albion Rovers,Cove Rangers,2,2,0,D
94869,19,SCO4,2020-02-01,Annan Athletic,Stenhousemuir,0,3,-3,L
94870,19,SCO4,2020-02-01,Brechin City,Elgin City,1,2,-1,L
94871,19,SCO4,2020-02-01,Edinburgh City,Stirling Albion,0,1,-1,L
94872,19,SCO4,2020-02-01,Queens Park,Cowdenbeath,1,0,1,W
94873,19,SCO4,2020-02-08,Albion Rovers,Brechin City,4,1,3,W
94874,19,SCO4,2020-02-08,Edinburgh City,Annan Athletic,3,0,3,W
94875,19,SCO4,2020-02-08,Elgin City,Cove Rangers,3,0,3,W
94876,19,SCO4,2020-02-08,Stenhousemuir,Cowdenbeath,2,2,0,D
94877,19,SCO4,2020-02-08,Stirling Albion,Queens Park,1,3,-2,L
94878,19,SCO4,2020-02-15,Cove Rangers,Edinburgh City,2,1,1,W
94879,19,SCO4,2020-02-15,Cowdenbeath,Stirling Albion,1,4,-3,L
94880,19,SCO4,2020-02-15,Queens Park,Elgin City,2,0,2,W
94881,19,SCO4,2020-02-15,Stenhousemuir,Albion Rovers,1,0,1,W
94882,19,SCO4,2020-02-22,Annan Athletic,Albion Rovers,2,1,1,W
94883,19,SCO4,2020-02-22,Cove Rangers,Queens Park,2,0,2,W
94884,19,SCO4,2020-02-22,Edinburgh City,Brechin City,0,0,0,D
94885,19,SCO4,2020-02-26,Brechin City,Queens Park,0,0,0,D
94886,19,SCO4,2020-02-29,Albion Rovers,Elgin City,1,2,-1,L
94887,19,SCO4,2020-02-29,Brechin City,Stirling Albion,0,2,-2,L
94888,19,SCO4,2020-02-29,Cowdenbeath,Edinburgh City,1,1,0,D
94889,19,SCO4,2020-02-29,Queens Park,Annan Athletic,2,0,2,W
94890,19,SCO4,2020-02-29,Stenhousemuir,Cove Rangers,0,3,-3,L
94891,19,SCO4,2020-03-03,Cowdenbeath,Albion Rovers,2,1,1,W
94892,19,SCO4,2020-03-03,Stirling Albion,Stenhousemuir,0,0,0,D
94893,19,SCO4,2020-03-07,Annan Athletic,Cowdenbeath,0,0,0,D
94894,19,SCO4,2020-03-07,Cove Rangers,Brechin City,3,2,1,W
94895,19,SCO4,2020-03-07,Edinburgh City,Albion Rovers,3,0,3,W
94896,19,SCO4,2020-03-07,Elgin City,Stirling Albion,3,1,2,W
94897,19,SCO4,2020-03-07,Stenhousemuir,Queens Park,0,0,0,D
94898,19,SCO4,2020-03-10,Stirling Albion,Cove Rangers,1,7,-6,L
94899,19,SCO4,2020-03-10,Elgin City,Cowdenbeath,3,2,1,W
94900,20,SCO4,2020-10-17,Albion Rovers,Stenhousemuir,1,3,-2,L
94901,20,SCO4,2020-10-17,Brechin City,Edinburgh City,1,5,-4,L
94902,20,SCO4,2020-10-17,Cowdenbeath,Annan Athletic,0,3,-3,L
94903,20,SCO4,2020-10-17,Stirling Albion,Queens Park,0,0,0,D
94904,20,SCO4,2020-10-17,Stranraer,Elgin City,1,4,-3,L
94905,20,SCO4,2020-10-24,Annan Athletic,Stranraer,1,1,0,D
94906,20,SCO4,2020-10-24,Edinburgh City,Cowdenbeath,0,1,-1,L
94907,20,SCO4,2020-10-24,Elgin City,Brechin City,3,0,3,W
94908,20,SCO4,2020-10-24,Queens Park,Albion Rovers,2,0,2,W
94909,20,SCO4,2020-10-24,Stenhousemuir,Stirling Albion,2,2,0,D
94910,20,SCO4,2020-10-31,Albion Rovers,Brechin City,0,2,-2,L
94911,20,SCO4,2020-10-31,Cowdenbeath,Stenhousemuir,1,1,0,D
94912,20,SCO4,2020-10-31,Edinburgh City,Elgin City,1,0,1,W
94913,20,SCO4,2020-10-31,Stirling Albion,Annan Athletic,1,0,1,W
94914,20,SCO4,2020-10-31,Stranraer,Queens Park,0,1,-1,L
94915,20,SCO4,2020-11-07,Annan Athletic,Albion Rovers,2,3,-1,L
94916,20,SCO4,2020-11-07,Brechin City,Stirling Albion,0,5,-5,L
94917,20,SCO4,2020-11-07,Elgin City,Queens Park,0,1,-1,L
94918,20,SCO4,2020-11-07,Stenhousemuir,Edinburgh City,2,0,2,W
94919,20,SCO4,2020-11-07,Stranraer,Cowdenbeath,2,0,2,W
94920,20,SCO4,2020-11-21,Edinburgh City,Stranraer,0,1,-1,L
94921,20,SCO4,2020-11-21,Queens Park,Brechin City,3,0,3,W
94922,20,SCO4,2020-11-21,Stenhousemuir,Annan Athletic,1,2,-1,L
94923,20,SCO4,2020-11-21,Stirling Albion,Elgin City,1,2,-1,L
94924,20,SCO4,2020-11-28,Albion Rovers,Stirling Albion,0,1,-1,L
94925,20,SCO4,2020-11-28,Annan Athletic,Edinburgh City,0,4,-4,L
94926,20,SCO4,2020-11-28,Brechin City,Stranraer,1,4,-3,L
94927,20,SCO4,2020-11-28,Elgin City,Cowdenbeath,5,2,3,W
94928,20,SCO4,2020-11-28,Queens Park,Stenhousemuir,3,1,2,W
94929,20,SCO4,2020-12-05,Cowdenbeath,Queens Park,0,3,-3,L
94930,20,SCO4,2020-12-05,Edinburgh City,Albion Rovers,5,2,3,W
94931,20,SCO4,2020-12-05,Elgin City,Annan Athletic,1,0,1,W
94932,20,SCO4,2020-12-05,Stenhousemuir,Brechin City,2,1,1,W
94933,20,SCO4,2020-12-05,Stranraer,Stirling Albion,2,2,0,D
94934,20,SCO4,2020-12-12,Albion Rovers,Elgin City,3,1,2,W
94935,20,SCO4,2020-12-12,Queens Park,Edinburgh City,3,3,0,D
94936,20,SCO4,2020-12-12,Stenhousemuir,Stranraer,2,2,0,D
94937,20,SCO4,2020-12-12,Stirling Albion,Cowdenbeath,1,0,1,W
94938,20,SCO4,2020-12-19,Annan Athletic,Queens Park,1,2,-1,L
94939,20,SCO4,2020-12-19,Cowdenbeath,Brechin City,2,0,2,W
94940,20,SCO4,2020-12-19,Edinburgh City,Stirling Albion,2,3,-1,L
94941,20,SCO4,2020-12-19,Elgin City,Stenhousemuir,2,0,2,W
94942,20,SCO4,2020-12-19,Stranraer,Albion Rovers,4,0,4,W
94943,20,SCO4,2020-12-22,Brechin City,Annan Athletic,0,0,0,D
94944,20,SCO4,2021-01-02,Stranraer,Annan Athletic,2,0,2,W
94945,20,SCO4,2021-03-20,Annan Athletic,Cowdenbeath,0,0,0,D
94946,20,SCO4,2021-03-20,Elgin City,Edinburgh City,1,2,-1,L
94947,20,SCO4,2021-03-20,Queens Park,Stranraer,3,0,3,W
94948,20,SCO4,2021-03-20,Stenhousemuir,Albion Rovers,2,0,2,W
94949,20,SCO4,2021-03-20,Stirling Albion,Brechin City,1,0,1,W
94950,20,SCO4,2021-03-23,Stranraer,Brechin City,2,0,2,W
94951,20,SCO4,2021-03-23,Albion Rovers,Edinburgh City,1,2,-1,L
94952,20,SCO4,2021-03-27,Albion Rovers,Annan Athletic,1,1,0,D
94953,20,SCO4,2021-03-27,Brechin City,Queens Park,0,2,-2,L
94954,20,SCO4,2021-03-27,Cowdenbeath,Stranraer,1,1,0,D
94955,20,SCO4,2021-03-27,Edinburgh City,Stenhousemuir,3,1,2,W
94956,20,SCO4,2021-03-27,Elgin City,Stirling Albion,1,1,0,D
94957,20,SCO4,2021-03-30,Albion Rovers,Queens Park,0,3,-3,L
94958,20,SCO4,2021-03-30,Brechin City,Elgin City,1,2,-1,L
94959,20,SCO4,2021-03-30,Cowdenbeath,Edinburgh City,1,3,-2,L
94960,20,SCO4,2021-03-30,Stirling Albion,Stenhousemuir,1,0,1,W
94961,20,SCO4,2021-04-03,Cowdenbeath,Albion Rovers,0,1,-1,L
94962,20,SCO4,2021-04-03,Annan Athletic,Elgin City,0,3,-3,L
94963,20,SCO4,2021-04-03,Queens Park,Stirling Albion,1,0,1,W
94964,20,SCO4,2021-04-06,Brechin City,Stenhousemuir,1,1,0,D
94965,20,SCO4,2021-04-06,Edinburgh City,Annan Athletic,1,1,0,D
94966,20,SCO4,2021-04-06,Queens Park,Cowdenbeath,3,0,3,W
94967,20,SCO4,2021-04-06,Stirling Albion,Albion Rovers,1,1,0,D
94968,20,SCO4,2021-04-06,Elgin City,Stranraer,2,1,1,W
94969,20,SCO4,2021-04-08,Stenhousemuir,Cowdenbeath,1,0,1,W
94970,20,SCO4,2021-04-10,Annan Athletic,Stirling Albion,1,2,-1,L
94971,20,SCO4,2021-04-10,Brechin City,Albion Rovers,2,4,-2,L
94972,20,SCO4,2021-04-10,Cowdenbeath,Elgin City,1,0,1,W
94973,20,SCO4,2021-04-10,Stenhousemuir,Queens Park,1,3,-2,L
94974,20,SCO4,2021-04-10,Stranraer,Edinburgh City,0,1,-1,L
94975,20,SCO4,2021-04-13,Albion Rovers,Cowdenbeath,0,0,0,D
94976,20,SCO4,2021-04-13,Edinburgh City,Brechin City,2,1,1,W
94977,20,SCO4,2021-04-13,Queens Park,Annan Athletic,1,0,1,W
94978,20,SCO4,2021-04-13,Stenhousemuir,Elgin City,2,0,2,W
94979,20,SCO4,2021-04-13,Stirling Albion,Stranraer,0,1,-1,L
94980,20,SCO4,2021-04-15,Stranraer,Stenhousemuir,4,0,4,W
94981,20,SCO4,2021-04-17,Annan Athletic,Brechin City,3,0,3,W
94982,20,SCO4,2021-04-17,Cowdenbeath,Stirling Albion,1,5,-4,L
94983,20,SCO4,2021-04-17,Edinburgh City,Queens Park,2,3,-1,L
94984,20,SCO4,2021-04-17,Elgin City,Albion Rovers,2,5,-3,L
94985,20,SCO4,2021-04-20,Albion Rovers,Stranraer,0,2,-2,L
94986,20,SCO4,2021-04-20,Annan Athletic,Stenhousemuir,5,1,4,W
94987,20,SCO4,2021-04-20,Brechin City,Cowdenbeath,0,0,0,D
94988,20,SCO4,2021-04-20,Queens Park,Elgin City,0,0,0,D
94989,20,SCO4,2021-04-20,Stirling Albion,Edinburgh City,0,1,-1,L
94990,20,SCO4,2021-04-23,Queens Park,Stranraer,0,1,-1,L
94991,20,SCO4,2021-04-24,Edinburgh City,Stirling Albion,0,1,-1,L
94992,20,SCO4,2021-04-24,Stenhousemuir,Cowdenbeath,0,2,-2,L
94993,20,SCO4,2021-04-24,Albion Rovers,Annan Athletic,1,0,1,W
94994,20,SCO4,2021-04-27,Stirling Albion,Queens Park,1,2,-1,L
94995,20,SCO4,2021-04-27,Stranraer,Elgin City,1,4,-3,L
94996,20,SCO4,2021-04-27,Annan Athletic,Stenhousemuir,1,1,0,D
94997,20,SCO4,2021-04-27,Cowdenbeath,Brechin City,0,2,-2,L
94998,20,SCO4,2021-04-29,Queens Park,Edinburgh City,2,0,2,W
94999,20,SCO4,2021-04-29,Elgin City,Stirling Albion,3,1,2,W
95000,20,SCO4,2021-04-29,Stenhousemuir,Albion Rovers,0,1,-1,L
95001,20,SCO4,2021-04-29,Brechin City,Annan Athletic,0,3,-3,L
95002,20,SCO4,2021-05-01,Edinburgh City,Elgin City,2,0,2,W
95003,20,SCO4,2021-05-01,Stirling Albion,Stranraer,2,2,0,D
95004,20,SCO4,2021-05-01,Albion Rovers,Brechin City,1,1,0,D
95005,20,SCO4,2021-05-01,Annan Athletic,Cowdenbeath,1,1,0,D
95006,20,SCO4,2021-05-04,Stranraer,Edinburgh City,2,1,1,W
95007,20,SCO4,2021-05-04,Elgin City,Queens Park,3,2,1,W
95008,20,SCO4,2021-05-04,Cowdenbeath,Albion Rovers,2,0,2,W
95009,20,SCO4,2021-05-04,Brechin City,Stenhousemuir,0,1,-1,L
95010,21,SCO4,2021-07-31,Annan Athletic,Forfar Athletic,0,2,-2,L
95011,21,SCO4,2021-07-31,Elgin City,Stranraer,1,1,0,D
95012,21,SCO4,2021-07-31,Kelty Hearts,Cowdenbeath,2,0,2,W
95013,21,SCO4,2021-07-31,Stenhousemuir,Stirling Albion,0,1,-1,L
95014,21,SCO4,2021-07-31,Albion Rovers,Edinburgh City,2,0,2,W
95015,21,SCO4,2021-08-07,Albion Rovers,Stenhousemuir,2,2,0,D
95016,21,SCO4,2021-08-07,Cowdenbeath,Elgin City,3,1,2,W
95017,21,SCO4,2021-08-07,Forfar Athletic,Edinburgh City,2,0,2,W
95018,21,SCO4,2021-08-07,Stirling Albion,Kelty Hearts,1,3,-2,L
95019,21,SCO4,2021-08-07,Stranraer,Annan Athletic,0,3,-3,L
95020,21,SCO4,2021-08-13,Edinburgh City,Stenhousemuir,1,0,1,W
95021,21,SCO4,2021-08-14,Annan Athletic,Stirling Albion,3,1,2,W
95022,21,SCO4,2021-08-14,Elgin City,Albion Rovers,3,0,3,W
95023,21,SCO4,2021-08-14,Forfar Athletic,Kelty Hearts,2,2,0,D
95024,21,SCO4,2021-08-21,Albion Rovers,Annan Athletic,0,1,-1,L
95025,21,SCO4,2021-08-21,Elgin City,Forfar Athletic,1,1,0,D
95026,21,SCO4,2021-08-21,Kelty Hearts,Edinburgh City,1,0,1,W
95027,21,SCO4,2021-08-21,Stenhousemuir,Cowdenbeath,1,1,0,D
95028,21,SCO4,2021-08-21,Stranraer,Stirling Albion,0,3,-3,L
95029,21,SCO4,2021-08-27,Edinburgh City,Elgin City,2,0,2,W
95030,21,SCO4,2021-08-28,Cowdenbeath,Annan Athletic,1,3,-2,L
95031,21,SCO4,2021-08-28,Forfar Athletic,Stranraer,1,1,0,D
95032,21,SCO4,2021-08-28,Stenhousemuir,Kelty Hearts,1,4,-3,L
95033,21,SCO4,2021-08-28,Stirling Albion,Albion Rovers,2,1,1,W
95034,21,SCO4,2021-08-31,Cowdenbeath,Stranraer,1,2,-1,L
95035,21,SCO4,2021-09-11,Albion Rovers,Cowdenbeath,2,1,1,W
95036,21,SCO4,2021-09-11,Annan Athletic,Stenhousemuir,1,2,-1,L
95037,21,SCO4,2021-09-11,Kelty Hearts,Elgin City,1,1,0,D
95038,21,SCO4,2021-09-11,Stirling Albion,Forfar Athletic,1,0,1,W
95039,21,SCO4,2021-09-11,Stranraer,Edinburgh City,0,1,-1,L
95040,21,SCO4,2021-09-17,Edinburgh City,Stirling Albion,2,2,0,D
95041,21,SCO4,2021-09-18,Albion Rovers,Kelty Hearts,0,3,-3,L
95042,21,SCO4,2021-09-18,Cowdenbeath,Forfar Athletic,1,1,0,D
95043,21,SCO4,2021-09-18,Elgin City,Annan Athletic,0,2,-2,L
95044,21,SCO4,2021-09-18,Stranraer,Stenhousemuir,2,0,2,W
95045,21,SCO4,2021-09-25,Annan Athletic,Edinburgh City,1,3,-2,L
95046,21,SCO4,2021-09-25,Forfar Athletic,Albion Rovers,3,1,2,W
95047,21,SCO4,2021-09-25,Kelty Hearts,Stranraer,1,0,1,W
95048,21,SCO4,2021-09-25,Stenhousemuir,Elgin City,1,2,-1,L
95049,21,SCO4,2021-09-25,Stirling Albion,Cowdenbeath,4,0,4,W
95050,21,SCO4,2021-10-01,Edinburgh City,Cowdenbeath,1,1,0,D
95051,21,SCO4,2021-10-02,Elgin City,Stirling Albion,0,2,-2,L
95052,21,SCO4,2021-10-02,Kelty Hearts,Annan Athletic,2,1,1,W
95053,21,SCO4,2021-10-02,Stenhousemuir,Forfar Athletic,1,1,0,D
95054,21,SCO4,2021-10-02,Stranraer,Albion Rovers,1,0,1,W
95055,21,SCO4,2021-10-15,Edinburgh City,Kelty Hearts,2,3,-1,L
95056,21,SCO4,2021-10-16,Albion Rovers,Elgin City,2,0,2,W
95057,21,SCO4,2021-10-16,Cowdenbeath,Stenhousemuir,0,2,-2,L
95058,21,SCO4,2021-10-16,Forfar Athletic,Annan Athletic,2,0,2,W
95059,21,SCO4,2021-10-16,Stirling Albion,Stranraer,1,1,0,D
95060,21,SCO4,2021-10-30,Annan Athletic,Cowdenbeath,1,0,1,W
95061,21,SCO4,2021-10-30,Kelty Hearts,Stirling Albion,1,1,0,D
95062,21,SCO4,2021-10-30,Stranraer,Forfar Athletic,2,3,-1,L
95063,21,SCO4,2021-11-05,Edinburgh City,Albion Rovers,0,4,-4,L
95064,21,SCO4,2021-11-06,Annan Athletic,Stranraer,2,2,0,D
95065,21,SCO4,2021-11-06,Cowdenbeath,Kelty Hearts,0,1,-1,L
95066,21,SCO4,2021-11-06,Forfar Athletic,Elgin City,2,1,1,W
95067,21,SCO4,2021-11-06,Stirling Albion,Stenhousemuir,1,3,-2,L
95068,21,SCO4,2021-11-09,Stenhousemuir,Albion Rovers,3,1,2,W
95069,21,SCO4,2021-11-12,Edinburgh City,Stranraer,3,1,2,W
95070,21,SCO4,2021-11-13,Albion Rovers,Stirling Albion,1,0,1,W
95071,21,SCO4,2021-11-13,Elgin City,Cowdenbeath,1,0,1,W
95072,21,SCO4,2021-11-13,Kelty Hearts,Forfar Athletic,1,0,1,W
95073,21,SCO4,2021-11-13,Stenhousemuir,Annan Athletic,2,0,2,W
95074,21,SCO4,2021-11-20,Annan Athletic,Albion Rovers,1,1,0,D
95075,21,SCO4,2021-11-20,Forfar Athletic,Cowdenbeath,3,0,3,W
95076,21,SCO4,2021-11-20,Kelty Hearts,Stenhousemuir,2,0,2,W
95077,21,SCO4,2021-11-20,Stirling Albion,Edinburgh City,1,2,-1,L
95078,21,SCO4,2021-11-20,Stranraer,Elgin City,1,0,1,W
95079,21,SCO4,2021-11-23,Elgin City,Edinburgh City,1,1,0,D
95080,21,SCO4,2021-12-03,Edinburgh City,Annan Athletic,0,1,-1,L
95081,21,SCO4,2021-12-04,Albion Rovers,Forfar Athletic,2,3,-1,L
95082,21,SCO4,2021-12-04,Cowdenbeath,Stirling Albion,1,0,1,W
95083,21,SCO4,2021-12-04,Stenhousemuir,Stranraer,1,4,-3,L
95084,21,SCO4,2021-12-11,Annan Athletic,Elgin City,4,1,3,W
95085,21,SCO4,2021-12-11,Forfar Athletic,Stirling Albion,2,0,2,W
95086,21,SCO4,2021-12-11,Kelty Hearts,Albion Rovers,6,1,5,W
95087,21,SCO4,2021-12-11,Stenhousemuir,Edinburgh City,2,2,0,D
95088,21,SCO4,2021-12-11,Stranraer,Cowdenbeath,2,0,2,W
95089,21,SCO4,2021-12-17,Edinburgh City,Forfar Athletic,0,4,-4,L
95090,21,SCO4,2021-12-18,Cowdenbeath,Albion Rovers,0,0,0,D
95091,21,SCO4,2021-12-18,Elgin City,Stenhousemuir,2,2,0,D
95092,21,SCO4,2021-12-18,Stirling Albion,Annan Athletic,2,3,-1,L
95093,21,SCO4,2021-12-18,Stranraer,Kelty Hearts,0,4,-4,L
95094,21,SCO4,2021-12-21,Stirling Albion,Elgin City,0,1,-1,L
95095,21,SCO4,2021-12-22,Cowdenbeath,Edinburgh City,1,2,-1,L
95096,21,SCO4,2021-12-26,Annan Athletic,Kelty Hearts,5,1,4,W
95097,21,SCO4,2021-12-26,Albion Rovers,Stranraer,3,2,1,W
95098,21,SCO4,2021-12-26,Forfar Athletic,Stenhousemuir,3,4,-1,L
95099,21,SCO4,2022-01-02,Elgin City,Forfar Athletic,1,0,1,W
95100,21,SCO4,2022-01-02,Stenhousemuir,Stirling Albion,1,2,-1,L
95101,21,SCO4,2022-01-02,Stranraer,Annan Athletic,1,1,0,D
95102,21,SCO4,2022-01-07,Edinburgh City,Elgin City,2,2,0,D
95103,21,SCO4,2022-01-08,Stirling Albion,Kelty Hearts,0,3,-3,L
95104,21,SCO4,2022-01-08,Albion Rovers,Stenhousemuir,1,2,-1,L
95105,21,SCO4,2022-01-08,Cowdenbeath,Annan Athletic,1,3,-2,L
95106,21,SCO4,2022-01-08,Forfar Athletic,Stranraer,3,2,1,W
95107,21,SCO4,2022-01-15,Annan Athletic,Forfar Athletic,2,2,0,D
95108,21,SCO4,2022-01-15,Elgin City,Albion Rovers,1,1,0,D
95109,21,SCO4,2022-01-15,Kelty Hearts,Edinburgh City,2,2,0,D
95110,21,SCO4,2022-01-15,Stenhousemuir,Cowdenbeath,0,2,-2,L
95111,21,SCO4,2022-01-15,Stranraer,Stirling Albion,3,3,0,D
95112,21,SCO4,2022-01-22,Cowdenbeath,Stranraer,0,1,-1,L
95113,21,SCO4,2022-01-25,Elgin City,Kelty Hearts,2,0,2,W
95114,21,SCO4,2022-01-29,Albion Rovers,Cowdenbeath,0,1,-1,L
95115,21,SCO4,2022-01-29,Annan Athletic,Stirling Albion,0,0,0,D
95116,21,SCO4,2022-01-29,Kelty Hearts,Stranraer,3,2,1,W
95117,21,SCO4,2022-01-29,Stenhousemuir,Elgin City,2,1,1,W
95118,21,SCO4,2022-01-31,Forfar Athletic,Edinburgh City,2,3,-1,L
95119,21,SCO4,2022-02-05,Annan Athletic,Stenhousemuir,0,2,-2,L
95120,21,SCO4,2022-02-05,Forfar Athletic,Albion Rovers,2,0,2,W
95121,21,SCO4,2022-02-05,Kelty Hearts,Elgin City,4,0,4,W
95122,21,SCO4,2022-02-05,Stranraer,Edinburgh City,0,2,-2,L
95123,21,SCO4,2022-02-11,Edinburgh City,Stirling Albion,1,0,1,W
95124,21,SCO4,2022-02-12,Elgin City,Stranraer,1,2,-1,L
95125,21,SCO4,2022-02-15,Edinburgh City,Albion Rovers,1,2,-1,L
95126,21,SCO4,2022-02-15,Elgin City,Annan Athletic,0,2,-2,L
95127,21,SCO4,2022-02-15,Stirling Albion,Forfar Athletic,1,1,0,D
95128,21,SCO4,2022-02-19,Annan Athletic,Edinburgh City,2,1,1,W
95129,21,SCO4,2022-02-19,Cowdenbeath,Elgin City,2,0,2,W
95130,21,SCO4,2022-02-19,Forfar Athletic,Kelty Hearts,1,0,1,W
95131,21,SCO4,2022-02-19,Stranraer,Stenhousemuir,1,1,0,D
95132,21,SCO4,2022-02-22,Kelty Hearts,Cowdenbeath,1,0,1,W
95133,21,SCO4,2022-02-25,Edinburgh City,Cowdenbeath,1,0,1,W
95134,21,SCO4,2022-02-26,Elgin City,Stirling Albion,3,1,2,W
95135,21,SCO4,2022-02-26,Kelty Hearts,Annan Athletic,3,1,2,W
95136,21,SCO4,2022-02-26,Stenhousemuir,Forfar Athletic,2,0,2,W
95137,21,SCO4,2022-02-26,Stranraer,Albion Rovers,0,0,0,D
95138,21,SCO4,2022-03-02,Edinburgh City,Stenhousemuir,1,1,0,D
95139,21,SCO4,2022-03-02,Albion Rovers,Annan Athletic,1,4,-3,L
95140,21,SCO4,2022-03-05,Albion Rovers,Edinburgh City,0,1,-1,L
95141,21,SCO4,2022-03-05,Annan Athletic,Stranraer,4,1,3,W
95142,21,SCO4,2022-03-05,Cowdenbeath,Kelty Hearts,0,1,-1,L
95143,21,SCO4,2022-03-05,Forfar Athletic,Elgin City,0,0,0,D
95144,21,SCO4,2022-03-05,Stirling Albion,Stenhousemuir,0,1,-1,L
95145,21,SCO4,2022-03-08,Stirling Albion,Cowdenbeath,2,1,1,W
95146,21,SCO4,2022-03-08,Stenhousemuir,Kelty Hearts,0,1,-1,L
95147,21,SCO4,2022-03-12,Annan Athletic,Elgin City,2,1,1,W
95148,21,SCO4,2022-03-12,Forfar Athletic,Stirling Albion,0,1,-1,L
95149,21,SCO4,2022-03-12,Kelty Hearts,Albion Rovers,3,1,2,W
95150,21,SCO4,2022-03-12,Stenhousemuir,Edinburgh City,0,0,0,D
95151,21,SCO4,2022-03-12,Stranraer,Cowdenbeath,3,0,3,W
95152,21,SCO4,2022-03-15,Cowdenbeath,Forfar Athletic,1,2,-1,L
95153,21,SCO4,2022-03-16,Albion Rovers,Kelty Hearts,0,0,0,D
95154,21,SCO4,2022-03-18,Edinburgh City,Stranraer,1,2,-1,L
95155,21,SCO4,2022-03-19,Albion Rovers,Forfar Athletic,0,0,0,D
95156,21,SCO4,2022-03-19,Cowdenbeath,Stenhousemuir,1,1,0,D
95157,21,SCO4,2022-03-19,Elgin City,Kelty Hearts,0,0,0,D
95158,21,SCO4,2022-03-19,Stirling Albion,Annan Athletic,0,3,-3,L
95159,21,SCO4,2022-03-22,Stirling Albion,Albion Rovers,0,1,-1,L
95160,21,SCO4,2022-03-26,Annan Athletic,Albion Rovers,2,4,-2,L
95161,21,SCO4,2022-03-26,Elgin City,Edinburgh City,2,0,2,W
95162,21,SCO4,2022-03-26,Forfar Athletic,Cowdenbeath,1,1,0,D
95163,21,SCO4,2022-03-26,Kelty Hearts,Stenhousemuir,1,0,1,W
95164,21,SCO4,2022-03-26,Stirling Albion,Stranraer,1,0,1,W
95165,21,SCO4,2022-04-01,Edinburgh City,Kelty Hearts,1,1,0,D
95166,21,SCO4,2022-04-02,Albion Rovers,Elgin City,0,0,0,D
95167,21,SCO4,2022-04-02,Cowdenbeath,Stirling Albion,0,0,0,D
95168,21,SCO4,2022-04-02,Stenhousemuir,Annan Athletic,0,1,-1,L
95169,21,SCO4,2022-04-02,Stranraer,Forfar Athletic,0,2,-2,L
95170,21,SCO4,2022-04-09,Edinburgh City,Forfar Athletic,2,0,2,W
95171,21,SCO4,2022-04-09,Albion Rovers,Stranraer,0,5,-5,L
95172,21,SCO4,2022-04-09,Annan Athletic,Cowdenbeath,2,3,-1,L
95173,21,SCO4,2022-04-09,Elgin City,Stenhousemuir,0,2,-2,L
95174,21,SCO4,2022-04-09,Kelty Hearts,Stirling Albion,1,1,0,D
95175,21,SCO4,2022-04-16,Cowdenbeath,Edinburgh City,0,0,0,D
95176,21,SCO4,2022-04-16,Forfar Athletic,Annan Athletic,5,1,4,W
95177,21,SCO4,2022-04-16,Stenhousemuir,Albion Rovers,4,1,3,W
95178,21,SCO4,2022-04-16,Stirling Albion,Elgin City,0,2,-2,L
95179,21,SCO4,2022-04-16,Stranraer,Kelty Hearts,0,3,-3,L
95180,21,SCO4,2022-04-22,Edinburgh City,Annan Athletic,2,1,1,W
95181,21,SCO4,2022-04-23,Albion Rovers,Stirling Albion,1,1,0,D
95182,21,SCO4,2022-04-23,Elgin City,Cowdenbeath,1,4,-3,L
95183,21,SCO4,2022-04-23,Kelty Hearts,Forfar Athletic,1,1,0,D
95184,21,SCO4,2022-04-23,Stenhousemuir,Stranraer,1,3,-2,L
95185,21,SCO4,2022-04-30,Annan Athletic,Kelty Hearts,1,2,-1,L
95186,21,SCO4,2022-04-30,Cowdenbeath,Albion Rovers,0,1,-1,L
95187,21,SCO4,2022-04-30,Forfar Athletic,Stenhousemuir,0,0,0,D
95188,21,SCO4,2022-04-30,Stirling Albion,Edinburgh City,5,0,5,W
95189,21,SCO4,2022-04-30,Stranraer,Elgin City,2,0,2,W
95190,22,SCO4,2022-07-30,Bonnyrigg Rose,Forfar Athletic,2,0,2,W
95191,22,SCO4,2022-07-30,Dumbarton,Stirling Albion,2,0,2,W
95192,22,SCO4,2022-07-30,Elgin City,East Fife,1,3,-2,L
95193,22,SCO4,2022-07-30,Stenhousemuir,Albion Rovers,1,0,1,W
95194,22,SCO4,2022-07-30,Stranraer,Annan Athletic,1,0,1,W
95195,22,SCO4,2022-08-06,Albion Rovers,Dumbarton,1,2,-1,L
95196,22,SCO4,2022-08-06,Annan Athletic,Stenhousemuir,2,1,1,W
95197,22,SCO4,2022-08-06,East Fife,Bonnyrigg Rose,0,3,-3,L
95198,22,SCO4,2022-08-06,Forfar Athletic,Stranraer,2,0,2,W
95199,22,SCO4,2022-08-06,Stirling Albion,Elgin City,2,2,0,D
95200,22,SCO4,2022-08-13,Albion Rovers,East Fife,0,1,-1,L
95201,22,SCO4,2022-08-13,Dumbarton,Annan Athletic,4,0,4,W
95202,22,SCO4,2022-08-13,Forfar Athletic,Elgin City,2,2,0,D
95203,22,SCO4,2022-08-13,Stirling Albion,Stenhousemuir,3,0,3,W
95204,22,SCO4,2022-08-13,Stranraer,Bonnyrigg Rose,2,2,0,D
95205,22,SCO4,2022-08-20,Annan Athletic,Stirling Albion,1,2,-1,L
95206,22,SCO4,2022-08-20,Bonnyrigg Rose,Albion Rovers,0,2,-2,L
95207,22,SCO4,2022-08-20,East Fife,Forfar Athletic,1,0,1,W
95208,22,SCO4,2022-08-20,Elgin City,Stranraer,2,2,0,D
95209,22,SCO4,2022-08-20,Stenhousemuir,Dumbarton,1,3,-2,L
95210,22,SCO4,2022-08-27,Albion Rovers,Annan Athletic,2,2,0,D
95211,22,SCO4,2022-08-27,Bonnyrigg Rose,Stirling Albion,1,0,1,W
95212,22,SCO4,2022-08-27,Dumbarton,Elgin City,2,1,1,W
95213,22,SCO4,2022-08-27,Forfar Athletic,Stenhousemuir,1,2,-1,L
95214,22,SCO4,2022-08-27,Stranraer,East Fife,2,2,0,D
95215,22,SCO4,2022-09-03,Annan Athletic,Forfar Athletic,2,1,1,W
95216,22,SCO4,2022-09-03,East Fife,Dumbarton,0,1,-1,L
95217,22,SCO4,2022-09-03,Elgin City,Bonnyrigg Rose,2,0,2,W
95218,22,SCO4,2022-09-03,Stenhousemuir,Stranraer,3,1,2,W
95219,22,SCO4,2022-09-03,Stirling Albion,Albion Rovers,1,1,0,D
95220,22,SCO4,2022-09-17,Albion Rovers,Forfar Athletic,0,2,-2,L
95221,22,SCO4,2022-09-17,Annan Athletic,East Fife,2,2,0,D
95222,22,SCO4,2022-09-17,Dumbarton,Bonnyrigg Rose,1,0,1,W
95223,22,SCO4,2022-09-17,Stenhousemuir,Elgin City,3,3,0,D
95224,22,SCO4,2022-09-17,Stirling Albion,Stranraer,4,1,3,W
95225,22,SCO4,2022-09-20,East Fife,Stenhousemuir,1,2,-1,L
95226,22,SCO4,2022-09-20,Stranraer,Dumbarton,3,2,1,W
95227,22,SCO4,2022-09-24,Forfar Athletic,Stirling Albion,1,4,-3,L
95228,22,SCO4,2022-10-01,Bonnyrigg Rose,Stenhousemuir,2,4,-2,L
95229,22,SCO4,2022-10-01,East Fife,Stirling Albion,1,2,-1,L
95230,22,SCO4,2022-10-01,Elgin City,Annan Athletic,5,1,4,W
95231,22,SCO4,2022-10-01,Forfar Athletic,Dumbarton,0,0,0,D
95232,22,SCO4,2022-10-01,Stranraer,Albion Rovers,2,1,1,W
95233,22,SCO4,2022-10-08,Albion Rovers,Bonnyrigg Rose,2,1,1,W
95234,22,SCO4,2022-10-08,Forfar Athletic,East Fife,1,3,-2,L
95235,22,SCO4,2022-10-08,Stenhousemuir,Annan Athletic,2,2,0,D
95236,22,SCO4,2022-10-08,Stirling Albion,Dumbarton,6,0,6,W
95237,22,SCO4,2022-10-08,Stranraer,Elgin City,2,3,-1,L
95238,22,SCO4,2022-10-11,Bonnyrigg Rose,Annan Athletic,2,0,2,W
95239,22,SCO4,2022-10-11,Elgin City,Albion Rovers,1,0,1,W
95240,22,SCO4,2022-10-15,Annan Athletic,Stranraer,1,1,0,D
95241,22,SCO4,2022-10-15,Bonnyrigg Rose,East Fife,1,4,-3,L
95242,22,SCO4,2022-10-15,Dumbarton,Albion Rovers,1,1,0,D
95243,22,SCO4,2022-10-15,Elgin City,Forfar Athletic,0,1,-1,L
95244,22,SCO4,2022-10-15,Stenhousemuir,Stirling Albion,1,3,-2,L
95245,22,SCO4,2022-10-29,Albion Rovers,Stenhousemuir,2,2,0,D
95246,22,SCO4,2022-10-29,Annan Athletic,Dumbarton,0,1,-1,L
95247,22,SCO4,2022-10-29,East Fife,Elgin City,2,1,1,W
95248,22,SCO4,2022-10-29,Stirling Albion,Bonnyrigg Rose,2,1,1,W
95249,22,SCO4,2022-10-29,Stranraer,Forfar Athletic,1,0,1,W
95250,22,SCO4,2022-11-05,Albion Rovers,Stirling Albion,1,1,0,D
95251,22,SCO4,2022-11-05,Bonnyrigg Rose,Elgin City,2,3,-1,L
95252,22,SCO4,2022-11-05,Dumbarton,Stranraer,2,0,2,W
95253,22,SCO4,2022-11-05,Forfar Athletic,Annan Athletic,1,4,-3,L
95254,22,SCO4,2022-11-05,Stenhousemuir,East Fife,2,2,0,D
95255,22,SCO4,2022-11-12,East Fife,Albion Rovers,2,3,-1,L
95256,22,SCO4,2022-11-12,Elgin City,Dumbarton,0,4,-4,L
95257,22,SCO4,2022-11-12,Forfar Athletic,Bonnyrigg Rose,1,1,0,D
95258,22,SCO4,2022-11-12,Stirling Albion,Annan Athletic,0,2,-2,L
95259,22,SCO4,2022-11-12,Stranraer,Stenhousemuir,3,2,1,W
95260,22,SCO4,2022-11-19,Albion Rovers,Stranraer,1,0,1,W
95261,22,SCO4,2022-11-19,Annan Athletic,Elgin City,1,3,-2,L
95262,22,SCO4,2022-11-19,Dumbarton,Forfar Athletic,2,2,0,D
95263,22,SCO4,2022-11-19,Stenhousemuir,Bonnyrigg Rose,1,1,0,D
95264,22,SCO4,2022-11-19,Stirling Albion,East Fife,3,1,2,W
95265,22,SCO4,2022-11-26,Stranraer,Annan Athletic,1,1,0,D
95266,22,SCO4,2022-12-03,Bonnyrigg Rose,Dumbarton,1,1,0,D
95267,22,SCO4,2022-12-03,East Fife,Annan Athletic,1,3,-2,L
95268,22,SCO4,2022-12-03,Elgin City,Stenhousemuir,2,1,1,W
95269,22,SCO4,2022-12-03,Forfar Athletic,Albion Rovers,1,0,1,W
95270,22,SCO4,2022-12-03,Stranraer,Stirling Albion,3,1,2,W
95271,22,SCO4,2022-12-10,Stenhousemuir,Forfar Athletic,1,2,-1,L
95272,22,SCO4,2022-12-10,East Fife,Bonnyrigg Rose,0,0,0,D
95273,22,SCO4,2022-12-23,Annan Athletic,Albion Rovers,5,1,4,W
95274,22,SCO4,2022-12-23,Bonnyrigg Rose,Stranraer,3,2,1,W
95275,22,SCO4,2022-12-23,Elgin City,Stirling Albion,1,2,-1,L
95276,22,SCO4,2022-12-24,Dumbarton,East Fife,2,0,2,W
95277,22,SCO4,2022-12-31,Albion Rovers,Dumbarton,0,1,-1,L
95278,22,SCO4,2022-12-31,Stirling Albion,Stenhousemuir,3,1,2,W
95279,22,SCO4,2023-01-02,Forfar Athletic,Elgin City,0,1,-1,L
95280,22,SCO4,2023-01-07,Annan Athletic,Forfar Athletic,0,2,-2,L
95281,22,SCO4,2023-01-07,Bonnyrigg Rose,Albion Rovers,0,4,-4,L
95282,22,SCO4,2023-01-07,Elgin City,East Fife,1,2,-1,L
95283,22,SCO4,2023-01-07,Stenhousemuir,Stranraer,2,1,1,W
95284,22,SCO4,2023-01-14,East Fife,Stenhousemuir,1,1,0,D
95285,22,SCO4,2023-01-14,Elgin City,Annan Athletic,1,1,0,D
95286,22,SCO4,2023-01-14,Forfar Athletic,Dumbarton,2,1,1,W
95287,22,SCO4,2023-01-14,Stranraer,Albion Rovers,0,4,-4,L
95288,22,SCO4,2023-01-21,Annan Athletic,Bonnyrigg Rose,4,0,4,W
95289,22,SCO4,2023-01-21,East Fife,Stranraer,1,3,-2,L
95290,22,SCO4,2023-01-28,Albion Rovers,Forfar Athletic,0,1,-1,L
95291,22,SCO4,2023-01-28,Annan Athletic,East Fife,3,0,3,W
95292,22,SCO4,2023-01-28,Dumbarton,Bonnyrigg Rose,1,0,1,W
95293,22,SCO4,2023-01-28,Stenhousemuir,Elgin City,2,0,2,W
95294,22,SCO4,2023-01-28,Stirling Albion,Stranraer,1,0,1,W
95295,22,SCO4,2023-02-04,Bonnyrigg Rose,Annan Athletic,1,2,-1,L
95296,22,SCO4,2023-02-04,East Fife,Stirling Albion,1,1,0,D
95297,22,SCO4,2023-02-04,Elgin City,Albion Rovers,1,1,0,D
95298,22,SCO4,2023-02-04,Forfar Athletic,Stranraer,2,1,1,W
95299,22,SCO4,2023-02-04,Stenhousemuir,Dumbarton,1,1,0,D
95300,22,SCO4,2023-02-11,Albion Rovers,East Fife,0,1,-1,L
95301,22,SCO4,2023-02-11,Dumbarton,Annan Athletic,2,1,1,W
95302,22,SCO4,2023-02-11,Forfar Athletic,Stenhousemuir,1,1,0,D
95303,22,SCO4,2023-02-11,Stranraer,Bonnyrigg Rose,0,1,-1,L
95304,22,SCO4,2023-02-14,Bonnyrigg Rose,Stirling Albion,1,2,-1,L
95305,22,SCO4,2023-02-18,Annan Athletic,Stirling Albion,2,2,0,D
95306,22,SCO4,2023-02-18,East Fife,Dumbarton,2,0,2,W
95307,22,SCO4,2023-02-18,Elgin City,Stranraer,0,1,-1,L
95308,22,SCO4,2023-02-18,Stenhousemuir,Albion Rovers,2,0,2,W
95309,22,SCO4,2023-02-21,Albion Rovers,Elgin City,3,0,3,W
95310,22,SCO4,2023-02-25,Albion Rovers,Annan Athletic,0,2,-2,L
95311,22,SCO4,2023-02-25,Bonnyrigg Rose,Stenhousemuir,0,1,-1,L
95312,22,SCO4,2023-02-25,Dumbarton,Elgin City,1,2,-1,L
95313,22,SCO4,2023-02-25,Forfar Athletic,Stirling Albion,0,0,0,D
95314,22,SCO4,2023-02-25,Stranraer,East Fife,2,0,2,W
95315,22,SCO4,2023-02-28,Dumbarton,Stenhousemuir,1,0,1,W
95316,22,SCO4,2023-02-28,Bonnyrigg Rose,Forfar Athletic,1,1,0,D
95317,22,SCO4,2023-03-04,Annan Athletic,Stenhousemuir,2,3,-1,L
95318,22,SCO4,2023-03-04,East Fife,Forfar Athletic,3,2,1,W
95319,22,SCO4,2023-03-04,Elgin City,Bonnyrigg Rose,0,1,-1,L
95320,22,SCO4,2023-03-04,Stirling Albion,Albion Rovers,3,2,1,W
95321,22,SCO4,2023-03-04,Stranraer,Dumbarton,0,2,-2,L
95322,22,SCO4,2023-03-11,Annan Athletic,Elgin City,4,1,3,W
95323,22,SCO4,2023-03-11,Stenhousemuir,East Fife,1,2,-1,L
95324,22,SCO4,2023-03-11,Stirling Albion,Bonnyrigg Rose,2,1,1,W
95325,22,SCO4,2023-03-18,Bonnyrigg Rose,East Fife,1,1,0,D
95326,22,SCO4,2023-03-18,Dumbarton,Albion Rovers,1,5,-4,L
95327,22,SCO4,2023-03-18,Forfar Athletic,Annan Athletic,2,1,1,W
95328,22,SCO4,2023-03-18,Stranraer,Stirling Albion,1,1,0,D
95329,22,SCO4,2023-03-21,Stirling Albion,Forfar Athletic,2,0,2,W
95330,22,SCO4,2023-03-21,Albion Rovers,Stranraer,0,1,-1,L
95331,22,SCO4,2023-03-24,East Fife,Elgin City,2,0,2,W
95332,22,SCO4,2023-03-25,Albion Rovers,Bonnyrigg Rose,0,1,-1,L
95333,22,SCO4,2023-03-25,Annan Athletic,Stranraer,0,0,0,D
95334,22,SCO4,2023-03-25,Stenhousemuir,Forfar Athletic,1,1,0,D
95335,22,SCO4,2023-03-25,Stirling Albion,Dumbarton,2,2,0,D
95336,22,SCO4,2023-03-29,Dumbarton,Forfar Athletic,0,1,-1,L
95337,22,SCO4,2023-04-01,Bonnyrigg Rose,Stranraer,1,0,1,W
95338,22,SCO4,2023-04-01,Dumbarton,Stenhousemuir,1,2,-1,L
95339,22,SCO4,2023-04-01,East Fife,Annan Athletic,0,1,-1,L
95340,22,SCO4,2023-04-01,Elgin City,Stirling Albion,0,3,-3,L
95341,22,SCO4,2023-04-01,Forfar Athletic,Albion Rovers,2,1,1,W
