,Sea,Lge,Date,HT,AT,HS,AS,GD,WDL
71483,0,HOL1,2000-08-18,Sparta Rotterdam,Roda,2,2,0,D
71484,0,HOL1,2000-08-19,De Graafschap,PSV Eindhoven,2,0,2,W
71485,0,HOL1,2000-08-19,Feyenoord Rotterdam,AZ Alkmaar,2,0,2,W
71486,0,HOL1,2000-08-19,NAC Breda,Waalwijk,0,1,-1,L
71487,0,HOL1,2000-08-20,Groningen,Willem II,1,1,0,D
71488,0,HOL1,2000-08-20,Roosendaal,NEC Nijmegen,2,3,-1,L
71489,0,HOL1,2000-08-20,Utrecht,Heerenveen,2,0,2,W
71490,0,HOL1,2000-08-20,Vitesse,Twente Enschede,3,1,2,W
71491,0,HOL1,2000-08-22,Ajax Amsterdam,For Sittard,5,0,5,W
71492,0,HOL1,2000-08-23,Groningen,NEC Nijmegen,4,4,0,D
71493,0,HOL1,2000-08-26,AZ Alkmaar,Roosendaal,3,0,3,W
71494,0,HOL1,2000-08-26,De Graafschap,Roda,1,3,-2,L
71495,0,HOL1,2000-08-26,For Sittard,Heerenveen,0,2,-2,L
71496,0,HOL1,2000-08-26,NAC Breda,Groningen,5,1,4,W
71497,0,HOL1,2000-08-26,Willem II,Waalwijk,2,0,2,W
71498,0,HOL1,2000-08-27,NEC Nijmegen,Vitesse,4,1,3,W
71499,0,HOL1,2000-08-27,Sparta Rotterdam,Ajax Amsterdam,3,0,3,W
71500,0,HOL1,2000-08-27,Twente Enschede,Feyenoord Rotterdam,1,2,-1,L
71501,0,HOL1,2000-08-27,Utrecht,PSV Eindhoven,1,3,-2,L
71502,0,HOL1,2000-09-03,Waalwijk,Roosendaal,2,1,1,W
71503,0,HOL1,2000-09-05,PSV Eindhoven,Willem II,2,2,0,D
71504,0,HOL1,2000-09-06,Ajax Amsterdam,NEC Nijmegen,0,0,0,D
71505,0,HOL1,2000-09-06,Groningen,De Graafschap,1,0,1,W
71506,0,HOL1,2000-09-06,NAC Breda,Roda,1,1,0,D
71507,0,HOL1,2000-09-06,Waalwijk,AZ Alkmaar,3,0,3,W
71508,0,HOL1,2000-09-06,Twente Enschede,Heerenveen,2,2,0,D
71509,0,HOL1,2000-09-06,Vitesse,Sparta Rotterdam,5,1,4,W
71510,0,HOL1,2000-09-08,For Sittard,PSV Eindhoven,0,3,-3,L
71511,0,HOL1,2000-09-09,Ajax Amsterdam,Groningen,3,1,2,W
71512,0,HOL1,2000-09-09,De Graafschap,AZ Alkmaar,4,2,2,W
71513,0,HOL1,2000-09-09,Feyenoord Rotterdam,Waalwijk,3,1,2,W
71514,0,HOL1,2000-09-09,Heerenveen,NAC Breda,2,1,1,W
71515,0,HOL1,2000-09-09,Roda,Twente Enschede,2,2,0,D
71516,0,HOL1,2000-09-09,Willem II,Vitesse,2,2,0,D
71517,0,HOL1,2000-09-10,NEC Nijmegen,Utrecht,1,1,0,D
71518,0,HOL1,2000-09-10,Sparta Rotterdam,Roosendaal,3,5,-2,L
71519,0,HOL1,2000-09-13,NAC Breda,Roosendaal,2,1,1,W
71520,0,HOL1,2000-09-16,NAC Breda,De Graafschap,3,0,3,W
71521,0,HOL1,2000-09-16,PSV Eindhoven,Sparta Rotterdam,2,1,1,W
71522,0,HOL1,2000-09-17,AZ Alkmaar,Ajax Amsterdam,3,2,1,W
71523,0,HOL1,2000-09-17,NEC Nijmegen,For Sittard,1,1,0,D
71524,0,HOL1,2000-09-17,Roosendaal,Groningen,0,2,-2,L
71525,0,HOL1,2000-09-17,Utrecht,Twente Enschede,1,2,-1,L
71526,0,HOL1,2000-09-17,Vitesse,Waalwijk,1,0,1,W
71527,0,HOL1,2000-09-22,Ajax Amsterdam,Roosendaal,2,0,2,W
71528,0,HOL1,2000-09-23,For Sittard,Vitesse,1,4,-3,L
71529,0,HOL1,2000-09-24,Groningen,Utrecht,1,3,-2,L
71530,0,HOL1,2000-09-24,NAC Breda,Willem II,2,0,2,W
71531,0,HOL1,2000-09-24,Waalwijk,NEC Nijmegen,0,0,0,D
71532,0,HOL1,2000-09-24,Twente Enschede,De Graafschap,3,1,2,W
71533,0,HOL1,2000-10-01,De Graafschap,Feyenoord Rotterdam,2,3,-1,L
71534,0,HOL1,2000-10-01,Groningen,PSV Eindhoven,0,1,-1,L
71535,0,HOL1,2000-10-01,Waalwijk,Twente Enschede,1,1,0,D
71536,0,HOL1,2000-10-01,Roda,AZ Alkmaar,4,2,2,W
71537,0,HOL1,2000-10-01,Sparta Rotterdam,Willem II,1,2,-1,L
71538,0,HOL1,2000-10-01,Vitesse,Utrecht,2,1,1,W
71539,0,HOL1,2000-10-02,Heerenveen,Ajax Amsterdam,2,2,0,D
71540,0,HOL1,2000-10-13,AZ Alkmaar,NAC Breda,3,1,2,W
71541,0,HOL1,2000-10-14,Heerenveen,Waalwijk,1,1,0,D
71542,0,HOL1,2000-10-14,PSV Eindhoven,NEC Nijmegen,0,0,0,D
71543,0,HOL1,2000-10-14,Roda,Groningen,2,0,2,W
71544,0,HOL1,2000-10-14,Twente Enschede,For Sittard,1,1,0,D
71545,0,HOL1,2000-10-14,Willem II,Utrecht,6,2,4,W
71546,0,HOL1,2000-10-15,Roosendaal,De Graafschap,2,4,-2,L
71547,0,HOL1,2000-10-15,Sparta Rotterdam,Feyenoord Rotterdam,1,4,-3,L
71548,0,HOL1,2000-10-15,Vitesse,Ajax Amsterdam,3,2,1,W
71549,0,HOL1,2000-10-20,Ajax Amsterdam,Roda,4,2,2,W
71550,0,HOL1,2000-10-21,De Graafschap,Willem II,1,1,0,D
71551,0,HOL1,2000-10-21,Feyenoord Rotterdam,Heerenveen,2,0,2,W
71552,0,HOL1,2000-10-21,Twente Enschede,Sparta Rotterdam,3,1,2,W
71553,0,HOL1,2000-10-22,AZ Alkmaar,Vitesse,0,2,-2,L
71554,0,HOL1,2000-10-22,Groningen,For Sittard,4,0,4,W
71555,0,HOL1,2000-10-22,Utrecht,Roosendaal,5,3,2,W
71556,0,HOL1,2000-10-27,AZ Alkmaar,Twente Enschede,5,0,5,W
71557,0,HOL1,2000-10-27,For Sittard,NAC Breda,1,2,-1,L
71558,0,HOL1,2000-10-28,Heerenveen,De Graafschap,1,0,1,W
71559,0,HOL1,2000-10-29,NEC Nijmegen,Willem II,3,0,3,W
71560,0,HOL1,2000-10-29,PSV Eindhoven,Ajax Amsterdam,1,1,0,D
71561,0,HOL1,2000-10-29,Roda,Waalwijk,0,1,-1,L
71562,0,HOL1,2000-10-29,Sparta Rotterdam,Groningen,2,0,2,W
71563,0,HOL1,2000-10-29,Utrecht,Feyenoord Rotterdam,1,1,0,D
71564,0,HOL1,2000-11-01,Heerenveen,Sparta Rotterdam,1,1,0,D
71565,0,HOL1,2000-11-01,NEC Nijmegen,De Graafschap,2,1,1,W
71566,0,HOL1,2000-11-01,PSV Eindhoven,Vitesse,2,0,2,W
71567,0,HOL1,2000-11-01,Waalwijk,Utrecht,4,1,3,W
71568,0,HOL1,2000-11-01,Roda,For Sittard,1,0,1,W
71569,0,HOL1,2000-11-02,Feyenoord Rotterdam,Roosendaal,5,1,4,W
71570,0,HOL1,2000-11-04,NAC Breda,NEC Nijmegen,2,2,0,D
71571,0,HOL1,2000-11-04,Twente Enschede,PSV Eindhoven,0,2,-2,L
71572,0,HOL1,2000-11-05,De Graafschap,Vitesse,1,2,-1,L
71573,0,HOL1,2000-11-05,Feyenoord Rotterdam,Roda,4,2,2,W
71574,0,HOL1,2000-11-05,Groningen,AZ Alkmaar,1,2,-1,L
71575,0,HOL1,2000-11-05,Roosendaal,For Sittard,3,1,2,W
71576,0,HOL1,2000-11-05,Utrecht,Sparta Rotterdam,1,1,0,D
71577,0,HOL1,2000-11-05,Willem II,Ajax Amsterdam,0,1,-1,L
71578,0,HOL1,2000-11-10,Roosendaal,Willem II,2,1,1,W
71579,0,HOL1,2000-11-11,For Sittard,Waalwijk,0,0,0,D
71580,0,HOL1,2000-11-12,Ajax Amsterdam,De Graafschap,4,1,3,W
71581,0,HOL1,2000-11-12,AZ Alkmaar,Utrecht,2,1,1,W
71582,0,HOL1,2000-11-12,PSV Eindhoven,Feyenoord Rotterdam,1,0,1,W
71583,0,HOL1,2000-11-12,Roda,Heerenveen,3,1,2,W
71584,0,HOL1,2000-11-12,Sparta Rotterdam,NEC Nijmegen,0,2,-2,L
71585,0,HOL1,2000-11-12,Twente Enschede,NAC Breda,4,0,4,W
71586,0,HOL1,2000-11-12,Vitesse,Groningen,2,2,0,D
71587,0,HOL1,2000-11-17,Roda,Utrecht,2,1,1,W
71588,0,HOL1,2000-11-18,For Sittard,AZ Alkmaar,1,1,0,D
71589,0,HOL1,2000-11-18,Heerenveen,PSV Eindhoven,1,4,-3,L
71590,0,HOL1,2000-11-18,Vitesse,Roosendaal,2,1,1,W
71591,0,HOL1,2000-11-18,Willem II,Twente Enschede,2,2,0,D
71592,0,HOL1,2000-11-19,NAC Breda,Ajax Amsterdam,0,3,-3,L
71593,0,HOL1,2000-11-19,NEC Nijmegen,Feyenoord Rotterdam,1,3,-2,L
71594,0,HOL1,2000-11-19,Waalwijk,De Graafschap,1,0,1,W
71595,0,HOL1,2000-11-25,AZ Alkmaar,Sparta Rotterdam,1,1,0,D
71596,0,HOL1,2000-11-25,De Graafschap,For Sittard,5,1,4,W
71597,0,HOL1,2000-11-25,Roosendaal,Roda,0,4,-4,L
71598,0,HOL1,2000-11-26,Feyenoord Rotterdam,Willem II,1,0,1,W
71599,0,HOL1,2000-11-26,NEC Nijmegen,Heerenveen,0,0,0,D
71600,0,HOL1,2000-11-26,PSV Eindhoven,NAC Breda,2,1,1,W
71601,0,HOL1,2000-11-26,Twente Enschede,Groningen,3,0,3,W
71602,0,HOL1,2000-11-26,Utrecht,Ajax Amsterdam,2,1,1,W
71603,0,HOL1,2000-11-28,Roda,Vitesse,2,3,-1,L
71604,0,HOL1,2000-11-29,Feyenoord Rotterdam,Sparta Rotterdam,2,1,1,W
71605,0,HOL1,2000-11-29,Heerenveen,AZ Alkmaar,1,1,0,D
71606,0,HOL1,2000-11-29,Roosendaal,NAC Breda,0,1,-1,L
71607,0,HOL1,2000-11-30,Ajax Amsterdam,Waalwijk,3,0,3,W
71608,0,HOL1,2000-12-01,Roda,PSV Eindhoven,1,2,-1,L
71609,0,HOL1,2000-12-02,For Sittard,Utrecht,0,1,-1,L
71610,0,HOL1,2000-12-02,Sparta Rotterdam,De Graafschap,2,1,1,W
71611,0,HOL1,2000-12-02,Willem II,AZ Alkmaar,1,1,0,D
71612,0,HOL1,2000-12-03,Ajax Amsterdam,Heerenveen,6,2,4,W
71613,0,HOL1,2000-12-03,NEC Nijmegen,Twente Enschede,1,0,1,W
71614,0,HOL1,2000-12-03,Waalwijk,Groningen,0,0,0,D
71615,0,HOL1,2000-12-09,AZ Alkmaar,NEC Nijmegen,0,0,0,D
71616,0,HOL1,2000-12-09,De Graafschap,Groningen,0,4,-4,L
71617,0,HOL1,2000-12-09,For Sittard,Sparta Rotterdam,2,1,1,W
71618,0,HOL1,2000-12-09,Roda,Willem II,0,1,-1,L
71619,0,HOL1,2000-12-10,Feyenoord Rotterdam,Ajax Amsterdam,3,1,2,W
71620,0,HOL1,2000-12-10,Utrecht,NAC Breda,5,0,5,W
71621,0,HOL1,2000-12-10,Vitesse,Heerenveen,0,0,0,D
71622,0,HOL1,2000-12-12,Waalwijk,PSV Eindhoven,1,1,0,D
71623,0,HOL1,2000-12-12,Twente Enschede,Roda,0,2,-2,L
71624,0,HOL1,2000-12-13,For Sittard,Feyenoord Rotterdam,2,4,-2,L
71625,0,HOL1,2000-12-13,Heerenveen,Willem II,0,1,-1,L
71626,0,HOL1,2000-12-13,Sparta Rotterdam,NAC Breda,1,2,-1,L
71627,0,HOL1,2000-12-13,Vitesse,AZ Alkmaar,3,2,1,W
71628,0,HOL1,2000-12-16,NAC Breda,Vitesse,1,1,0,D
71629,0,HOL1,2000-12-16,Willem II,For Sittard,3,1,2,W
71630,0,HOL1,2000-12-17,Ajax Amsterdam,Twente Enschede,5,1,4,W
71631,0,HOL1,2000-12-17,AZ Alkmaar,PSV Eindhoven,0,5,-5,L
71632,0,HOL1,2000-12-17,De Graafschap,Utrecht,0,3,-3,L
71633,0,HOL1,2000-12-17,Groningen,Feyenoord Rotterdam,1,0,1,W
71634,0,HOL1,2000-12-17,NEC Nijmegen,Roda,0,2,-2,L
71635,0,HOL1,2000-12-17,Roosendaal,Heerenveen,0,3,-3,L
71636,0,HOL1,2000-12-17,Waalwijk,Sparta Rotterdam,2,0,2,W
71637,0,HOL1,2000-12-20,Feyenoord Rotterdam,Vitesse,2,0,2,W
71638,0,HOL1,2000-12-20,Utrecht,Waalwijk,2,1,1,W
71639,0,HOL1,2000-12-20,Willem II,NEC Nijmegen,2,0,2,W
71640,0,HOL1,2000-12-21,Groningen,Heerenveen,2,1,1,W
71641,0,HOL1,2000-12-21,PSV Eindhoven,For Sittard,1,1,0,D
71642,0,HOL1,2000-12-21,Roosendaal,Twente Enschede,2,2,0,D
71643,0,HOL1,2001-01-27,PSV Eindhoven,Roosendaal,6,0,6,W
71644,0,HOL1,2001-01-28,Feyenoord Rotterdam,NAC Breda,2,0,2,W
71645,0,HOL1,2001-01-31,For Sittard,Roda,1,0,1,W
71646,0,HOL1,2001-01-31,Heerenveen,Feyenoord Rotterdam,1,0,1,W
71647,0,HOL1,2001-01-31,NEC Nijmegen,Roosendaal,2,3,-1,L
71648,0,HOL1,2001-01-31,PSV Eindhoven,Groningen,3,0,3,W
71649,0,HOL1,2001-01-31,Vitesse,NAC Breda,2,4,-2,L
71650,0,HOL1,2001-01-31,Willem II,Sparta Rotterdam,4,1,3,W
71651,0,HOL1,2001-02-01,De Graafschap,Ajax Amsterdam,1,3,-2,L
71652,0,HOL1,2001-02-03,Roosendaal,Waalwijk,0,3,-3,L
71653,0,HOL1,2001-02-03,Twente Enschede,Willem II,3,1,2,W
71654,0,HOL1,2001-02-04,AZ Alkmaar,Feyenoord Rotterdam,0,3,-3,L
71655,0,HOL1,2001-02-04,For Sittard,De Graafschap,0,0,0,D
71656,0,HOL1,2001-02-04,Sparta Rotterdam,PSV Eindhoven,0,1,-1,L
71657,0,HOL1,2001-02-04,Vitesse,NEC Nijmegen,2,2,0,D
71658,0,HOL1,2001-02-09,De Graafschap,Sparta Rotterdam,2,1,1,W
71659,0,HOL1,2001-02-10,PSV Eindhoven,AZ Alkmaar,3,0,3,W
71660,0,HOL1,2001-02-11,Ajax Amsterdam,Willem II,1,1,0,D
71661,0,HOL1,2001-02-11,Feyenoord Rotterdam,Groningen,1,0,1,W
71662,0,HOL1,2001-02-11,Waalwijk,Vitesse,3,0,3,W
71663,0,HOL1,2001-02-11,Roda,Roosendaal,2,1,1,W
71664,0,HOL1,2001-02-11,Utrecht,NEC Nijmegen,1,1,0,D
71665,0,HOL1,2001-02-16,For Sittard,Ajax Amsterdam,0,3,-3,L
71666,0,HOL1,2001-02-17,Heerenveen,Roda,0,0,0,D
71667,0,HOL1,2001-02-17,Roosendaal,AZ Alkmaar,2,3,-1,L
71668,0,HOL1,2001-02-18,Groningen,Twente Enschede,2,0,2,W
71669,0,HOL1,2001-02-18,NAC Breda,PSV Eindhoven,1,2,-1,L
71670,0,HOL1,2001-02-18,Sparta Rotterdam,Waalwijk,2,2,0,D
71671,0,HOL1,2001-02-18,Utrecht,De Graafschap,3,1,2,W
71672,0,HOL1,2001-02-21,NAC Breda,Twente Enschede,0,0,0,D
71673,0,HOL1,2001-02-23,NEC Nijmegen,Sparta Rotterdam,0,3,-3,L
71674,0,HOL1,2001-02-23,Willem II,Heerenveen,1,6,-5,L
71675,0,HOL1,2001-02-24,AZ Alkmaar,Roda,2,4,-2,L
71676,0,HOL1,2001-02-24,Waalwijk,For Sittard,1,0,1,W
71677,0,HOL1,2001-02-24,Twente Enschede,Vitesse,2,1,1,W
71678,0,HOL1,2001-02-25,Ajax Amsterdam,Utrecht,2,0,2,W
71679,0,HOL1,2001-02-25,Feyenoord Rotterdam,PSV Eindhoven,1,2,-1,L
71680,0,HOL1,2001-02-25,Groningen,NAC Breda,0,0,0,D
71681,0,HOL1,2001-03-02,Heerenveen,Groningen,0,0,0,D
71682,0,HOL1,2001-03-02,Waalwijk,NAC Breda,0,0,0,D
71683,0,HOL1,2001-03-03,PSV Eindhoven,Roda,0,0,0,D
71684,0,HOL1,2001-03-03,Willem II,De Graafschap,6,0,6,W
71685,0,HOL1,2001-03-04,NEC Nijmegen,AZ Alkmaar,1,1,0,D
71686,0,HOL1,2001-03-04,Roosendaal,Ajax Amsterdam,1,3,-2,L
71687,0,HOL1,2001-03-04,Sparta Rotterdam,Twente Enschede,5,1,4,W
71688,0,HOL1,2001-03-04,Utrecht,For Sittard,1,0,1,W
71689,0,HOL1,2001-03-04,Vitesse,Feyenoord Rotterdam,0,0,0,D
71690,0,HOL1,2001-03-09,De Graafschap,Heerenveen,0,1,-1,L
71691,0,HOL1,2001-03-09,Roda,NAC Breda,1,0,1,W
71692,0,HOL1,2001-03-10,AZ Alkmaar,Waalwijk,1,3,-2,L
71693,0,HOL1,2001-03-10,For Sittard,Roosendaal,2,1,1,W
71694,0,HOL1,2001-03-10,Twente Enschede,NEC Nijmegen,1,1,0,D
71695,0,HOL1,2001-03-11,Groningen,Ajax Amsterdam,3,3,0,D
71696,0,HOL1,2001-03-11,Utrecht,Vitesse,0,0,0,D
71697,0,HOL1,2001-03-11,Willem II,Feyenoord Rotterdam,3,1,2,W
71698,0,HOL1,2001-03-16,Roosendaal,Vitesse,0,3,-3,L
71699,0,HOL1,2001-03-17,AZ Alkmaar,For Sittard,0,2,-2,L
71700,0,HOL1,2001-03-17,NAC Breda,Heerenveen,2,2,0,D
71701,0,HOL1,2001-03-17,Roda,De Graafschap,3,1,2,W
71702,0,HOL1,2001-03-18,Ajax Amsterdam,Sparta Rotterdam,9,0,9,W
71703,0,HOL1,2001-03-18,Feyenoord Rotterdam,Twente Enschede,5,1,4,W
71704,0,HOL1,2001-03-18,NEC Nijmegen,Groningen,1,0,1,W
71705,0,HOL1,2001-03-18,PSV Eindhoven,Utrecht,5,1,4,W
71706,0,HOL1,2001-03-18,Waalwijk,Willem II,3,2,1,W
71707,0,HOL1,2001-03-31,AZ Alkmaar,De Graafschap,0,1,-1,L
71708,0,HOL1,2001-03-31,Heerenveen,Roosendaal,2,0,2,W
71709,0,HOL1,2001-03-31,NAC Breda,For Sittard,1,0,1,W
71710,0,HOL1,2001-03-31,PSV Eindhoven,Twente Enschede,2,1,1,W
71711,0,HOL1,2001-03-31,Willem II,Roda,1,1,0,D
71712,0,HOL1,2001-04-01,Groningen,Vitesse,0,1,-1,L
71713,0,HOL1,2001-04-01,NEC Nijmegen,Ajax Amsterdam,1,0,1,W
71714,0,HOL1,2001-04-01,Waalwijk,Feyenoord Rotterdam,2,0,2,W
71715,0,HOL1,2001-04-01,Sparta Rotterdam,Utrecht,0,1,-1,L
71716,0,HOL1,2001-04-06,Utrecht,AZ Alkmaar,1,0,1,W
71717,0,HOL1,2001-04-07,De Graafschap,Roosendaal,2,2,0,D
71718,0,HOL1,2001-04-07,Heerenveen,NEC Nijmegen,5,0,5,W
71719,0,HOL1,2001-04-07,Twente Enschede,Waalwijk,1,1,0,D
71720,0,HOL1,2001-04-07,Vitesse,Willem II,1,2,-1,L
71721,0,HOL1,2001-04-08,Ajax Amsterdam,PSV Eindhoven,0,1,-1,L
71722,0,HOL1,2001-04-08,Groningen,Roda,1,3,-2,L
71723,0,HOL1,2001-04-08,NAC Breda,Feyenoord Rotterdam,1,0,1,W
71724,0,HOL1,2001-04-08,Sparta Rotterdam,For Sittard,0,2,-2,L
71725,0,HOL1,2001-04-13,For Sittard,NEC Nijmegen,2,0,2,W
71726,0,HOL1,2001-04-14,AZ Alkmaar,Groningen,2,0,2,W
71727,0,HOL1,2001-04-14,Roosendaal,Sparta Rotterdam,1,3,-2,L
71728,0,HOL1,2001-04-14,Waalwijk,Heerenveen,1,1,0,D
71729,0,HOL1,2001-04-15,Feyenoord Rotterdam,De Graafschap,1,2,-1,L
71730,0,HOL1,2001-04-15,Vitesse,PSV Eindhoven,0,0,0,D
71731,0,HOL1,2001-04-16,Roda,Ajax Amsterdam,1,1,0,D
71732,0,HOL1,2001-04-16,Twente Enschede,Utrecht,0,0,0,D
71733,0,HOL1,2001-04-16,Willem II,NAC Breda,1,3,-2,L
71734,0,HOL1,2001-04-20,PSV Eindhoven,Waalwijk,3,1,2,W
71735,0,HOL1,2001-04-20,Utrecht,Willem II,1,0,1,W
71736,0,HOL1,2001-04-21,De Graafschap,Twente Enschede,4,0,4,W
71737,0,HOL1,2001-04-21,Feyenoord Rotterdam,NEC Nijmegen,3,0,3,W
71738,0,HOL1,2001-04-21,Groningen,Roosendaal,2,0,2,W
71739,0,HOL1,2001-04-21,Heerenveen,For Sittard,6,1,5,W
71740,0,HOL1,2001-04-21,NAC Breda,AZ Alkmaar,0,0,0,D
71741,0,HOL1,2001-04-21,Roda,Sparta Rotterdam,1,0,1,W
71742,0,HOL1,2001-04-27,Ajax Amsterdam,NAC Breda,1,0,1,W
71743,0,HOL1,2001-04-28,For Sittard,Groningen,1,1,0,D
71744,0,HOL1,2001-04-28,Sparta Rotterdam,Heerenveen,1,3,-2,L
71745,0,HOL1,2001-04-28,Twente Enschede,AZ Alkmaar,1,0,1,W
71746,0,HOL1,2001-04-28,Vitesse,De Graafschap,2,1,1,W
71747,0,HOL1,2001-04-28,Willem II,PSV Eindhoven,1,1,0,D
71748,0,HOL1,2001-04-29,NEC Nijmegen,Waalwijk,5,1,4,W
71749,0,HOL1,2001-04-29,Roosendaal,Utrecht,1,2,-1,L
71750,0,HOL1,2001-04-29,Roda,Feyenoord Rotterdam,1,0,1,W
71751,0,HOL1,2001-05-02,Heerenveen,Utrecht,1,2,-1,L
71752,0,HOL1,2001-05-03,Waalwijk,Ajax Amsterdam,2,2,0,D
71753,0,HOL1,2001-05-05,AZ Alkmaar,Willem II,2,3,-1,L
71754,0,HOL1,2001-05-05,Twente Enschede,Roosendaal,4,1,3,W
71755,0,HOL1,2001-05-05,Vitesse,Roda,1,1,0,D
71756,0,HOL1,2001-05-06,De Graafschap,NEC Nijmegen,2,1,1,W
71757,0,HOL1,2001-05-06,Feyenoord Rotterdam,For Sittard,2,3,-1,L
71758,0,HOL1,2001-05-06,Groningen,Sparta Rotterdam,1,1,0,D
71759,0,HOL1,2001-05-06,NAC Breda,Utrecht,0,0,0,D
71760,0,HOL1,2001-05-06,PSV Eindhoven,Heerenveen,3,0,3,W
71761,0,HOL1,2001-05-11,For Sittard,Twente Enschede,0,2,-2,L
71762,0,HOL1,2001-05-11,Roosendaal,PSV Eindhoven,1,2,-1,L
71763,0,HOL1,2001-05-12,De Graafschap,Waalwijk,0,1,-1,L
71764,0,HOL1,2001-05-12,Heerenveen,Vitesse,0,0,0,D
71765,0,HOL1,2001-05-12,Willem II,Groningen,3,0,3,W
71766,0,HOL1,2001-05-13,Ajax Amsterdam,Feyenoord Rotterdam,3,4,-1,L
71767,0,HOL1,2001-05-13,NEC Nijmegen,NAC Breda,0,2,-2,L
71768,0,HOL1,2001-05-13,Sparta Rotterdam,AZ Alkmaar,0,3,-3,L
71769,0,HOL1,2001-05-13,Utrecht,Roda,3,0,3,W
71770,0,HOL1,2001-05-17,Ajax Amsterdam,Vitesse,1,2,-1,L
71771,0,HOL1,2001-05-20,AZ Alkmaar,Heerenveen,2,2,0,D
71772,0,HOL1,2001-05-20,Feyenoord Rotterdam,Utrecht,2,2,0,D
71773,0,HOL1,2001-05-20,Groningen,Waalwijk,1,2,-1,L
71774,0,HOL1,2001-05-20,NAC Breda,Sparta Rotterdam,2,0,2,W
71775,0,HOL1,2001-05-20,PSV Eindhoven,De Graafschap,3,2,1,W
71776,0,HOL1,2001-05-20,Roda,NEC Nijmegen,4,1,3,W
71777,0,HOL1,2001-05-20,Twente Enschede,Ajax Amsterdam,1,3,-2,L
71778,0,HOL1,2001-05-20,Vitesse,For Sittard,3,0,3,W
71779,0,HOL1,2001-05-20,Willem II,Roosendaal,3,0,3,W
71780,0,HOL1,2001-05-27,Ajax Amsterdam,AZ Alkmaar,5,1,4,W
71781,0,HOL1,2001-05-27,Heerenveen,Twente Enschede,1,1,0,D
71782,0,HOL1,2001-05-27,NEC Nijmegen,PSV Eindhoven,2,4,-2,L
71783,0,HOL1,2001-05-27,Roosendaal,Feyenoord Rotterdam,0,1,-1,L
71784,0,HOL1,2001-05-27,Waalwijk,Roda,3,2,1,W
71785,0,HOL1,2001-05-27,Sparta Rotterdam,Vitesse,2,2,0,D
71786,0,HOL1,2001-05-27,Utrecht,Groningen,6,0,6,W
71787,0,HOL1,2001-05-31,De Graafschap,NAC Breda,1,1,0,D
71788,0,HOL1,2001-05-31,For Sittard,Willem II,4,1,3,W
71789,1,HOL1,2001-08-17,Twente Enschede,Waalwijk,1,0,1,W
71790,1,HOL1,2001-08-18,De Graafschap,AZ Alkmaar,3,0,3,W
71791,1,HOL1,2001-08-18,Den Bosch,Heerenveen,0,0,0,D
71792,1,HOL1,2001-08-18,Groningen,PSV Eindhoven,2,2,0,D
71793,1,HOL1,2001-08-18,NAC Breda,Utrecht,1,0,1,W
71794,1,HOL1,2001-08-19,Ajax Amsterdam,Roda,1,1,0,D
71795,1,HOL1,2001-08-19,Feyenoord Rotterdam,Sparta Rotterdam,5,0,5,W
71796,1,HOL1,2001-08-19,For Sittard,Vitesse,0,0,0,D
71797,1,HOL1,2001-08-19,Willem II,NEC Nijmegen,3,1,2,W
71798,1,HOL1,2001-08-21,NAC Breda,Twente Enschede,3,3,0,D
71799,1,HOL1,2001-08-22,For Sittard,De Graafschap,2,1,1,W
71800,1,HOL1,2001-08-22,Groningen,Willem II,1,0,1,W
71801,1,HOL1,2001-08-22,NEC Nijmegen,Waalwijk,1,0,1,W
71802,1,HOL1,2001-08-22,PSV Eindhoven,Den Bosch,3,2,1,W
71803,1,HOL1,2001-08-22,Roda,Feyenoord Rotterdam,0,2,-2,L
71804,1,HOL1,2001-08-22,Sparta Rotterdam,Utrecht,3,1,2,W
71805,1,HOL1,2001-08-22,Vitesse,AZ Alkmaar,1,0,1,W
71806,1,HOL1,2001-08-24,Heerenveen,NAC Breda,5,0,5,W
71807,1,HOL1,2001-08-25,AZ Alkmaar,Sparta Rotterdam,3,0,3,W
71808,1,HOL1,2001-08-25,De Graafschap,NEC Nijmegen,1,1,0,D
71809,1,HOL1,2001-08-25,Twente Enschede,Roda,3,0,3,W
71810,1,HOL1,2001-08-25,Vitesse,Utrecht,1,0,1,W
71811,1,HOL1,2001-08-25,Willem II,PSV Eindhoven,3,1,2,W
71812,1,HOL1,2001-08-26,Den Bosch,For Sittard,4,0,4,W
71813,1,HOL1,2001-08-26,Feyenoord Rotterdam,Ajax Amsterdam,1,2,-1,L
71814,1,HOL1,2001-08-26,Waalwijk,Groningen,4,0,4,W
71815,1,HOL1,2001-09-07,Heerenveen,Vitesse,1,1,0,D
71816,1,HOL1,2001-09-08,AZ Alkmaar,NAC Breda,2,1,1,W
71817,1,HOL1,2001-09-08,NEC Nijmegen,Feyenoord Rotterdam,0,3,-3,L
71818,1,HOL1,2001-09-08,PSV Eindhoven,For Sittard,3,0,3,W
71819,1,HOL1,2001-09-08,Roda,De Graafschap,0,1,-1,L
71820,1,HOL1,2001-09-08,Twente Enschede,Ajax Amsterdam,0,2,-2,L
71821,1,HOL1,2001-09-09,Sparta Rotterdam,Waalwijk,0,0,0,D
71822,1,HOL1,2001-09-09,Utrecht,Groningen,3,1,2,W
71823,1,HOL1,2001-09-09,Willem II,Den Bosch,1,1,0,D
71824,1,HOL1,2001-09-14,For Sittard,Willem II,1,2,-1,L
71825,1,HOL1,2001-09-15,Feyenoord Rotterdam,De Graafschap,2,0,2,W
71826,1,HOL1,2001-09-15,NAC Breda,PSV Eindhoven,2,0,2,W
71827,1,HOL1,2001-09-15,Vitesse,Sparta Rotterdam,1,1,0,D
71828,1,HOL1,2001-09-16,Ajax Amsterdam,AZ Alkmaar,1,0,1,W
71829,1,HOL1,2001-09-16,Den Bosch,NEC Nijmegen,2,1,1,W
71830,1,HOL1,2001-09-16,Groningen,Twente Enschede,3,0,3,W
71831,1,HOL1,2001-09-16,Waalwijk,Heerenveen,2,1,1,W
71832,1,HOL1,2001-09-16,Utrecht,Roda,4,1,3,W
71833,1,HOL1,2001-09-21,Roda,Den Bosch,4,1,3,W
71834,1,HOL1,2001-09-22,Heerenveen,PSV Eindhoven,4,1,3,W
71835,1,HOL1,2001-09-22,Waalwijk,For Sittard,1,0,1,W
71836,1,HOL1,2001-09-23,Ajax Amsterdam,Sparta Rotterdam,3,0,3,W
71837,1,HOL1,2001-09-23,AZ Alkmaar,Utrecht,1,0,1,W
71838,1,HOL1,2001-09-23,De Graafschap,Vitesse,0,2,-2,L
71839,1,HOL1,2001-09-23,NEC Nijmegen,Groningen,1,0,1,W
71840,1,HOL1,2001-09-28,De Graafschap,NAC Breda,4,2,2,W
71841,1,HOL1,2001-09-29,For Sittard,NEC Nijmegen,2,2,0,D
71842,1,HOL1,2001-09-29,PSV Eindhoven,Vitesse,0,2,-2,L
71843,1,HOL1,2001-09-29,Willem II,AZ Alkmaar,2,2,0,D
71844,1,HOL1,2001-09-30,Den Bosch,Feyenoord Rotterdam,0,0,0,D
71845,1,HOL1,2001-09-30,Groningen,Ajax Amsterdam,1,4,-3,L
71846,1,HOL1,2001-09-30,Roda,Heerenveen,0,2,-2,L
71847,1,HOL1,2001-09-30,Sparta Rotterdam,Twente Enschede,1,1,0,D
71848,1,HOL1,2001-09-30,Utrecht,Waalwijk,2,1,1,W
71849,1,HOL1,2001-10-07,Sparta Rotterdam,Den Bosch,1,1,0,D
71850,1,HOL1,2001-10-09,AZ Alkmaar,PSV Eindhoven,1,1,0,D
71851,1,HOL1,2001-10-09,NAC Breda,Roda,2,1,1,W
71852,1,HOL1,2001-10-09,Waalwijk,De Graafschap,2,0,2,W
71853,1,HOL1,2001-10-09,Twente Enschede,Willem II,0,0,0,D
71854,1,HOL1,2001-10-10,Ajax Amsterdam,NEC Nijmegen,5,0,5,W
71855,1,HOL1,2001-10-10,Heerenveen,Utrecht,1,2,-1,L
71856,1,HOL1,2001-10-12,Roda,PSV Eindhoven,0,1,-1,L
71857,1,HOL1,2001-10-13,For Sittard,Sparta Rotterdam,3,4,-1,L
71858,1,HOL1,2001-10-13,Heerenveen,AZ Alkmaar,2,1,1,W
71859,1,HOL1,2001-10-13,Waalwijk,Ajax Amsterdam,0,2,-2,L
71860,1,HOL1,2001-10-14,De Graafschap,Twente Enschede,4,2,2,W
71861,1,HOL1,2001-10-14,Feyenoord Rotterdam,Groningen,1,0,1,W
71862,1,HOL1,2001-10-14,NAC Breda,Den Bosch,0,0,0,D
71863,1,HOL1,2001-10-14,NEC Nijmegen,Vitesse,1,0,1,W
71864,1,HOL1,2001-10-14,Utrecht,Willem II,3,1,2,W
71865,1,HOL1,2001-10-17,NAC Breda,Willem II,1,1,0,D
71866,1,HOL1,2001-10-17,Vitesse,Groningen,1,0,1,W
71867,1,HOL1,2001-10-20,AZ Alkmaar,Feyenoord Rotterdam,1,3,-2,L
71868,1,HOL1,2001-10-20,PSV Eindhoven,De Graafschap,4,0,4,W
71869,1,HOL1,2001-10-20,Sparta Rotterdam,Roda,0,3,-3,L
71870,1,HOL1,2001-10-20,Vitesse,NAC Breda,1,0,1,W
71871,1,HOL1,2001-10-20,Willem II,Waalwijk,3,1,2,W
71872,1,HOL1,2001-10-21,Den Bosch,Utrecht,1,1,0,D
71873,1,HOL1,2001-10-21,Groningen,Heerenveen,1,1,0,D
71874,1,HOL1,2001-10-21,NEC Nijmegen,Twente Enschede,2,0,2,W
71875,1,HOL1,2001-10-24,Heerenveen,Ajax Amsterdam,5,1,4,W
71876,1,HOL1,2001-10-26,Roda,NEC Nijmegen,0,0,0,D
71877,1,HOL1,2001-10-27,AZ Alkmaar,For Sittard,3,0,3,W
71878,1,HOL1,2001-10-27,Heerenveen,De Graafschap,1,0,1,W
71879,1,HOL1,2001-10-27,PSV Eindhoven,Waalwijk,2,0,2,W
71880,1,HOL1,2001-10-27,Twente Enschede,Vitesse,0,0,0,D
71881,1,HOL1,2001-10-28,Ajax Amsterdam,Willem II,4,1,3,W
71882,1,HOL1,2001-10-28,Feyenoord Rotterdam,Utrecht,4,0,4,W
71883,1,HOL1,2001-10-28,Groningen,Den Bosch,2,0,2,W
71884,1,HOL1,2001-10-30,Sparta Rotterdam,NAC Breda,2,3,-1,L
71885,1,HOL1,2001-11-02,Willem II,Vitesse,1,1,0,D
71886,1,HOL1,2001-11-03,For Sittard,Heerenveen,1,0,1,W
71887,1,HOL1,2001-11-03,NEC Nijmegen,AZ Alkmaar,1,0,1,W
71888,1,HOL1,2001-11-03,Waalwijk,Den Bosch,3,3,0,D
71889,1,HOL1,2001-11-03,Sparta Rotterdam,PSV Eindhoven,2,1,1,W
71890,1,HOL1,2001-11-04,De Graafschap,Ajax Amsterdam,1,1,0,D
71891,1,HOL1,2001-11-04,NAC Breda,Feyenoord Rotterdam,2,1,1,W
71892,1,HOL1,2001-11-04,Roda,Groningen,3,1,2,W
71893,1,HOL1,2001-11-04,Utrecht,Twente Enschede,1,1,0,D
71894,1,HOL1,2001-11-16,Heerenveen,Sparta Rotterdam,3,0,3,W
71895,1,HOL1,2001-11-17,AZ Alkmaar,Waalwijk,0,1,-1,L
71896,1,HOL1,2001-11-17,Den Bosch,Twente Enschede,1,3,-2,L
71897,1,HOL1,2001-11-17,Feyenoord Rotterdam,Vitesse,3,2,1,W
71898,1,HOL1,2001-11-17,PSV Eindhoven,NEC Nijmegen,3,1,2,W
71899,1,HOL1,2001-11-17,Willem II,Roda,1,1,0,D
71900,1,HOL1,2001-11-18,Ajax Amsterdam,NAC Breda,1,3,-2,L
71901,1,HOL1,2001-11-18,Groningen,For Sittard,4,2,2,W
71902,1,HOL1,2001-11-18,Utrecht,De Graafschap,6,0,6,W
71903,1,HOL1,2001-11-23,AZ Alkmaar,Den Bosch,3,2,1,W
71904,1,HOL1,2001-11-24,De Graafschap,Sparta Rotterdam,3,0,3,W
71905,1,HOL1,2001-11-24,For Sittard,Waalwijk,1,4,-3,L
71906,1,HOL1,2001-11-24,NAC Breda,Groningen,5,0,5,W
71907,1,HOL1,2001-11-24,Twente Enschede,Heerenveen,0,0,0,D
71908,1,HOL1,2001-11-24,Vitesse,Roda,2,0,2,W
71909,1,HOL1,2001-11-25,Ajax Amsterdam,PSV Eindhoven,1,3,-2,L
71910,1,HOL1,2001-11-25,Feyenoord Rotterdam,Willem II,3,1,2,W
71911,1,HOL1,2001-11-25,NEC Nijmegen,Utrecht,0,3,-3,L
71912,1,HOL1,2001-11-27,Den Bosch,De Graafschap,3,1,2,W
71913,1,HOL1,2001-11-27,Groningen,AZ Alkmaar,0,1,-1,L
71914,1,HOL1,2001-11-28,Ajax Amsterdam,Twente Enschede,3,2,1,W
71915,1,HOL1,2001-11-28,NEC Nijmegen,NAC Breda,1,3,-2,L
71916,1,HOL1,2001-11-28,Waalwijk,Feyenoord Rotterdam,2,3,-1,L
71917,1,HOL1,2001-11-28,Roda,For Sittard,1,0,1,W
71918,1,HOL1,2001-11-28,Sparta Rotterdam,Willem II,3,2,1,W
71919,1,HOL1,2001-11-28,Utrecht,PSV Eindhoven,3,3,0,D
71920,1,HOL1,2001-11-30,De Graafschap,Groningen,1,2,-1,L
71921,1,HOL1,2001-12-01,Heerenveen,Feyenoord Rotterdam,1,0,1,W
71922,1,HOL1,2001-12-01,PSV Eindhoven,AZ Alkmaar,3,0,3,W
71923,1,HOL1,2001-12-01,Waalwijk,Roda,3,0,3,W
71924,1,HOL1,2001-12-01,Twente Enschede,For Sittard,1,1,0,D
71925,1,HOL1,2001-12-02,Sparta Rotterdam,NEC Nijmegen,0,0,0,D
71926,1,HOL1,2001-12-02,Utrecht,Vitesse,3,1,2,W
71927,1,HOL1,2001-12-02,Willem II,NAC Breda,2,2,0,D
71928,1,HOL1,2001-12-04,Ajax Amsterdam,For Sittard,4,0,4,W
71929,1,HOL1,2001-12-07,For Sittard,Den Bosch,1,3,-2,L
71930,1,HOL1,2001-12-07,Vitesse,De Graafschap,2,1,1,W
71931,1,HOL1,2001-12-08,AZ Alkmaar,Roda,1,2,-1,L
71932,1,HOL1,2001-12-08,NAC Breda,Waalwijk,0,1,-1,L
71933,1,HOL1,2001-12-08,Willem II,Heerenveen,2,2,0,D
71934,1,HOL1,2001-12-09,Feyenoord Rotterdam,NEC Nijmegen,5,0,5,W
71935,1,HOL1,2001-12-09,Groningen,Sparta Rotterdam,0,0,0,D
71936,1,HOL1,2001-12-09,PSV Eindhoven,Twente Enschede,1,0,1,W
71937,1,HOL1,2001-12-14,For Sittard,NAC Breda,2,3,-1,L
71938,1,HOL1,2001-12-15,De Graafschap,Willem II,1,1,0,D
71939,1,HOL1,2001-12-15,Den Bosch,Vitesse,4,1,3,W
71940,1,HOL1,2001-12-15,Roda,Ajax Amsterdam,1,1,0,D
71941,1,HOL1,2001-12-15,Twente Enschede,AZ Alkmaar,0,0,0,D
71942,1,HOL1,2001-12-16,Feyenoord Rotterdam,PSV Eindhoven,0,0,0,D
71943,1,HOL1,2001-12-16,Groningen,Utrecht,2,2,0,D
71944,1,HOL1,2001-12-16,NEC Nijmegen,Heerenveen,1,0,1,W
71945,1,HOL1,2001-12-16,Waalwijk,Sparta Rotterdam,1,1,0,D
71946,1,HOL1,2001-12-19,Ajax Amsterdam,Vitesse,5,1,4,W
71947,1,HOL1,2001-12-19,For Sittard,Utrecht,3,3,0,D
71948,1,HOL1,2001-12-19,Heerenveen,Den Bosch,2,0,2,W
71949,1,HOL1,2001-12-19,Twente Enschede,Feyenoord Rotterdam,3,2,1,W
71950,1,HOL1,2001-12-22,NAC Breda,Heerenveen,2,1,1,W
71951,1,HOL1,2001-12-22,PSV Eindhoven,Groningen,8,0,8,W
71952,1,HOL1,2001-12-22,Vitesse,Waalwijk,1,1,0,D
71953,1,HOL1,2001-12-22,Willem II,Twente Enschede,3,3,0,D
71954,1,HOL1,2001-12-23,NEC Nijmegen,Roda,1,0,1,W
71955,1,HOL1,2001-12-23,Utrecht,Ajax Amsterdam,3,1,2,W
71956,1,HOL1,2002-01-25,Sparta Rotterdam,Heerenveen,1,4,-3,L
71957,1,HOL1,2002-01-26,AZ Alkmaar,Groningen,3,2,1,W
71958,1,HOL1,2002-01-26,De Graafschap,For Sittard,5,0,5,W
71959,1,HOL1,2002-01-26,PSV Eindhoven,NAC Breda,3,1,2,W
71960,1,HOL1,2002-01-26,Roda,Twente Enschede,2,1,1,W
71961,1,HOL1,2002-01-27,Den Bosch,Ajax Amsterdam,0,1,-1,L
71962,1,HOL1,2002-01-27,Waalwijk,Willem II,0,1,-1,L
71963,1,HOL1,2002-01-27,Utrecht,Feyenoord Rotterdam,2,2,0,D
71964,1,HOL1,2002-01-27,Vitesse,NEC Nijmegen,2,1,1,W
71965,1,HOL1,2002-01-31,Willem II,Groningen,3,1,2,W
71966,1,HOL1,2002-02-01,NEC Nijmegen,Sparta Rotterdam,1,1,0,D
71967,1,HOL1,2002-02-02,AZ Alkmaar,Vitesse,0,0,0,D
71968,1,HOL1,2002-02-02,Den Bosch,Waalwijk,1,0,1,W
71969,1,HOL1,2002-02-02,For Sittard,PSV Eindhoven,0,1,-1,L
71970,1,HOL1,2002-02-02,Twente Enschede,De Graafschap,0,0,0,D
71971,1,HOL1,2002-02-03,Feyenoord Rotterdam,Roda,5,0,5,W
71972,1,HOL1,2002-02-03,Groningen,NAC Breda,3,0,3,W
71973,1,HOL1,2002-02-03,Utrecht,Heerenveen,0,0,0,D
71974,1,HOL1,2002-02-03,Willem II,Ajax Amsterdam,1,3,-2,L
71975,1,HOL1,2002-02-05,Waalwijk,PSV Eindhoven,2,1,1,W
71976,1,HOL1,2002-02-06,Feyenoord Rotterdam,For Sittard,1,0,1,W
71977,1,HOL1,2002-02-06,NAC Breda,Sparta Rotterdam,2,2,0,D
71978,1,HOL1,2002-02-06,Roda,Utrecht,1,0,1,W
71979,1,HOL1,2002-02-08,Twente Enschede,Den Bosch,4,0,4,W
71980,1,HOL1,2002-02-09,AZ Alkmaar,Heerenveen,0,2,-2,L
71981,1,HOL1,2002-02-09,Sparta Rotterdam,De Graafschap,1,3,-2,L
71982,1,HOL1,2002-02-09,Vitesse,For Sittard,1,1,0,D
71983,1,HOL1,2002-02-10,Ajax Amsterdam,Waalwijk,3,1,2,W
71984,1,HOL1,2002-02-10,Groningen,Feyenoord Rotterdam,0,1,-1,L
71985,1,HOL1,2002-02-10,Utrecht,NEC Nijmegen,1,4,-3,L
71986,1,HOL1,2002-02-15,Den Bosch,Sparta Rotterdam,1,1,0,D
71987,1,HOL1,2002-02-16,De Graafschap,Roda,2,1,1,W
71988,1,HOL1,2002-02-16,Heerenveen,Willem II,3,0,3,W
71989,1,HOL1,2002-02-16,NEC Nijmegen,PSV Eindhoven,0,4,-4,L
71990,1,HOL1,2002-02-17,AZ Alkmaar,Ajax Amsterdam,0,0,0,D
71991,1,HOL1,2002-02-17,Twente Enschede,NAC Breda,1,2,-1,L
71992,1,HOL1,2002-02-17,Vitesse,Feyenoord Rotterdam,2,1,1,W
71993,1,HOL1,2002-02-20,Den Bosch,Groningen,1,4,-3,L
71994,1,HOL1,2002-02-20,Sparta Rotterdam,AZ Alkmaar,0,4,-4,L
71995,1,HOL1,2002-02-23,Roda,Willem II,2,0,2,W
71996,1,HOL1,2002-02-23,Vitesse,Den Bosch,1,1,0,D
71997,1,HOL1,2002-02-24,Feyenoord Rotterdam,Twente Enschede,1,2,-1,L
71998,1,HOL1,2002-02-24,NAC Breda,Ajax Amsterdam,0,1,-1,L
71999,1,HOL1,2002-02-24,PSV Eindhoven,Utrecht,4,0,4,W
72000,1,HOL1,2002-02-24,Waalwijk,AZ Alkmaar,3,2,1,W
72001,1,HOL1,2002-02-27,For Sittard,Ajax Amsterdam,1,1,0,D
72002,1,HOL1,2002-03-01,NAC Breda,AZ Alkmaar,3,1,2,W
72003,1,HOL1,2002-03-02,De Graafschap,Den Bosch,0,1,-1,L
72004,1,HOL1,2002-03-02,Willem II,Utrecht,4,2,2,W
72005,1,HOL1,2002-03-03,Ajax Amsterdam,Feyenoord Rotterdam,1,1,0,D
72006,1,HOL1,2002-03-03,Groningen,Waalwijk,1,1,0,D
72007,1,HOL1,2002-03-03,Sparta Rotterdam,For Sittard,0,0,0,D
72008,1,HOL1,2002-03-03,Twente Enschede,NEC Nijmegen,2,0,2,W
72009,1,HOL1,2002-03-04,Roda,Vitesse,0,2,-2,L
72010,1,HOL1,2002-03-08,Utrecht,Sparta Rotterdam,4,2,2,W
72011,1,HOL1,2002-03-09,Den Bosch,NAC Breda,1,2,-1,L
72012,1,HOL1,2002-03-09,For Sittard,Groningen,0,1,-1,L
72013,1,HOL1,2002-03-09,Heerenveen,Waalwijk,2,0,2,W
72014,1,HOL1,2002-03-09,PSV Eindhoven,Roda,4,1,3,W
72015,1,HOL1,2002-03-09,Vitesse,Twente Enschede,2,0,2,W
72016,1,HOL1,2002-03-10,Ajax Amsterdam,De Graafschap,4,0,4,W
72017,1,HOL1,2002-03-10,Feyenoord Rotterdam,AZ Alkmaar,4,1,3,W
72018,1,HOL1,2002-03-10,NEC Nijmegen,Willem II,3,0,3,W
72019,1,HOL1,2002-03-13,Heerenveen,For Sittard,3,1,2,W
72020,1,HOL1,2002-03-13,NEC Nijmegen,De Graafschap,3,1,2,W
72021,1,HOL1,2002-03-15,Roda,NAC Breda,1,1,0,D
72022,1,HOL1,2002-03-16,AZ Alkmaar,De Graafschap,2,1,1,W
72023,1,HOL1,2002-03-16,Willem II,Sparta Rotterdam,4,0,4,W
72024,1,HOL1,2002-03-17,Ajax Amsterdam,Heerenveen,2,0,2,W
72025,1,HOL1,2002-03-17,Feyenoord Rotterdam,Den Bosch,3,0,3,W
72026,1,HOL1,2002-03-17,Waalwijk,NEC Nijmegen,2,1,1,W
72027,1,HOL1,2002-03-17,Twente Enschede,Groningen,0,1,-1,L
72028,1,HOL1,2002-03-17,Utrecht,For Sittard,3,0,3,W
72029,1,HOL1,2002-03-17,Vitesse,PSV Eindhoven,0,0,0,D
72030,1,HOL1,2002-03-22,For Sittard,AZ Alkmaar,0,1,-1,L
72031,1,HOL1,2002-03-23,Den Bosch,Willem II,1,2,-1,L
72032,1,HOL1,2002-03-23,Heerenveen,NEC Nijmegen,4,0,4,W
72033,1,HOL1,2002-03-23,NAC Breda,Vitesse,3,3,0,D
72034,1,HOL1,2002-03-24,De Graafschap,Utrecht,0,0,0,D
72035,1,HOL1,2002-03-24,Groningen,Roda,0,2,-2,L
72036,1,HOL1,2002-03-24,PSV Eindhoven,Ajax Amsterdam,1,1,0,D
72037,1,HOL1,2002-03-24,Waalwijk,Twente Enschede,3,1,2,W
72038,1,HOL1,2002-03-24,Sparta Rotterdam,Feyenoord Rotterdam,0,5,-5,L
72039,1,HOL1,2002-03-30,AZ Alkmaar,Twente Enschede,0,2,-2,L
72040,1,HOL1,2002-03-30,NAC Breda,De Graafschap,1,0,1,W
72041,1,HOL1,2002-03-30,NEC Nijmegen,For Sittard,3,1,2,W
72042,1,HOL1,2002-03-30,Roda,Sparta Rotterdam,3,0,3,W
72043,1,HOL1,2002-03-31,Feyenoord Rotterdam,Waalwijk,1,1,0,D
72044,1,HOL1,2002-03-31,Vitesse,Ajax Amsterdam,3,1,2,W
72045,1,HOL1,2002-04-01,PSV Eindhoven,Heerenveen,4,1,3,W
72046,1,HOL1,2002-04-01,Utrecht,Den Bosch,3,1,2,W
72047,1,HOL1,2002-04-03,Ajax Amsterdam,Groningen,4,3,1,W
72048,1,HOL1,2002-04-05,Twente Enschede,Sparta Rotterdam,2,0,2,W
72049,1,HOL1,2002-04-06,De Graafschap,Waalwijk,3,1,2,W
72050,1,HOL1,2002-04-06,Roda,AZ Alkmaar,0,0,0,D
72051,1,HOL1,2002-04-06,Vitesse,Heerenveen,0,0,0,D
72052,1,HOL1,2002-04-06,Willem II,For Sittard,3,0,3,W
72053,1,HOL1,2002-04-07,Den Bosch,PSV Eindhoven,0,1,-1,L
72054,1,HOL1,2002-04-07,Feyenoord Rotterdam,NAC Breda,0,0,0,D
72055,1,HOL1,2002-04-07,Groningen,NEC Nijmegen,2,2,0,D
72056,1,HOL1,2002-04-13,AZ Alkmaar,Willem II,2,2,0,D
72057,1,HOL1,2002-04-13,De Graafschap,Heerenveen,1,2,-1,L
72058,1,HOL1,2002-04-13,Den Bosch,Roda,3,1,2,W
72059,1,HOL1,2002-04-13,For Sittard,Twente Enschede,2,0,2,W
72060,1,HOL1,2002-04-13,NAC Breda,NEC Nijmegen,1,3,-2,L
72061,1,HOL1,2002-04-14,Groningen,Vitesse,0,1,-1,L
72062,1,HOL1,2002-04-14,PSV Eindhoven,Feyenoord Rotterdam,2,0,2,W
72063,1,HOL1,2002-04-14,Waalwijk,Utrecht,1,2,-1,L
72064,1,HOL1,2002-04-14,Sparta Rotterdam,Ajax Amsterdam,0,4,-4,L
72065,1,HOL1,2002-04-19,For Sittard,Feyenoord Rotterdam,1,2,-1,L
72066,1,HOL1,2002-04-20,Heerenveen,Roda,0,0,0,D
72067,1,HOL1,2002-04-20,Waalwijk,NAC Breda,4,1,3,W
72068,1,HOL1,2002-04-20,Sparta Rotterdam,Vitesse,0,1,-1,L
72069,1,HOL1,2002-04-20,Twente Enschede,PSV Eindhoven,1,1,0,D
72070,1,HOL1,2002-04-20,Willem II,De Graafschap,2,2,0,D
72071,1,HOL1,2002-04-21,Ajax Amsterdam,Utrecht,1,0,1,W
72072,1,HOL1,2002-04-21,NEC Nijmegen,Den Bosch,2,1,1,W
72073,1,HOL1,2002-04-24,Heerenveen,Groningen,2,0,2,W
72074,1,HOL1,2002-04-24,PSV Eindhoven,Willem II,6,0,6,W
72075,1,HOL1,2002-04-24,Utrecht,AZ Alkmaar,3,2,1,W
72076,1,HOL1,2002-04-25,De Graafschap,Feyenoord Rotterdam,1,0,1,W
72077,1,HOL1,2002-04-28,Ajax Amsterdam,Den Bosch,2,0,2,W
72078,1,HOL1,2002-04-28,AZ Alkmaar,NEC Nijmegen,5,0,5,W
72079,1,HOL1,2002-04-28,Feyenoord Rotterdam,Heerenveen,3,2,1,W
72080,1,HOL1,2002-04-28,Groningen,De Graafschap,2,0,2,W
72081,1,HOL1,2002-04-28,NAC Breda,For Sittard,3,1,2,W
72082,1,HOL1,2002-04-28,PSV Eindhoven,Sparta Rotterdam,3,0,3,W
72083,1,HOL1,2002-04-28,Roda,Waalwijk,1,0,1,W
72084,1,HOL1,2002-04-28,Twente Enschede,Utrecht,2,0,2,W
72085,1,HOL1,2002-04-28,Vitesse,Willem II,4,2,2,W
72086,1,HOL1,2002-05-05,De Graafschap,PSV Eindhoven,2,2,0,D
72087,1,HOL1,2002-05-05,Den Bosch,AZ Alkmaar,0,1,-1,L
72088,1,HOL1,2002-05-05,For Sittard,Roda,0,0,0,D
72089,1,HOL1,2002-05-05,Heerenveen,Twente Enschede,0,0,0,D
72090,1,HOL1,2002-05-05,NEC Nijmegen,Ajax Amsterdam,0,2,-2,L
72091,1,HOL1,2002-05-05,Waalwijk,Vitesse,3,2,1,W
72092,1,HOL1,2002-05-05,Sparta Rotterdam,Groningen,0,0,0,D
72093,1,HOL1,2002-05-05,Utrecht,NAC Breda,0,0,0,D
72094,1,HOL1,2002-05-05,Willem II,Feyenoord Rotterdam,0,0,0,D
72095,2,HOL1,2002-08-16,Roosendaal,Zwolle,1,1,0,D
72096,2,HOL1,2002-08-17,AZ Alkmaar,Heerenveen,3,3,0,D
72097,2,HOL1,2002-08-17,Excelsior,PSV Eindhoven,0,2,-2,L
72098,2,HOL1,2002-08-17,NAC Breda,Roda,2,2,0,D
72099,2,HOL1,2002-08-17,Twente Enschede,Willem II,0,2,-2,L
72100,2,HOL1,2002-08-18,Ajax Amsterdam,Utrecht,3,1,2,W
72101,2,HOL1,2002-08-18,Feyenoord Rotterdam,NEC Nijmegen,2,0,2,W
72102,2,HOL1,2002-08-18,Groningen,Vitesse,1,2,-1,L
72103,2,HOL1,2002-08-18,Waalwijk,De Graafschap,4,2,2,W
72104,2,HOL1,2002-08-23,NEC Nijmegen,AZ Alkmaar,2,0,2,W
72105,2,HOL1,2002-08-24,De Graafschap,Roosendaal,2,0,2,W
72106,2,HOL1,2002-08-24,Heerenveen,Waalwijk,1,2,-1,L
72107,2,HOL1,2002-08-24,PSV Eindhoven,Groningen,1,0,1,W
72108,2,HOL1,2002-08-24,Roda,Feyenoord Rotterdam,2,2,0,D
72109,2,HOL1,2002-08-24,Zwolle,Excelsior,1,1,0,D
72110,2,HOL1,2002-08-25,Twente Enschede,Utrecht,1,1,0,D
72111,2,HOL1,2002-08-25,Vitesse,Ajax Amsterdam,1,2,-1,L
72112,2,HOL1,2002-08-25,Willem II,NAC Breda,1,1,0,D
72113,2,HOL1,2002-08-30,Waalwijk,Twente Enschede,3,2,1,W
72114,2,HOL1,2002-08-31,NAC Breda,NEC Nijmegen,0,0,0,D
72115,2,HOL1,2002-08-31,Roda,Willem II,1,0,1,W
72116,2,HOL1,2002-08-31,Zwolle,Vitesse,1,0,1,W
72117,2,HOL1,2002-09-01,Groningen,Ajax Amsterdam,1,3,-2,L
72118,2,HOL1,2002-09-01,Roosendaal,Heerenveen,3,0,3,W
72119,2,HOL1,2002-09-10,AZ Alkmaar,PSV Eindhoven,0,4,-4,L
72120,2,HOL1,2002-09-10,Feyenoord Rotterdam,Excelsior,4,1,3,W
72121,2,HOL1,2002-09-10,Utrecht,De Graafschap,4,0,4,W
72122,2,HOL1,2002-09-13,Vitesse,Roosendaal,3,0,3,W
72123,2,HOL1,2002-09-14,Ajax Amsterdam,Zwolle,2,0,2,W
72124,2,HOL1,2002-09-14,Excelsior,Groningen,4,2,2,W
72125,2,HOL1,2002-09-14,Heerenveen,NAC Breda,0,2,-2,L
72126,2,HOL1,2002-09-14,PSV Eindhoven,Waalwijk,4,0,4,W
72127,2,HOL1,2002-09-14,Twente Enschede,Feyenoord Rotterdam,1,5,-4,L
72128,2,HOL1,2002-09-14,Willem II,Utrecht,2,0,2,W
72129,2,HOL1,2002-09-15,De Graafschap,AZ Alkmaar,1,2,-1,L
72130,2,HOL1,2002-09-15,NEC Nijmegen,Roda,2,4,-2,L
72131,2,HOL1,2002-09-20,Excelsior,AZ Alkmaar,1,2,-1,L
72132,2,HOL1,2002-09-20,NAC Breda,Twente Enschede,2,0,2,W
72133,2,HOL1,2002-09-21,Feyenoord Rotterdam,De Graafschap,2,0,2,W
72134,2,HOL1,2002-09-21,Roosendaal,Ajax Amsterdam,2,3,-1,L
72135,2,HOL1,2002-09-21,Willem II,NEC Nijmegen,1,1,0,D
72136,2,HOL1,2002-09-21,Zwolle,PSV Eindhoven,1,3,-2,L
72137,2,HOL1,2002-09-22,Groningen,Utrecht,0,0,0,D
72138,2,HOL1,2002-09-22,Roda,Heerenveen,1,0,1,W
72139,2,HOL1,2002-09-22,Vitesse,Waalwijk,1,1,0,D
72140,2,HOL1,2002-09-27,AZ Alkmaar,Groningen,4,1,3,W
72141,2,HOL1,2002-09-28,PSV Eindhoven,De Graafschap,4,0,4,W
72142,2,HOL1,2002-09-28,Roosendaal,Feyenoord Rotterdam,4,2,2,W
72143,2,HOL1,2002-09-28,Twente Enschede,Roda,3,3,0,D
72144,2,HOL1,2002-09-28,Willem II,Zwolle,5,2,3,W
72145,2,HOL1,2002-09-29,Ajax Amsterdam,NAC Breda,2,2,0,D
72146,2,HOL1,2002-09-29,NEC Nijmegen,Heerenveen,4,2,2,W
72147,2,HOL1,2002-09-29,Utrecht,Vitesse,1,0,1,W
72148,2,HOL1,2002-09-29,Waalwijk,Excelsior,0,3,-3,L
72149,2,HOL1,2002-10-02,NEC Nijmegen,Groningen,2,0,2,W
72150,2,HOL1,2002-10-04,Waalwijk,Zwolle,0,2,-2,L
72151,2,HOL1,2002-10-05,De Graafschap,Twente Enschede,0,1,-1,L
72152,2,HOL1,2002-10-05,NAC Breda,PSV Eindhoven,2,2,0,D
72153,2,HOL1,2002-10-05,Roda,Excelsior,2,3,-1,L
72154,2,HOL1,2002-10-06,AZ Alkmaar,Vitesse,1,3,-2,L
72155,2,HOL1,2002-10-06,Feyenoord Rotterdam,Ajax Amsterdam,1,2,-1,L
72156,2,HOL1,2002-10-06,Heerenveen,Willem II,1,1,0,D
72157,2,HOL1,2002-10-06,Utrecht,Roosendaal,2,2,0,D
72158,2,HOL1,2002-10-18,De Graafschap,NEC Nijmegen,1,3,-2,L
72159,2,HOL1,2002-10-19,Ajax Amsterdam,AZ Alkmaar,6,2,4,W
72160,2,HOL1,2002-10-19,PSV Eindhoven,Roda,0,0,0,D
72161,2,HOL1,2002-10-19,Twente Enschede,Heerenveen,1,1,0,D
72162,2,HOL1,2002-10-19,Vitesse,Feyenoord Rotterdam,1,1,0,D
72163,2,HOL1,2002-10-19,Willem II,Roosendaal,3,1,2,W
72164,2,HOL1,2002-10-20,Excelsior,Utrecht,1,1,0,D
72165,2,HOL1,2002-10-20,Groningen,Waalwijk,2,3,-1,L
72166,2,HOL1,2002-10-20,Zwolle,NAC Breda,0,3,-3,L
72167,2,HOL1,2002-10-22,Vitesse,Roda,0,2,-2,L
72168,2,HOL1,2002-10-25,NAC Breda,Vitesse,0,0,0,D
72169,2,HOL1,2002-10-26,AZ Alkmaar,Twente Enschede,1,2,-1,L
72170,2,HOL1,2002-10-26,Feyenoord Rotterdam,Willem II,5,1,4,W
72171,2,HOL1,2002-10-26,Heerenveen,Excelsior,2,0,2,W
72172,2,HOL1,2002-10-26,NEC Nijmegen,PSV Eindhoven,0,5,-5,L
72173,2,HOL1,2002-10-26,Roda,De Graafschap,5,0,5,W
72174,2,HOL1,2002-10-26,Waalwijk,Ajax Amsterdam,1,1,0,D
72175,2,HOL1,2002-11-01,Zwolle,AZ Alkmaar,5,1,4,W
72176,2,HOL1,2002-11-02,Excelsior,NEC Nijmegen,0,0,0,D
72177,2,HOL1,2002-11-02,Heerenveen,De Graafschap,3,1,2,W
72178,2,HOL1,2002-11-02,Roosendaal,Waalwijk,0,0,0,D
72179,2,HOL1,2002-11-02,Twente Enschede,PSV Eindhoven,0,0,0,D
72180,2,HOL1,2002-11-03,Ajax Amsterdam,Willem II,3,0,3,W
72181,2,HOL1,2002-11-03,Groningen,Feyenoord Rotterdam,0,2,-2,L
72182,2,HOL1,2002-11-03,Utrecht,NAC Breda,1,0,1,W
72183,2,HOL1,2002-11-08,Roda,Ajax Amsterdam,1,1,0,D
72184,2,HOL1,2002-11-09,AZ Alkmaar,Roosendaal,2,0,2,W
72185,2,HOL1,2002-11-09,De Graafschap,Excelsior,1,1,0,D
72186,2,HOL1,2002-11-09,NAC Breda,Groningen,0,0,0,D
72187,2,HOL1,2002-11-09,PSV Eindhoven,Heerenveen,3,1,2,W
72188,2,HOL1,2002-11-09,Willem II,Vitesse,1,3,-2,L
72189,2,HOL1,2002-11-10,Feyenoord Rotterdam,Zwolle,2,0,2,W
72190,2,HOL1,2002-11-10,NEC Nijmegen,Twente Enschede,1,2,-1,L
72191,2,HOL1,2002-11-10,Waalwijk,Utrecht,0,1,-1,L
72192,2,HOL1,2002-11-12,Roosendaal,Groningen,2,0,2,W
72193,2,HOL1,2002-11-13,Utrecht,Zwolle,2,0,2,W
72194,2,HOL1,2002-11-15,Willem II,Waalwijk,0,1,-1,L
72195,2,HOL1,2002-11-16,Groningen,De Graafschap,3,1,2,W
72196,2,HOL1,2002-11-17,Ajax Amsterdam,NEC Nijmegen,6,0,6,W
72197,2,HOL1,2002-11-17,Excelsior,NAC Breda,0,3,-3,L
72198,2,HOL1,2002-11-17,PSV Eindhoven,Feyenoord Rotterdam,1,2,-1,L
72199,2,HOL1,2002-11-17,Roosendaal,Roda,4,0,4,W
72200,2,HOL1,2002-11-17,Utrecht,AZ Alkmaar,2,2,0,D
72201,2,HOL1,2002-11-17,Vitesse,Heerenveen,1,2,-1,L
72202,2,HOL1,2002-11-17,Zwolle,Twente Enschede,1,1,0,D
72203,2,HOL1,2002-11-22,Excelsior,Willem II,0,3,-3,L
72204,2,HOL1,2002-11-23,De Graafschap,NAC Breda,3,2,1,W
72205,2,HOL1,2002-11-23,Heerenveen,Ajax Amsterdam,0,3,-3,L
72206,2,HOL1,2002-11-23,Roda,AZ Alkmaar,1,3,-2,L
72207,2,HOL1,2002-11-23,Roosendaal,PSV Eindhoven,0,3,-3,L
72208,2,HOL1,2002-11-23,Twente Enschede,Vitesse,1,0,1,W
72209,2,HOL1,2002-11-23,Waalwijk,Feyenoord Rotterdam,1,0,1,W
72210,2,HOL1,2002-11-24,Utrecht,NEC Nijmegen,3,2,1,W
72211,2,HOL1,2002-11-24,Zwolle,Groningen,0,2,-2,L
72212,2,HOL1,2002-11-29,Roda,Zwolle,2,0,2,W
72213,2,HOL1,2002-11-30,AZ Alkmaar,Waalwijk,2,0,2,W
72214,2,HOL1,2002-11-30,NAC Breda,Roosendaal,1,0,1,W
72215,2,HOL1,2002-11-30,PSV Eindhoven,Willem II,2,1,1,W
72216,2,HOL1,2002-12-01,Ajax Amsterdam,Twente Enschede,2,1,1,W
72217,2,HOL1,2002-12-01,Feyenoord Rotterdam,Utrecht,2,1,1,W
72218,2,HOL1,2002-12-01,Groningen,Heerenveen,1,1,0,D
72219,2,HOL1,2002-12-01,Vitesse,De Graafschap,1,1,0,D
72220,2,HOL1,2002-12-06,Roosendaal,Excelsior,1,1,0,D
72221,2,HOL1,2002-12-07,De Graafschap,Ajax Amsterdam,1,1,0,D
72222,2,HOL1,2002-12-07,Heerenveen,Feyenoord Rotterdam,3,1,2,W
72223,2,HOL1,2002-12-07,Willem II,AZ Alkmaar,3,1,2,W
72224,2,HOL1,2002-12-08,NEC Nijmegen,Vitesse,2,0,2,W
72225,2,HOL1,2002-12-08,Twente Enschede,Groningen,0,0,0,D
72226,2,HOL1,2002-12-08,Utrecht,PSV Eindhoven,1,3,-2,L
72227,2,HOL1,2002-12-08,Waalwijk,Roda,3,1,2,W
72228,2,HOL1,2002-12-13,Groningen,Roda,3,2,1,W
72229,2,HOL1,2002-12-14,Excelsior,Twente Enschede,2,2,0,D
72230,2,HOL1,2002-12-14,De Graafschap,Willem II,1,1,0,D
72231,2,HOL1,2002-12-14,NAC Breda,Waalwijk,1,0,1,W
72232,2,HOL1,2002-12-14,Zwolle,NEC Nijmegen,0,0,0,D
72233,2,HOL1,2002-12-15,Ajax Amsterdam,PSV Eindhoven,2,4,-2,L
72234,2,HOL1,2002-12-15,Feyenoord Rotterdam,AZ Alkmaar,6,1,5,W
72235,2,HOL1,2002-12-15,Heerenveen,Utrecht,2,2,0,D
72236,2,HOL1,2002-12-17,NEC Nijmegen,Roosendaal,3,0,3,W
72237,2,HOL1,2002-12-18,Heerenveen,Zwolle,2,0,2,W
72238,2,HOL1,2002-12-18,Vitesse,Excelsior,1,2,-1,L
72239,2,HOL1,2002-12-20,Roda,Utrecht,1,0,1,W
72240,2,HOL1,2002-12-20,Twente Enschede,Roosendaal,3,0,3,W
72241,2,HOL1,2002-12-21,De Graafschap,Zwolle,3,2,1,W
72242,2,HOL1,2002-12-21,NEC Nijmegen,Waalwijk,0,0,0,D
72243,2,HOL1,2002-12-21,PSV Eindhoven,Vitesse,1,0,1,W
72244,2,HOL1,2002-12-21,Willem II,Groningen,1,0,1,W
72245,2,HOL1,2002-12-22,Excelsior,Ajax Amsterdam,0,2,-2,L
72246,2,HOL1,2002-12-22,NAC Breda,Feyenoord Rotterdam,1,1,0,D
72247,2,HOL1,2003-01-31,PSV Eindhoven,Roosendaal,3,0,3,W
72248,2,HOL1,2003-02-01,AZ Alkmaar,NEC Nijmegen,0,0,0,D
72249,2,HOL1,2003-02-01,NAC Breda,Heerenveen,1,1,0,D
72250,2,HOL1,2003-02-02,Feyenoord Rotterdam,Twente Enschede,4,2,2,W
72251,2,HOL1,2003-02-02,Waalwijk,Groningen,1,0,1,W
72252,2,HOL1,2003-02-02,Willem II,Ajax Amsterdam,0,6,-6,L
72253,2,HOL1,2003-02-07,Zwolle,Willem II,0,3,-3,L
72254,2,HOL1,2003-02-08,Heerenveen,AZ Alkmaar,5,0,5,W
72255,2,HOL1,2003-02-08,Roda,Vitesse,2,0,2,W
72256,2,HOL1,2003-02-08,Roosendaal,De Graafschap,1,0,1,W
72257,2,HOL1,2003-02-08,Waalwijk,PSV Eindhoven,0,1,-1,L
72258,2,HOL1,2003-02-09,Ajax Amsterdam,Feyenoord Rotterdam,1,1,0,D
72259,2,HOL1,2003-02-09,Groningen,Twente Enschede,0,0,0,D
72260,2,HOL1,2003-02-09,NEC Nijmegen,NAC Breda,2,0,2,W
72261,2,HOL1,2003-02-09,Utrecht,Excelsior,2,2,0,D
72262,2,HOL1,2003-02-14,Roosendaal,Utrecht,0,1,-1,L
72263,2,HOL1,2003-02-15,Ajax Amsterdam,Groningen,2,1,1,W
72264,2,HOL1,2003-02-15,AZ Alkmaar,Feyenoord Rotterdam,1,4,-3,L
72265,2,HOL1,2003-02-15,NAC Breda,Excelsior,2,1,1,W
72266,2,HOL1,2003-02-15,PSV Eindhoven,Zwolle,6,0,6,W
72267,2,HOL1,2003-02-15,Willem II,Roda,5,0,5,W
72268,2,HOL1,2003-02-16,De Graafschap,Heerenveen,1,5,-4,L
72269,2,HOL1,2003-02-16,Twente Enschede,NEC Nijmegen,1,2,-1,L
72270,2,HOL1,2003-02-16,Waalwijk,Vitesse,1,0,1,W
72271,2,HOL1,2003-02-19,AZ Alkmaar,NAC Breda,3,1,2,W
72272,2,HOL1,2003-02-19,Excelsior,Roda,0,2,-2,L
72273,2,HOL1,2003-02-19,Vitesse,Zwolle,2,1,1,W
72274,2,HOL1,2003-02-21,NEC Nijmegen,De Graafschap,1,0,1,W
72275,2,HOL1,2003-02-22,Excelsior,Roosendaal,1,2,-1,L
72276,2,HOL1,2003-02-22,PSV Eindhoven,NAC Breda,1,0,1,W
72277,2,HOL1,2003-02-22,Roda,Twente Enschede,2,0,2,W
72278,2,HOL1,2003-02-22,Vitesse,AZ Alkmaar,2,2,0,D
72279,2,HOL1,2003-02-23,Feyenoord Rotterdam,Groningen,4,1,3,W
72280,2,HOL1,2003-02-23,Utrecht,Ajax Amsterdam,1,0,1,W
72281,2,HOL1,2003-02-23,Zwolle,Waalwijk,2,1,1,W
72282,2,HOL1,2003-02-25,NEC Nijmegen,Willem II,1,0,1,W
72283,2,HOL1,2003-02-26,Utrecht,Heerenveen,2,2,0,D
72284,2,HOL1,2003-02-28,De Graafschap,Roda,1,1,0,D
72285,2,HOL1,2003-02-28,Roosendaal,Willem II,1,0,1,W
72286,2,HOL1,2003-03-01,Excelsior,Waalwijk,1,2,-1,L
72287,2,HOL1,2003-03-01,Heerenveen,PSV Eindhoven,0,1,-1,L
72288,2,HOL1,2003-03-01,Twente Enschede,AZ Alkmaar,0,0,0,D
72289,2,HOL1,2003-03-02,Ajax Amsterdam,Vitesse,2,0,2,W
72290,2,HOL1,2003-03-02,Feyenoord Rotterdam,NAC Breda,2,1,1,W
72291,2,HOL1,2003-03-02,Groningen,Zwolle,4,0,4,W
72292,2,HOL1,2003-03-07,AZ Alkmaar,Roda,1,0,1,W
72293,2,HOL1,2003-03-08,Excelsior,Feyenoord Rotterdam,2,6,-4,L
72294,2,HOL1,2003-03-08,NAC Breda,De Graafschap,1,0,1,W
72295,2,HOL1,2003-03-08,PSV Eindhoven,NEC Nijmegen,2,1,1,W
72296,2,HOL1,2003-03-08,Willem II,Twente Enschede,1,2,-1,L
72297,2,HOL1,2003-03-08,Zwolle,Ajax Amsterdam,0,5,-5,L
72298,2,HOL1,2003-03-09,Groningen,Roosendaal,1,0,1,W
72299,2,HOL1,2003-03-09,Vitesse,Utrecht,1,4,-3,L
72300,2,HOL1,2003-03-09,Waalwijk,Heerenveen,3,0,3,W
72301,2,HOL1,2003-03-12,De Graafschap,Utrecht,1,0,1,W
72302,2,HOL1,2003-03-15,De Graafschap,Waalwijk,2,4,-2,L
72303,2,HOL1,2003-03-15,Heerenveen,Twente Enschede,3,0,3,W
72304,2,HOL1,2003-03-15,Roda,NAC Breda,0,0,0,D
72305,2,HOL1,2003-03-15,Vitesse,PSV Eindhoven,0,5,-5,L
72306,2,HOL1,2003-03-15,Zwolle,Roosendaal,1,1,0,D
72307,2,HOL1,2003-03-16,Ajax Amsterdam,Excelsior,2,1,1,W
72308,2,HOL1,2003-03-16,AZ Alkmaar,Utrecht,2,0,2,W
72309,2,HOL1,2003-03-16,Groningen,Willem II,1,1,0,D
72310,2,HOL1,2003-03-16,NEC Nijmegen,Feyenoord Rotterdam,1,2,-1,L
72311,2,HOL1,2003-03-21,Excelsior,Zwolle,0,1,-1,L
72312,2,HOL1,2003-03-22,AZ Alkmaar,De Graafschap,3,1,2,W
72313,2,HOL1,2003-03-22,Feyenoord Rotterdam,Heerenveen,5,0,5,W
72314,2,HOL1,2003-03-22,Roda,NEC Nijmegen,2,1,1,W
72315,2,HOL1,2003-03-22,Roosendaal,Vitesse,3,1,2,W
72316,2,HOL1,2003-03-22,Twente Enschede,Waalwijk,2,1,1,W
72317,2,HOL1,2003-03-23,NAC Breda,Willem II,0,0,0,D
72318,2,HOL1,2003-03-23,PSV Eindhoven,Ajax Amsterdam,2,0,2,W
72319,2,HOL1,2003-03-23,Utrecht,Groningen,0,0,0,D
72320,2,HOL1,2003-04-05,Ajax Amsterdam,Roosendaal,4,1,3,W
72321,2,HOL1,2003-04-05,De Graafschap,Feyenoord Rotterdam,3,4,-1,L
72322,2,HOL1,2003-04-05,Heerenveen,Roda,3,2,1,W
72323,2,HOL1,2003-04-05,Twente Enschede,NAC Breda,0,0,0,D
72324,2,HOL1,2003-04-05,Vitesse,Groningen,0,0,0,D
72325,2,HOL1,2003-04-06,NEC Nijmegen,Excelsior,1,0,1,W
72326,2,HOL1,2003-04-06,Waalwijk,AZ Alkmaar,2,0,2,W
72327,2,HOL1,2003-04-06,Willem II,PSV Eindhoven,1,1,0,D
72328,2,HOL1,2003-04-06,Zwolle,Utrecht,3,1,2,W
72329,2,HOL1,2003-04-11,Roda,PSV Eindhoven,2,3,-1,L
72330,2,HOL1,2003-04-11,Utrecht,Willem II,1,1,0,D
72331,2,HOL1,2003-04-12,AZ Alkmaar,Zwolle,1,1,0,D
72332,2,HOL1,2003-04-12,Feyenoord Rotterdam,Vitesse,2,1,1,W
72333,2,HOL1,2003-04-12,Heerenveen,NEC Nijmegen,2,3,-1,L
72334,2,HOL1,2003-04-12,Twente Enschede,De Graafschap,3,0,3,W
72335,2,HOL1,2003-04-13,Groningen,Excelsior,1,0,1,W
72336,2,HOL1,2003-04-13,NAC Breda,Ajax Amsterdam,0,3,-3,L
72337,2,HOL1,2003-04-13,Waalwijk,Roosendaal,1,2,-1,L
72338,2,HOL1,2003-04-18,Utrecht,Waalwijk,4,3,1,W
72339,2,HOL1,2003-04-19,Ajax Amsterdam,Roda,4,2,2,W
72340,2,HOL1,2003-04-19,Excelsior,Heerenveen,1,0,1,W
72341,2,HOL1,2003-04-19,PSV Eindhoven,Twente Enschede,2,0,2,W
72342,2,HOL1,2003-04-19,Roosendaal,AZ Alkmaar,0,0,0,D
72343,2,HOL1,2003-04-19,Willem II,De Graafschap,3,0,3,W
72344,2,HOL1,2003-04-20,Vitesse,NEC Nijmegen,1,1,0,D
72345,2,HOL1,2003-04-20,Zwolle,Feyenoord Rotterdam,1,3,-2,L
72346,2,HOL1,2003-04-25,Waalwijk,Willem II,3,1,2,W
72347,2,HOL1,2003-04-26,De Graafschap,PSV Eindhoven,1,6,-5,L
72348,2,HOL1,2003-04-26,Heerenveen,Vitesse,2,2,0,D
72349,2,HOL1,2003-04-26,Twente Enschede,Excelsior,1,0,1,W
72350,2,HOL1,2003-04-27,AZ Alkmaar,Ajax Amsterdam,1,3,-2,L
72351,2,HOL1,2003-04-27,Feyenoord Rotterdam,Roosendaal,1,0,1,W
72352,2,HOL1,2003-04-27,Groningen,NAC Breda,0,0,0,D
72353,2,HOL1,2003-04-27,NEC Nijmegen,Utrecht,1,2,-1,L
72354,2,HOL1,2003-05-02,Excelsior,De Graafschap,3,4,-1,L
72355,2,HOL1,2003-05-03,Ajax Amsterdam,Waalwijk,6,1,5,W
72356,2,HOL1,2003-05-03,PSV Eindhoven,AZ Alkmaar,2,2,0,D
72357,2,HOL1,2003-05-03,Vitesse,NAC Breda,3,1,2,W
72358,2,HOL1,2003-05-03,Willem II,Heerenveen,1,5,-4,L
72359,2,HOL1,2003-05-03,Zwolle,Roda,3,1,2,W
72360,2,HOL1,2003-05-04,Groningen,NEC Nijmegen,0,0,0,D
72361,2,HOL1,2003-05-04,Roosendaal,Twente Enschede,1,0,1,W
72362,2,HOL1,2003-05-04,Utrecht,Feyenoord Rotterdam,1,2,-1,L
72363,2,HOL1,2003-05-06,NAC Breda,Zwolle,2,0,2,W
72364,2,HOL1,2003-05-09,Heerenveen,Groningen,2,1,1,W
72365,2,HOL1,2003-05-09,Roda,Roosendaal,1,0,1,W
72366,2,HOL1,2003-05-10,AZ Alkmaar,Willem II,3,2,1,W
72367,2,HOL1,2003-05-10,NAC Breda,Utrecht,2,0,2,W
72368,2,HOL1,2003-05-10,PSV Eindhoven,Excelsior,7,0,7,W
72369,2,HOL1,2003-05-10,Twente Enschede,Zwolle,0,0,0,D
72370,2,HOL1,2003-05-11,Feyenoord Rotterdam,Waalwijk,2,1,1,W
72371,2,HOL1,2003-05-11,De Graafschap,Vitesse,0,1,-1,L
72372,2,HOL1,2003-05-11,NEC Nijmegen,Ajax Amsterdam,1,2,-1,L
72373,2,HOL1,2003-05-13,Roda,Groningen,5,1,4,W
72374,2,HOL1,2003-05-16,Utrecht,Roda,4,4,0,D
72375,2,HOL1,2003-05-17,Roosendaal,NEC Nijmegen,0,2,-2,L
72376,2,HOL1,2003-05-17,Vitesse,Twente Enschede,0,1,-1,L
72377,2,HOL1,2003-05-17,Willem II,Excelsior,2,1,1,W
72378,2,HOL1,2003-05-17,Zwolle,Heerenveen,0,1,-1,L
72379,2,HOL1,2003-05-18,Ajax Amsterdam,De Graafschap,7,1,6,W
72380,2,HOL1,2003-05-18,Feyenoord Rotterdam,PSV Eindhoven,3,1,2,W
72381,2,HOL1,2003-05-18,Groningen,AZ Alkmaar,1,0,1,W
72382,2,HOL1,2003-05-18,Waalwijk,NAC Breda,2,3,-1,L
72383,2,HOL1,2003-05-25,Excelsior,Vitesse,4,4,0,D
72384,2,HOL1,2003-05-25,De Graafschap,Groningen,1,0,1,W
72385,2,HOL1,2003-05-25,Heerenveen,Roosendaal,6,0,6,W
72386,2,HOL1,2003-05-25,NAC Breda,AZ Alkmaar,4,0,4,W
72387,2,HOL1,2003-05-25,NEC Nijmegen,Zwolle,0,0,0,D
72388,2,HOL1,2003-05-25,PSV Eindhoven,Utrecht,2,0,2,W
72389,2,HOL1,2003-05-25,Roda,Waalwijk,1,0,1,W
72390,2,HOL1,2003-05-25,Twente Enschede,Ajax Amsterdam,1,2,-1,L
72391,2,HOL1,2003-05-25,Willem II,Feyenoord Rotterdam,1,1,0,D
72392,2,HOL1,2003-05-29,Ajax Amsterdam,Heerenveen,3,0,3,W
72393,2,HOL1,2003-05-29,AZ Alkmaar,Excelsior,3,1,2,W
72394,2,HOL1,2003-05-29,Feyenoord Rotterdam,Roda,3,1,2,W
72395,2,HOL1,2003-05-29,Groningen,PSV Eindhoven,0,0,0,D
72396,2,HOL1,2003-05-29,Roosendaal,NAC Breda,1,2,-1,L
72397,2,HOL1,2003-05-29,Utrecht,Twente Enschede,3,2,1,W
72398,2,HOL1,2003-05-29,Vitesse,Willem II,2,0,2,W
72399,2,HOL1,2003-05-29,Waalwijk,NEC Nijmegen,0,1,-1,L
72400,2,HOL1,2003-05-29,Zwolle,De Graafschap,2,1,1,W
72401,3,HOL1,2003-08-15,Roda,PSV Eindhoven,2,2,0,D
72402,3,HOL1,2003-08-16,Twente Enschede,Roosendaal,3,1,2,W
72403,3,HOL1,2003-08-16,Waalwijk,ADO Den Haag,1,0,1,W
72404,3,HOL1,2003-08-16,Willem II,AZ Alkmaar,1,0,1,W
72405,3,HOL1,2003-08-17,Feyenoord Rotterdam,NEC Nijmegen,2,1,1,W
72406,3,HOL1,2003-08-17,Groningen,NAC Breda,1,0,1,W
72407,3,HOL1,2003-08-17,Utrecht,Zwolle,1,0,1,W
72408,3,HOL1,2003-08-17,Vitesse,Ajax Amsterdam,1,2,-1,L
72409,3,HOL1,2003-08-17,Volendam,Heerenveen,0,1,-1,L
72410,3,HOL1,2003-08-22,AZ Alkmaar,Twente Enschede,3,0,3,W
72411,3,HOL1,2003-08-23,ADO Den Haag,Utrecht,1,1,0,D
72412,3,HOL1,2003-08-23,Heerenveen,Feyenoord Rotterdam,1,0,1,W
72413,3,HOL1,2003-08-23,NAC Breda,Vitesse,2,0,2,W
72414,3,HOL1,2003-08-23,PSV Eindhoven,Willem II,6,1,5,W
72415,3,HOL1,2003-08-23,Roosendaal,Ajax Amsterdam,0,1,-1,L
72416,3,HOL1,2003-08-24,NEC Nijmegen,Roda,1,3,-2,L
72417,3,HOL1,2003-08-24,Volendam,Groningen,3,0,3,W
72418,3,HOL1,2003-08-24,Zwolle,Waalwijk,0,3,-3,L
72419,3,HOL1,2003-08-29,Vitesse,AZ Alkmaar,1,2,-1,L
72420,3,HOL1,2003-08-29,Willem II,Heerenveen,2,0,2,W
72421,3,HOL1,2003-08-30,Roda,Roosendaal,0,2,-2,L
72422,3,HOL1,2003-08-30,Twente Enschede,PSV Eindhoven,0,2,-2,L
72423,3,HOL1,2003-08-31,Ajax Amsterdam,Zwolle,1,0,1,W
72424,3,HOL1,2003-08-31,Feyenoord Rotterdam,NAC Breda,2,1,1,W
72425,3,HOL1,2003-08-31,Groningen,ADO Den Haag,2,0,2,W
72426,3,HOL1,2003-08-31,Utrecht,NEC Nijmegen,0,1,-1,L
72427,3,HOL1,2003-08-31,Waalwijk,Volendam,3,0,3,W
72428,3,HOL1,2003-09-12,ADO Den Haag,Volendam,1,1,0,D
72429,3,HOL1,2003-09-13,Ajax Amsterdam,Waalwijk,4,1,3,W
72430,3,HOL1,2003-09-13,Heerenveen,Groningen,1,0,1,W
72431,3,HOL1,2003-09-13,PSV Eindhoven,Utrecht,2,1,1,W
72432,3,HOL1,2003-09-13,Roosendaal,Vitesse,1,1,0,D
72433,3,HOL1,2003-09-13,Zwolle,Roda,0,0,0,D
72434,3,HOL1,2003-09-14,AZ Alkmaar,Feyenoord Rotterdam,2,2,0,D
72435,3,HOL1,2003-09-14,NAC Breda,Willem II,1,1,0,D
72436,3,HOL1,2003-09-14,NEC Nijmegen,Twente Enschede,2,1,1,W
72437,3,HOL1,2003-09-19,Volendam,NEC Nijmegen,2,3,-1,L
72438,3,HOL1,2003-09-20,AZ Alkmaar,Heerenveen,3,1,2,W
72439,3,HOL1,2003-09-20,ADO Den Haag,Roosendaal,1,2,-1,L
72440,3,HOL1,2003-09-20,Twente Enschede,Waalwijk,2,1,1,W
72441,3,HOL1,2003-09-20,Vitesse,Roda,1,1,0,D
72442,3,HOL1,2003-09-20,Willem II,Zwolle,2,1,1,W
72443,3,HOL1,2003-09-21,Feyenoord Rotterdam,PSV Eindhoven,1,3,-2,L
72444,3,HOL1,2003-09-21,Groningen,Utrecht,1,1,0,D
72445,3,HOL1,2003-09-21,NAC Breda,Ajax Amsterdam,4,2,2,W
72446,3,HOL1,2003-09-27,Heerenveen,Twente Enschede,3,0,3,W
72447,3,HOL1,2003-09-27,PSV Eindhoven,AZ Alkmaar,0,1,-1,L
72448,3,HOL1,2003-09-27,Roosendaal,Volendam,1,1,0,D
72449,3,HOL1,2003-09-28,Ajax Amsterdam,Willem II,6,0,6,W
72450,3,HOL1,2003-09-28,NEC Nijmegen,ADO Den Haag,1,2,-1,L
72451,3,HOL1,2003-09-28,Roda,Groningen,0,0,0,D
72452,3,HOL1,2003-09-28,Utrecht,Vitesse,1,3,-2,L
72453,3,HOL1,2003-09-28,Waalwijk,NAC Breda,2,0,2,W
72454,3,HOL1,2003-09-28,Zwolle,Feyenoord Rotterdam,0,3,-3,L
72455,3,HOL1,2003-10-03,Vitesse,Twente Enschede,3,5,-2,L
72456,3,HOL1,2003-10-04,AZ Alkmaar,NEC Nijmegen,2,0,2,W
72457,3,HOL1,2003-10-04,ADO Den Haag,PSV Eindhoven,0,4,-4,L
72458,3,HOL1,2003-10-04,Heerenveen,Waalwijk,1,0,1,W
72459,3,HOL1,2003-10-04,NAC Breda,Utrecht,1,2,-1,L
72460,3,HOL1,2003-10-04,Willem II,Roda,0,2,-2,L
72461,3,HOL1,2003-10-05,Feyenoord Rotterdam,Roosendaal,2,0,2,W
72462,3,HOL1,2003-10-05,Groningen,Ajax Amsterdam,1,3,-2,L
72463,3,HOL1,2003-10-05,Volendam,Zwolle,2,2,0,D
72464,3,HOL1,2003-10-17,Ajax Amsterdam,Volendam,5,1,4,W
72465,3,HOL1,2003-10-18,PSV Eindhoven,Heerenveen,2,0,2,W
72466,3,HOL1,2003-10-18,Roosendaal,Willem II,0,0,0,D
72467,3,HOL1,2003-10-18,Waalwijk,Vitesse,2,2,0,D
72468,3,HOL1,2003-10-19,NEC Nijmegen,NAC Breda,0,3,-3,L
72469,3,HOL1,2003-10-19,Roda,Feyenoord Rotterdam,1,1,0,D
72470,3,HOL1,2003-10-19,Twente Enschede,Groningen,5,3,2,W
72471,3,HOL1,2003-10-19,Utrecht,AZ Alkmaar,0,3,-3,L
72472,3,HOL1,2003-10-19,Zwolle,ADO Den Haag,1,2,-1,L
72473,3,HOL1,2003-10-24,Volendam,Roda,2,1,1,W
72474,3,HOL1,2003-10-25,AZ Alkmaar,Zwolle,4,0,4,W
72475,3,HOL1,2003-10-25,ADO Den Haag,NAC Breda,1,1,0,D
72476,3,HOL1,2003-10-25,Groningen,Vitesse,2,1,1,W
72477,3,HOL1,2003-10-25,Heerenveen,NEC Nijmegen,1,2,-1,L
72478,3,HOL1,2003-10-25,Waalwijk,Roosendaal,1,2,-1,L
72479,3,HOL1,2003-10-26,Feyenoord Rotterdam,Willem II,2,1,1,W
72480,3,HOL1,2003-10-26,PSV Eindhoven,Ajax Amsterdam,2,2,0,D
72481,3,HOL1,2003-10-26,Twente Enschede,Utrecht,2,2,0,D
72482,3,HOL1,2003-10-31,Roda,ADO Den Haag,5,1,4,W
72483,3,HOL1,2003-11-01,Ajax Amsterdam,AZ Alkmaar,3,2,1,W
72484,3,HOL1,2003-11-01,NAC Breda,PSV Eindhoven,1,3,-2,L
72485,3,HOL1,2003-11-01,Roosendaal,NEC Nijmegen,1,0,1,W
72486,3,HOL1,2003-11-01,Vitesse,Volendam,2,2,0,D
72487,3,HOL1,2003-11-02,Groningen,Feyenoord Rotterdam,3,3,0,D
72488,3,HOL1,2003-11-02,Utrecht,Heerenveen,2,1,1,W
72489,3,HOL1,2003-11-02,Willem II,Waalwijk,4,1,3,W
72490,3,HOL1,2003-11-02,Zwolle,Twente Enschede,1,0,1,W
72491,3,HOL1,2003-11-07,Vitesse,Willem II,2,2,0,D
72492,3,HOL1,2003-11-08,Heerenveen,Zwolle,1,1,0,D
72493,3,HOL1,2003-11-08,NAC Breda,AZ Alkmaar,1,2,-1,L
72494,3,HOL1,2003-11-08,PSV Eindhoven,Roosendaal,1,1,0,D
72495,3,HOL1,2003-11-08,Roda,Twente Enschede,2,1,1,W
72496,3,HOL1,2003-11-09,ADO Den Haag,Ajax Amsterdam,1,4,-3,L
72497,3,HOL1,2003-11-09,NEC Nijmegen,Groningen,2,3,-1,L
72498,3,HOL1,2003-11-09,Utrecht,Waalwijk,1,0,1,W
72499,3,HOL1,2003-11-09,Volendam,Feyenoord Rotterdam,1,3,-2,L
72500,3,HOL1,2003-11-21,Waalwijk,Groningen,1,1,0,D
72501,3,HOL1,2003-11-22,AZ Alkmaar,Roda,1,5,-4,L
72502,3,HOL1,2003-11-22,Feyenoord Rotterdam,Vitesse,3,0,3,W
72503,3,HOL1,2003-11-22,NEC Nijmegen,PSV Eindhoven,2,3,-1,L
72504,3,HOL1,2003-11-22,Willem II,Volendam,6,0,6,W
72505,3,HOL1,2003-11-22,Zwolle,NAC Breda,0,2,-2,L
72506,3,HOL1,2003-11-23,Ajax Amsterdam,Heerenveen,3,1,2,W
72507,3,HOL1,2003-11-23,Roosendaal,Utrecht,1,1,0,D
72508,3,HOL1,2003-11-23,Twente Enschede,ADO Den Haag,4,0,4,W
72509,3,HOL1,2003-11-28,Groningen,Roosendaal,2,0,2,W
72510,3,HOL1,2003-11-29,ADO Den Haag,Vitesse,1,1,0,D
72511,3,HOL1,2003-11-29,Twente Enschede,NAC Breda,2,1,1,W
72512,3,HOL1,2003-11-29,Willem II,NEC Nijmegen,3,0,3,W
72513,3,HOL1,2003-11-29,Zwolle,PSV Eindhoven,0,4,-4,L
72514,3,HOL1,2003-11-30,Ajax Amsterdam,Feyenoord Rotterdam,2,0,2,W
72515,3,HOL1,2003-11-30,Utrecht,Roda,3,1,2,W
72516,3,HOL1,2003-11-30,Waalwijk,AZ Alkmaar,1,1,0,D
72517,3,HOL1,2003-12-03,AZ Alkmaar,Groningen,2,1,1,W
72518,3,HOL1,2003-12-03,Heerenveen,ADO Den Haag,2,0,2,W
72519,3,HOL1,2003-12-03,Volendam,Twente Enschede,2,0,2,W
72520,3,HOL1,2003-12-06,NEC Nijmegen,Waalwijk,1,1,0,D
72521,3,HOL1,2003-12-06,PSV Eindhoven,Volendam,7,0,7,W
72522,3,HOL1,2003-12-06,Willem II,Utrecht,0,2,-2,L
72523,3,HOL1,2003-12-07,Feyenoord Rotterdam,ADO Den Haag,4,1,3,W
72524,3,HOL1,2003-12-07,NAC Breda,Heerenveen,2,3,-1,L
72525,3,HOL1,2003-12-07,Roosendaal,AZ Alkmaar,1,0,1,W
72526,3,HOL1,2003-12-07,Vitesse,Zwolle,5,2,3,W
72527,3,HOL1,2003-12-12,Roda,NAC Breda,2,2,0,D
72528,3,HOL1,2003-12-13,ADO Den Haag,Willem II,0,1,-1,L
72529,3,HOL1,2003-12-13,PSV Eindhoven,Waalwijk,3,1,2,W
72530,3,HOL1,2003-12-13,Roosendaal,Heerenveen,1,1,0,D
72531,3,HOL1,2003-12-13,Twente Enschede,Feyenoord Rotterdam,4,2,2,W
72532,3,HOL1,2003-12-14,Ajax Amsterdam,Utrecht,1,0,1,W
72533,3,HOL1,2003-12-14,NEC Nijmegen,Vitesse,2,0,2,W
72534,3,HOL1,2003-12-14,Volendam,AZ Alkmaar,0,6,-6,L
72535,3,HOL1,2003-12-14,Zwolle,Groningen,1,1,0,D
72536,3,HOL1,2003-12-20,Heerenveen,Roda,2,1,1,W
72537,3,HOL1,2003-12-20,NAC Breda,Roosendaal,3,2,1,W
72538,3,HOL1,2003-12-20,NEC Nijmegen,Zwolle,1,0,1,W
72539,3,HOL1,2003-12-20,Vitesse,PSV Eindhoven,0,0,0,D
72540,3,HOL1,2003-12-21,Groningen,Willem II,1,2,-1,L
72541,3,HOL1,2003-12-21,Twente Enschede,Ajax Amsterdam,2,0,2,W
72542,3,HOL1,2003-12-21,Utrecht,Volendam,3,0,3,W
72543,3,HOL1,2003-12-21,Waalwijk,Feyenoord Rotterdam,0,0,0,D
72544,3,HOL1,2004-01-21,Roda,Ajax Amsterdam,1,2,-1,L
72545,3,HOL1,2004-01-23,AZ Alkmaar,ADO Den Haag,0,1,-1,L
72546,3,HOL1,2004-01-24,NAC Breda,Volendam,3,2,1,W
72547,3,HOL1,2004-01-24,Roda,Waalwijk,2,1,1,W
72548,3,HOL1,2004-01-24,Vitesse,Heerenveen,0,1,-1,L
72549,3,HOL1,2004-01-24,Willem II,Twente Enschede,2,3,-1,L
72550,3,HOL1,2004-01-24,Zwolle,Roosendaal,0,3,-3,L
72551,3,HOL1,2004-01-25,Ajax Amsterdam,NEC Nijmegen,1,0,1,W
72552,3,HOL1,2004-01-25,Feyenoord Rotterdam,Utrecht,3,2,1,W
72553,3,HOL1,2004-01-25,Groningen,PSV Eindhoven,0,2,-2,L
72554,3,HOL1,2004-01-28,AZ Alkmaar,Willem II,0,0,0,D
72555,3,HOL1,2004-01-28,NEC Nijmegen,Feyenoord Rotterdam,1,2,-1,L
72556,3,HOL1,2004-01-28,PSV Eindhoven,Zwolle,5,1,4,W
72557,3,HOL1,2004-01-28,Twente Enschede,Vitesse,0,0,0,D
72558,3,HOL1,2004-01-28,Utrecht,Roosendaal,0,1,-1,L
72559,3,HOL1,2004-01-28,Volendam,Waalwijk,0,4,-4,L
72560,3,HOL1,2004-01-31,PSV Eindhoven,Vitesse,3,0,3,W
72561,3,HOL1,2004-01-31,Roda,AZ Alkmaar,3,1,2,W
72562,3,HOL1,2004-01-31,Waalwijk,NEC Nijmegen,1,2,-1,L
72563,3,HOL1,2004-02-01,Ajax Amsterdam,ADO Den Haag,4,0,4,W
72564,3,HOL1,2004-02-01,Feyenoord Rotterdam,Twente Enschede,3,2,1,W
72565,3,HOL1,2004-02-01,Groningen,Volendam,0,1,-1,L
72566,3,HOL1,2004-02-01,Willem II,NAC Breda,1,1,0,D
72567,3,HOL1,2004-02-01,Zwolle,Utrecht,1,1,0,D
72568,3,HOL1,2004-02-06,Roosendaal,Waalwijk,1,3,-2,L
72569,3,HOL1,2004-02-07,AZ Alkmaar,Volendam,3,0,3,W
72570,3,HOL1,2004-02-07,Heerenveen,NAC Breda,3,4,-1,L
72571,3,HOL1,2004-02-07,Twente Enschede,Zwolle,2,0,2,W
72572,3,HOL1,2004-02-08,Ajax Amsterdam,PSV Eindhoven,2,1,1,W
72573,3,HOL1,2004-02-08,Groningen,NEC Nijmegen,2,0,2,W
72574,3,HOL1,2004-02-08,Vitesse,Feyenoord Rotterdam,0,0,0,D
72575,3,HOL1,2004-02-08,Willem II,ADO Den Haag,1,0,1,W
72576,3,HOL1,2004-02-11,ADO Den Haag,Groningen,3,1,2,W
72577,3,HOL1,2004-02-11,Feyenoord Rotterdam,AZ Alkmaar,0,3,-3,L
72578,3,HOL1,2004-02-11,Roosendaal,Roda,1,4,-3,L
72579,3,HOL1,2004-02-11,Utrecht,Willem II,2,2,0,D
72580,3,HOL1,2004-02-11,Waalwijk,Heerenveen,0,0,0,D
72581,3,HOL1,2004-02-14,Heerenveen,Willem II,1,1,0,D
72582,3,HOL1,2004-02-14,NAC Breda,Roda,0,0,0,D
72583,3,HOL1,2004-02-14,PSV Eindhoven,Twente Enschede,1,0,1,W
72584,3,HOL1,2004-02-14,Vitesse,Roosendaal,1,2,-1,L
72585,3,HOL1,2004-02-15,ADO Den Haag,Feyenoord Rotterdam,2,2,0,D
72586,3,HOL1,2004-02-15,NEC Nijmegen,Utrecht,4,0,4,W
72587,3,HOL1,2004-02-15,Volendam,Ajax Amsterdam,0,2,-2,L
72588,3,HOL1,2004-02-15,Waalwijk,Zwolle,2,0,2,W
72589,3,HOL1,2004-02-20,Roda,Volendam,1,0,1,W
72590,3,HOL1,2004-02-21,AZ Alkmaar,Roosendaal,2,1,1,W
72591,3,HOL1,2004-02-21,Heerenveen,PSV Eindhoven,3,2,1,W
72592,3,HOL1,2004-02-21,Vitesse,Groningen,1,2,-1,L
72593,3,HOL1,2004-02-21,Zwolle,NEC Nijmegen,2,1,1,W
72594,3,HOL1,2004-02-22,Ajax Amsterdam,Twente Enschede,1,0,1,W
72595,3,HOL1,2004-02-22,Utrecht,NAC Breda,1,2,-1,L
72596,3,HOL1,2004-02-25,ADO Den Haag,Roda,1,0,1,W
72597,3,HOL1,2004-02-25,Heerenveen,Ajax Amsterdam,4,1,3,W
72598,3,HOL1,2004-02-25,NAC Breda,Groningen,1,1,0,D
72599,3,HOL1,2004-02-27,Zwolle,Vitesse,1,1,0,D
72600,3,HOL1,2004-02-28,NEC Nijmegen,Heerenveen,1,2,-1,L
72601,3,HOL1,2004-02-28,Roosendaal,NAC Breda,1,1,0,D
72602,3,HOL1,2004-02-28,Twente Enschede,AZ Alkmaar,4,1,3,W
72603,3,HOL1,2004-02-29,Groningen,Waalwijk,1,2,-1,L
72604,3,HOL1,2004-02-29,PSV Eindhoven,Roda,1,2,-1,L
72605,3,HOL1,2004-02-29,Utrecht,Ajax Amsterdam,1,0,1,W
72606,3,HOL1,2004-02-29,Volendam,ADO Den Haag,0,2,-2,L
72607,3,HOL1,2004-02-29,Willem II,Feyenoord Rotterdam,0,3,-3,L
72608,3,HOL1,2004-03-05,NAC Breda,Twente Enschede,0,1,-1,L
72609,3,HOL1,2004-03-06,ADO Den Haag,AZ Alkmaar,2,3,-1,L
72610,3,HOL1,2004-03-06,NEC Nijmegen,Roosendaal,1,2,-1,L
72611,3,HOL1,2004-03-06,Roda,Zwolle,1,1,0,D
72612,3,HOL1,2004-03-06,Waalwijk,Ajax Amsterdam,0,1,-1,L
72613,3,HOL1,2004-03-06,Willem II,Groningen,2,0,2,W
72614,3,HOL1,2004-03-07,Feyenoord Rotterdam,Heerenveen,2,2,0,D
72615,3,HOL1,2004-03-07,Utrecht,PSV Eindhoven,0,4,-4,L
72616,3,HOL1,2004-03-07,Volendam,Vitesse,0,0,0,D
72617,3,HOL1,2004-03-12,Twente Enschede,NEC Nijmegen,2,5,-3,L
72618,3,HOL1,2004-03-13,Heerenveen,Volendam,2,1,1,W
72619,3,HOL1,2004-03-13,NAC Breda,Zwolle,3,1,2,W
72620,3,HOL1,2004-03-13,Roosendaal,Groningen,1,0,1,W
72621,3,HOL1,2004-03-14,Ajax Amsterdam,Roda,4,2,2,W
72622,3,HOL1,2004-03-14,AZ Alkmaar,Utrecht,1,2,-1,L
72623,3,HOL1,2004-03-14,PSV Eindhoven,Feyenoord Rotterdam,0,1,-1,L
72624,3,HOL1,2004-03-14,Vitesse,ADO Den Haag,1,0,1,W
72625,3,HOL1,2004-03-14,Waalwijk,Willem II,1,1,0,D
72626,3,HOL1,2004-03-19,Groningen,Heerenveen,0,0,0,D
72627,3,HOL1,2004-03-20,NEC Nijmegen,AZ Alkmaar,0,2,-2,L
72628,3,HOL1,2004-03-20,PSV Eindhoven,NAC Breda,1,1,0,D
72629,3,HOL1,2004-03-20,Roda,Willem II,6,1,5,W
72630,3,HOL1,2004-03-20,Zwolle,Volendam,3,0,3,W
72631,3,HOL1,2004-03-21,Ajax Amsterdam,Vitesse,5,0,5,W
72632,3,HOL1,2004-03-21,Feyenoord Rotterdam,Waalwijk,1,0,1,W
72633,3,HOL1,2004-03-21,Roosendaal,ADO Den Haag,0,0,0,D
72634,3,HOL1,2004-03-21,Utrecht,Twente Enschede,2,0,2,W
72635,3,HOL1,2004-03-26,ADO Den Haag,Zwolle,1,1,0,D
72636,3,HOL1,2004-03-27,Heerenveen,Roosendaal,1,0,1,W
72637,3,HOL1,2004-03-27,NAC Breda,NEC Nijmegen,5,2,3,W
72638,3,HOL1,2004-03-27,Vitesse,Waalwijk,3,3,0,D
72639,3,HOL1,2004-03-28,AZ Alkmaar,Ajax Amsterdam,1,1,0,D
72640,3,HOL1,2004-03-28,Feyenoord Rotterdam,Roda,3,0,3,W
72641,3,HOL1,2004-03-28,Groningen,Twente Enschede,1,0,1,W
72642,3,HOL1,2004-03-28,Volendam,Utrecht,1,2,-1,L
72643,3,HOL1,2004-03-28,Willem II,PSV Eindhoven,3,1,2,W
72644,3,HOL1,2004-04-02,NEC Nijmegen,Willem II,4,0,4,W
72645,3,HOL1,2004-04-03,AZ Alkmaar,Vitesse,2,1,1,W
72646,3,HOL1,2004-04-03,Roda,Heerenveen,0,1,-1,L
72647,3,HOL1,2004-04-03,Roosendaal,Zwolle,1,1,0,D
72648,3,HOL1,2004-04-03,Twente Enschede,Volendam,1,2,-1,L
72649,3,HOL1,2004-04-03,Waalwijk,PSV Eindhoven,0,4,-4,L
72650,3,HOL1,2004-04-04,Ajax Amsterdam,Groningen,2,1,1,W
72651,3,HOL1,2004-04-04,NAC Breda,Feyenoord Rotterdam,0,3,-3,L
72652,3,HOL1,2004-04-04,Utrecht,ADO Den Haag,5,3,2,W
72653,3,HOL1,2004-04-09,Roda,NEC Nijmegen,4,0,4,W
72654,3,HOL1,2004-04-10,ADO Den Haag,Waalwijk,1,3,-2,L
72655,3,HOL1,2004-04-10,Heerenveen,Utrecht,4,0,4,W
72656,3,HOL1,2004-04-10,Volendam,Willem II,0,1,-1,L
72657,3,HOL1,2004-04-10,Zwolle,AZ Alkmaar,2,0,2,W
72658,3,HOL1,2004-04-11,Feyenoord Rotterdam,Ajax Amsterdam,1,1,0,D
72659,3,HOL1,2004-04-11,PSV Eindhoven,Groningen,5,0,5,W
72660,3,HOL1,2004-04-11,Roosendaal,Twente Enschede,1,2,-1,L
72661,3,HOL1,2004-04-11,Vitesse,NAC Breda,2,2,0,D
72662,3,HOL1,2004-04-16,Willem II,Vitesse,1,1,0,D
72663,3,HOL1,2004-04-17,ADO Den Haag,Twente Enschede,1,0,1,W
72664,3,HOL1,2004-04-17,PSV Eindhoven,NEC Nijmegen,3,0,3,W
72665,3,HOL1,2004-04-17,Waalwijk,Roda,1,1,0,D
72666,3,HOL1,2004-04-17,Zwolle,Heerenveen,1,0,1,W
72667,3,HOL1,2004-04-18,Ajax Amsterdam,Roosendaal,1,1,0,D
72668,3,HOL1,2004-04-18,Groningen,AZ Alkmaar,1,1,0,D
72669,3,HOL1,2004-04-18,Utrecht,Feyenoord Rotterdam,0,3,-3,L
72670,3,HOL1,2004-04-18,Volendam,NAC Breda,4,2,2,W
72671,3,HOL1,2004-04-23,Roda,Utrecht,1,1,0,D
72672,3,HOL1,2004-04-24,AZ Alkmaar,Waalwijk,7,0,7,W
72673,3,HOL1,2004-04-24,Heerenveen,Vitesse,0,0,0,D
72674,3,HOL1,2004-04-24,Roosendaal,PSV Eindhoven,0,3,-3,L
72675,3,HOL1,2004-04-24,Twente Enschede,Willem II,2,0,2,W
72676,3,HOL1,2004-04-25,Feyenoord Rotterdam,Volendam,2,0,2,W
72677,3,HOL1,2004-04-25,Groningen,Zwolle,2,2,0,D
72678,3,HOL1,2004-04-25,NAC Breda,ADO Den Haag,1,0,1,W
72679,3,HOL1,2004-04-25,NEC Nijmegen,Ajax Amsterdam,0,0,0,D
72680,3,HOL1,2004-05-01,AZ Alkmaar,NAC Breda,2,2,0,D
72681,3,HOL1,2004-05-01,ADO Den Haag,Heerenveen,1,0,1,W
72682,3,HOL1,2004-05-01,Twente Enschede,Roda,1,2,-1,L
72683,3,HOL1,2004-05-01,Willem II,Roosendaal,3,0,3,W
72684,3,HOL1,2004-05-02,Feyenoord Rotterdam,Groningen,1,2,-1,L
72685,3,HOL1,2004-05-02,Vitesse,NEC Nijmegen,2,2,0,D
72686,3,HOL1,2004-05-02,Volendam,PSV Eindhoven,0,5,-5,L
72687,3,HOL1,2004-05-02,Waalwijk,Utrecht,1,0,1,W
72688,3,HOL1,2004-05-02,Zwolle,Ajax Amsterdam,0,5,-5,L
72689,3,HOL1,2004-05-09,Ajax Amsterdam,NAC Breda,2,0,2,W
72690,3,HOL1,2004-05-09,Heerenveen,AZ Alkmaar,1,0,1,W
72691,3,HOL1,2004-05-09,NEC Nijmegen,Volendam,1,1,0,D
72692,3,HOL1,2004-05-09,PSV Eindhoven,ADO Den Haag,3,2,1,W
72693,3,HOL1,2004-05-09,Roda,Vitesse,2,0,2,W
72694,3,HOL1,2004-05-09,Roosendaal,Feyenoord Rotterdam,1,4,-3,L
72695,3,HOL1,2004-05-09,Utrecht,Groningen,2,0,2,W
72696,3,HOL1,2004-05-09,Waalwijk,Twente Enschede,3,3,0,D
72697,3,HOL1,2004-05-09,Zwolle,Willem II,0,0,0,D
72698,3,HOL1,2004-05-16,AZ Alkmaar,PSV Eindhoven,2,4,-2,L
72699,3,HOL1,2004-05-16,ADO Den Haag,NEC Nijmegen,4,1,3,W
72700,3,HOL1,2004-05-16,Feyenoord Rotterdam,Zwolle,7,1,6,W
72701,3,HOL1,2004-05-16,Groningen,Roda,2,2,0,D
72702,3,HOL1,2004-05-16,NAC Breda,Waalwijk,5,3,2,W
72703,3,HOL1,2004-05-16,Twente Enschede,Heerenveen,2,0,2,W
72704,3,HOL1,2004-05-16,Vitesse,Utrecht,3,0,3,W
72705,3,HOL1,2004-05-16,Volendam,Roosendaal,2,1,1,W
72706,3,HOL1,2004-05-16,Willem II,Ajax Amsterdam,2,5,-3,L
72707,4,HOL1,2004-08-13,Roda,Vitesse,2,3,-1,L
72708,4,HOL1,2004-08-14,AZ Alkmaar,Heerenveen,1,1,0,D
72709,4,HOL1,2004-08-14,NAC Breda,Utrecht,3,2,1,W
72710,4,HOL1,2004-08-14,NEC Nijmegen,Willem II,2,0,2,W
72711,4,HOL1,2004-08-14,Roosendaal,PSV Eindhoven,2,5,-3,L
72712,4,HOL1,2004-08-15,Den Bosch,ADO Den Haag,1,0,1,W
72713,4,HOL1,2004-08-15,Feyenoord Rotterdam,De Graafschap,6,1,5,W
72714,4,HOL1,2004-08-15,Groningen,Waalwijk,0,0,0,D
72715,4,HOL1,2004-08-15,Twente Enschede,Ajax Amsterdam,2,3,-1,L
72716,4,HOL1,2004-08-20,Vitesse,Groningen,1,0,1,W
72717,4,HOL1,2004-08-21,ADO Den Haag,NEC Nijmegen,1,2,-1,L
72718,4,HOL1,2004-08-21,Heerenveen,Roda,3,4,-1,L
72719,4,HOL1,2004-08-21,PSV Eindhoven,AZ Alkmaar,5,1,4,W
72720,4,HOL1,2004-08-21,Waalwijk,Twente Enschede,1,0,1,W
72721,4,HOL1,2004-08-22,Ajax Amsterdam,NAC Breda,6,2,4,W
72722,4,HOL1,2004-08-22,De Graafschap,Den Bosch,1,1,0,D
72723,4,HOL1,2004-08-22,Utrecht,Roosendaal,5,1,4,W
72724,4,HOL1,2004-08-22,Willem II,Feyenoord Rotterdam,0,4,-4,L
72725,4,HOL1,2004-08-27,Den Bosch,Willem II,1,2,-1,L
72726,4,HOL1,2004-08-28,NAC Breda,PSV Eindhoven,2,2,0,D
72727,4,HOL1,2004-08-28,NEC Nijmegen,AZ Alkmaar,1,2,-1,L
72728,4,HOL1,2004-08-28,Roda,De Graafschap,2,1,1,W
72729,4,HOL1,2004-08-28,Twente Enschede,Heerenveen,4,1,3,W
72730,4,HOL1,2004-08-29,Ajax Amsterdam,Utrecht,1,1,0,D
72731,4,HOL1,2004-08-29,Roosendaal,Groningen,2,2,0,D
72732,4,HOL1,2004-08-29,Vitesse,Feyenoord Rotterdam,1,1,0,D
72733,4,HOL1,2004-08-29,Waalwijk,ADO Den Haag,1,3,-2,L
72734,4,HOL1,2004-09-10,AZ Alkmaar,Den Bosch,5,0,5,W
72735,4,HOL1,2004-09-11,Heerenveen,De Graafschap,2,0,2,W
72736,4,HOL1,2004-09-11,PSV Eindhoven,Waalwijk,1,0,1,W
72737,4,HOL1,2004-09-11,Roosendaal,Vitesse,4,1,3,W
72738,4,HOL1,2004-09-11,Willem II,Roda,3,1,2,W
72739,4,HOL1,2004-09-12,ADO Den Haag,Ajax Amsterdam,3,3,0,D
72740,4,HOL1,2004-09-12,Feyenoord Rotterdam,Twente Enschede,3,1,2,W
72741,4,HOL1,2004-09-12,Groningen,NAC Breda,2,3,-1,L
72742,4,HOL1,2004-09-12,Utrecht,NEC Nijmegen,1,0,1,W
72743,4,HOL1,2004-09-17,ADO Den Haag,Vitesse,0,4,-4,L
72744,4,HOL1,2004-09-18,De Graafschap,Groningen,2,2,0,D
72745,4,HOL1,2004-09-18,Heerenveen,NAC Breda,3,0,3,W
72746,4,HOL1,2004-09-18,NEC Nijmegen,PSV Eindhoven,0,3,-3,L
72747,4,HOL1,2004-09-18,Twente Enschede,Willem II,0,0,0,D
72748,4,HOL1,2004-09-18,Waalwijk,Roosendaal,2,0,2,W
72749,4,HOL1,2004-09-19,Den Bosch,Ajax Amsterdam,0,5,-5,L
72750,4,HOL1,2004-09-19,Feyenoord Rotterdam,Utrecht,0,3,-3,L
72751,4,HOL1,2004-09-19,Roda,AZ Alkmaar,1,1,0,D
72752,4,HOL1,2004-09-25,Ajax Amsterdam,Roda,1,0,1,W
72753,4,HOL1,2004-09-25,AZ Alkmaar,Willem II,3,1,2,W
72754,4,HOL1,2004-09-25,PSV Eindhoven,Heerenveen,4,0,4,W
72755,4,HOL1,2004-09-25,Roosendaal,Feyenoord Rotterdam,0,4,-4,L
72756,4,HOL1,2004-09-25,Vitesse,Den Bosch,0,0,0,D
72757,4,HOL1,2004-09-26,De Graafschap,Twente Enschede,0,0,0,D
72758,4,HOL1,2004-09-26,Groningen,NEC Nijmegen,0,0,0,D
72759,4,HOL1,2004-09-26,NAC Breda,Waalwijk,0,4,-4,L
72760,4,HOL1,2004-09-26,Utrecht,ADO Den Haag,2,0,2,W
72761,4,HOL1,2004-10-01,NEC Nijmegen,Roosendaal,3,0,3,W
72762,4,HOL1,2004-10-02,NAC Breda,De Graafschap,3,2,1,W
72763,4,HOL1,2004-10-02,PSV Eindhoven,Groningen,3,0,3,W
72764,4,HOL1,2004-10-02,Twente Enschede,Roda,2,3,-1,L
72765,4,HOL1,2004-10-02,Willem II,Vitesse,3,2,1,W
72766,4,HOL1,2004-10-03,AZ Alkmaar,Ajax Amsterdam,0,0,0,D
72767,4,HOL1,2004-10-03,Feyenoord Rotterdam,Den Bosch,4,2,2,W
72768,4,HOL1,2004-10-03,Heerenveen,ADO Den Haag,1,0,1,W
72769,4,HOL1,2004-10-03,Utrecht,Waalwijk,3,2,1,W
72770,4,HOL1,2004-10-15,De Graafschap,AZ Alkmaar,1,3,-2,L
72771,4,HOL1,2004-10-16,Ajax Amsterdam,Heerenveen,1,3,-2,L
72772,4,HOL1,2004-10-16,Den Bosch,Roosendaal,2,1,1,W
72773,4,HOL1,2004-10-16,ADO Den Haag,PSV Eindhoven,0,2,-2,L
72774,4,HOL1,2004-10-17,Groningen,Utrecht,3,0,3,W
72775,4,HOL1,2004-10-17,Roda,Feyenoord Rotterdam,0,2,-2,L
72776,4,HOL1,2004-10-17,Vitesse,NAC Breda,1,2,-1,L
72777,4,HOL1,2004-10-17,Waalwijk,NEC Nijmegen,2,2,0,D
72778,4,HOL1,2004-10-22,Willem II,Groningen,4,2,2,W
72779,4,HOL1,2004-10-23,NEC Nijmegen,NAC Breda,3,3,0,D
72780,4,HOL1,2004-10-23,Roosendaal,Twente Enschede,0,1,-1,L
72781,4,HOL1,2004-10-23,Vitesse,AZ Alkmaar,0,3,-3,L
72782,4,HOL1,2004-10-24,Feyenoord Rotterdam,Waalwijk,4,0,4,W
72783,4,HOL1,2004-10-24,De Graafschap,ADO Den Haag,1,2,-1,L
72784,4,HOL1,2004-10-24,Heerenveen,Utrecht,2,1,1,W
72785,4,HOL1,2004-10-24,PSV Eindhoven,Ajax Amsterdam,2,0,2,W
72786,4,HOL1,2004-10-24,Roda,Den Bosch,5,0,5,W
72787,4,HOL1,2004-10-27,ADO Den Haag,Twente Enschede,0,1,-1,L
72788,4,HOL1,2004-10-27,De Graafschap,Willem II,2,2,0,D
72789,4,HOL1,2004-10-27,NAC Breda,Roda,4,0,4,W
72790,4,HOL1,2004-10-29,Utrecht,PSV Eindhoven,0,0,0,D
72791,4,HOL1,2004-10-30,Roda,Waalwijk,1,1,0,D
72792,4,HOL1,2004-10-30,Twente Enschede,Vitesse,1,4,-3,L
72793,4,HOL1,2004-10-30,Willem II,Roosendaal,3,0,3,W
72794,4,HOL1,2004-10-31,Ajax Amsterdam,NEC Nijmegen,1,0,1,W
72795,4,HOL1,2004-10-31,AZ Alkmaar,Feyenoord Rotterdam,4,1,3,W
72796,4,HOL1,2004-10-31,Den Bosch,Heerenveen,2,4,-2,L
72797,4,HOL1,2004-10-31,Groningen,ADO Den Haag,4,3,1,W
72798,4,HOL1,2004-11-05,Roosendaal,De Graafschap,3,0,3,W
72799,4,HOL1,2004-11-06,Waalwijk,Heerenveen,0,0,0,D
72800,4,HOL1,2004-11-07,AZ Alkmaar,Utrecht,4,0,4,W
72801,4,HOL1,2004-11-07,Den Bosch,PSV Eindhoven,0,3,-3,L
72802,4,HOL1,2004-11-07,Feyenoord Rotterdam,NAC Breda,4,0,4,W
72803,4,HOL1,2004-11-07,Twente Enschede,Groningen,1,2,-1,L
72804,4,HOL1,2004-11-07,Vitesse,NEC Nijmegen,1,0,1,W
72805,4,HOL1,2004-11-07,Willem II,Ajax Amsterdam,1,3,-2,L
72806,4,HOL1,2004-11-12,ADO Den Haag,Roosendaal,5,1,4,W
72807,4,HOL1,2004-11-13,Heerenveen,Vitesse,0,3,-3,L
72808,4,HOL1,2004-11-13,NAC Breda,AZ Alkmaar,0,3,-3,L
72809,4,HOL1,2004-11-13,NEC Nijmegen,Twente Enschede,0,2,-2,L
72810,4,HOL1,2004-11-13,PSV Eindhoven,Willem II,1,0,1,W
72811,4,HOL1,2004-11-14,Ajax Amsterdam,Feyenoord Rotterdam,1,1,0,D
72812,4,HOL1,2004-11-14,Groningen,Den Bosch,3,1,2,W
72813,4,HOL1,2004-11-14,Utrecht,Roda,1,1,0,D
72814,4,HOL1,2004-11-14,Waalwijk,De Graafschap,2,2,0,D
72815,4,HOL1,2004-11-19,Roda,ADO Den Haag,1,1,0,D
72816,4,HOL1,2004-11-20,AZ Alkmaar,Waalwijk,3,0,3,W
72817,4,HOL1,2004-11-20,De Graafschap,Ajax Amsterdam,0,5,-5,L
72818,4,HOL1,2004-11-20,Roosendaal,Heerenveen,1,3,-2,L
72819,4,HOL1,2004-11-21,Den Bosch,NEC Nijmegen,0,0,0,D
72820,4,HOL1,2004-11-21,Feyenoord Rotterdam,Groningen,1,2,-1,L
72821,4,HOL1,2004-11-21,Twente Enschede,Utrecht,0,1,-1,L
72822,4,HOL1,2004-11-21,Vitesse,PSV Eindhoven,0,2,-2,L
72823,4,HOL1,2004-11-21,Willem II,NAC Breda,0,1,-1,L
72824,4,HOL1,2004-11-26,Waalwijk,Vitesse,2,2,0,D
72825,4,HOL1,2004-11-27,ADO Den Haag,Willem II,0,1,-1,L
72826,4,HOL1,2004-11-27,NEC Nijmegen,Roda,1,1,0,D
72827,4,HOL1,2004-11-27,PSV Eindhoven,Twente Enschede,2,0,2,W
72828,4,HOL1,2004-11-28,Ajax Amsterdam,Roosendaal,4,1,3,W
72829,4,HOL1,2004-11-28,Groningen,AZ Alkmaar,1,2,-1,L
72830,4,HOL1,2004-11-28,Heerenveen,Feyenoord Rotterdam,2,2,0,D
72831,4,HOL1,2004-11-28,NAC Breda,Den Bosch,3,0,3,W
72832,4,HOL1,2004-11-28,Utrecht,De Graafschap,1,0,1,W
72833,4,HOL1,2004-12-03,Waalwijk,Ajax Amsterdam,1,2,-1,L
72834,4,HOL1,2004-12-04,De Graafschap,PSV Eindhoven,0,4,-4,L
72835,4,HOL1,2004-12-04,Roda,Groningen,5,1,4,W
72836,4,HOL1,2004-12-04,Roosendaal,NAC Breda,0,0,0,D
72837,4,HOL1,2004-12-04,Twente Enschede,Den Bosch,4,0,4,W
72838,4,HOL1,2004-12-05,AZ Alkmaar,ADO Den Haag,2,0,2,W
72839,4,HOL1,2004-12-05,Feyenoord Rotterdam,NEC Nijmegen,2,1,1,W
72840,4,HOL1,2004-12-05,Vitesse,Utrecht,2,1,1,W
72841,4,HOL1,2004-12-05,Willem II,Heerenveen,2,2,0,D
72842,4,HOL1,2004-12-10,Heerenveen,Groningen,1,0,1,W
72843,4,HOL1,2004-12-11,AZ Alkmaar,Twente Enschede,5,0,5,W
72844,4,HOL1,2004-12-11,Den Bosch,Waalwijk,0,2,-2,L
72845,4,HOL1,2004-12-11,Roda,Roosendaal,3,1,2,W
72846,4,HOL1,2004-12-11,Willem II,Utrecht,0,0,0,D
72847,4,HOL1,2004-12-12,Ajax Amsterdam,Vitesse,1,0,1,W
72848,4,HOL1,2004-12-12,Feyenoord Rotterdam,PSV Eindhoven,3,3,0,D
72849,4,HOL1,2004-12-12,De Graafschap,NEC Nijmegen,3,2,1,W
72850,4,HOL1,2004-12-12,NAC Breda,ADO Den Haag,1,1,0,D
72851,4,HOL1,2004-12-16,Vitesse,De Graafschap,3,1,2,W
72852,4,HOL1,2004-12-17,Twente Enschede,NAC Breda,0,0,0,D
72853,4,HOL1,2004-12-18,PSV Eindhoven,Roda,0,2,-2,L
72854,4,HOL1,2004-12-18,Roosendaal,AZ Alkmaar,0,2,-2,L
72855,4,HOL1,2004-12-18,Waalwijk,Willem II,1,0,1,W
72856,4,HOL1,2004-12-19,ADO Den Haag,Feyenoord Rotterdam,2,0,2,W
72857,4,HOL1,2004-12-19,Groningen,Ajax Amsterdam,0,4,-4,L
72858,4,HOL1,2004-12-19,NEC Nijmegen,Heerenveen,3,2,1,W
72859,4,HOL1,2004-12-19,Utrecht,Den Bosch,1,0,1,W
72860,4,HOL1,2005-01-21,AZ Alkmaar,NEC Nijmegen,1,1,0,D
72861,4,HOL1,2005-01-22,De Graafschap,Roda,2,0,2,W
72862,4,HOL1,2005-01-22,Heerenveen,Den Bosch,2,1,1,W
72863,4,HOL1,2005-01-22,PSV Eindhoven,NAC Breda,4,0,4,W
72864,4,HOL1,2005-01-22,Willem II,Twente Enschede,0,3,-3,L
72865,4,HOL1,2005-01-23,ADO Den Haag,Groningen,0,3,-3,L
72866,4,HOL1,2005-01-23,Feyenoord Rotterdam,Vitesse,1,2,-1,L
72867,4,HOL1,2005-01-23,Roosendaal,Waalwijk,0,1,-1,L
72868,4,HOL1,2005-01-23,Utrecht,Ajax Amsterdam,0,2,-2,L
72869,4,HOL1,2005-01-28,Roda,Willem II,4,0,4,W
72870,4,HOL1,2005-01-29,Den Bosch,AZ Alkmaar,0,1,-1,L
72871,4,HOL1,2005-01-29,Twente Enschede,Feyenoord Rotterdam,0,0,0,D
72872,4,HOL1,2005-01-29,Vitesse,Roosendaal,1,3,-2,L
72873,4,HOL1,2005-01-30,Ajax Amsterdam,ADO Den Haag,0,0,0,D
72874,4,HOL1,2005-01-30,Groningen,De Graafschap,1,0,1,W
72875,4,HOL1,2005-01-30,NAC Breda,Heerenveen,1,1,0,D
72876,4,HOL1,2005-01-30,NEC Nijmegen,Utrecht,0,0,0,D
72877,4,HOL1,2005-01-30,Waalwijk,PSV Eindhoven,1,4,-3,L
72878,4,HOL1,2005-02-02,PSV Eindhoven,Roosendaal,4,1,3,W
72879,4,HOL1,2005-02-04,De Graafschap,Feyenoord Rotterdam,2,7,-5,L
72880,4,HOL1,2005-02-04,Willem II,NEC Nijmegen,3,1,2,W
72881,4,HOL1,2005-02-05,ADO Den Haag,Den Bosch,2,0,2,W
72882,4,HOL1,2005-02-05,Heerenveen,AZ Alkmaar,1,3,-2,L
72883,4,HOL1,2005-02-06,Ajax Amsterdam,Twente Enschede,1,2,-1,L
72884,4,HOL1,2005-02-06,Utrecht,NAC Breda,2,0,2,W
72885,4,HOL1,2005-02-06,Vitesse,Roda,3,0,3,W
72886,4,HOL1,2005-02-06,Waalwijk,Groningen,3,0,3,W
72887,4,HOL1,2005-02-11,Groningen,Vitesse,0,0,0,D
72888,4,HOL1,2005-02-12,AZ Alkmaar,PSV Eindhoven,0,0,0,D
72889,4,HOL1,2005-02-12,Roda,Heerenveen,2,3,-1,L
72890,4,HOL1,2005-02-12,Roosendaal,Utrecht,0,1,-1,L
72891,4,HOL1,2005-02-12,Twente Enschede,Waalwijk,3,1,2,W
72892,4,HOL1,2005-02-13,Den Bosch,De Graafschap,0,2,-2,L
72893,4,HOL1,2005-02-13,Feyenoord Rotterdam,Willem II,7,0,7,W
72894,4,HOL1,2005-02-13,NAC Breda,Ajax Amsterdam,1,2,-1,L
72895,4,HOL1,2005-02-13,NEC Nijmegen,ADO Den Haag,1,1,0,D
72896,4,HOL1,2005-02-18,Roosendaal,Willem II,2,0,2,W
72897,4,HOL1,2005-02-19,PSV Eindhoven,NEC Nijmegen,4,1,3,W
72898,4,HOL1,2005-02-20,Ajax Amsterdam,Den Bosch,2,0,2,W
72899,4,HOL1,2005-02-20,AZ Alkmaar,Roda,1,1,0,D
72900,4,HOL1,2005-02-20,De Graafschap,Heerenveen,2,1,1,W
72901,4,HOL1,2005-02-20,Groningen,Twente Enschede,0,1,-1,L
72902,4,HOL1,2005-02-20,Utrecht,Feyenoord Rotterdam,0,2,-2,L
72903,4,HOL1,2005-02-20,Vitesse,ADO Den Haag,3,4,-1,L
72904,4,HOL1,2005-02-20,Waalwijk,NAC Breda,1,0,1,W
72905,4,HOL1,2005-02-25,NEC Nijmegen,Waalwijk,1,0,1,W
72906,4,HOL1,2005-02-26,NAC Breda,Groningen,1,4,-3,L
72907,4,HOL1,2005-02-26,Twente Enschede,De Graafschap,0,0,0,D
72908,4,HOL1,2005-02-27,Den Bosch,Vitesse,1,2,-1,L
72909,4,HOL1,2005-02-27,ADO Den Haag,Utrecht,1,0,1,W
72910,4,HOL1,2005-02-27,Feyenoord Rotterdam,Roosendaal,3,0,3,W
72911,4,HOL1,2005-02-27,Heerenveen,PSV Eindhoven,0,3,-3,L
72912,4,HOL1,2005-02-27,Roda,Ajax Amsterdam,1,2,-1,L
72913,4,HOL1,2005-02-27,Willem II,AZ Alkmaar,1,3,-2,L
72914,4,HOL1,2005-03-04,Roosendaal,NEC Nijmegen,1,0,1,W
72915,4,HOL1,2005-03-05,Vitesse,Willem II,2,0,2,W
72916,4,HOL1,2005-03-05,Waalwijk,Utrecht,2,2,0,D
72917,4,HOL1,2005-03-06,De Graafschap,NAC Breda,0,2,-2,L
72918,4,HOL1,2005-03-06,Roda,Twente Enschede,1,2,-1,L
72919,4,HOL1,2005-03-11,Twente Enschede,Roosendaal,3,0,3,W
72920,4,HOL1,2005-03-12,Heerenveen,Waalwijk,1,2,-1,L
72921,4,HOL1,2005-03-12,NAC Breda,Vitesse,1,2,-1,L
72922,4,HOL1,2005-03-12,Willem II,Den Bosch,2,1,1,W
72923,4,HOL1,2005-03-13,AZ Alkmaar,De Graafschap,3,2,1,W
72924,4,HOL1,2005-03-13,Feyenoord Rotterdam,Roda,4,1,3,W
72925,4,HOL1,2005-03-13,NEC Nijmegen,Ajax Amsterdam,0,1,-1,L
72926,4,HOL1,2005-03-13,PSV Eindhoven,ADO Den Haag,4,0,4,W
72927,4,HOL1,2005-03-13,Utrecht,Groningen,1,2,-1,L
72928,4,HOL1,2005-03-16,ADO Den Haag,Heerenveen,0,2,-2,L
72929,4,HOL1,2005-03-17,Groningen,PSV Eindhoven,0,1,-1,L
72930,4,HOL1,2005-03-18,Den Bosch,Roda,0,3,-3,L
72931,4,HOL1,2005-03-19,AZ Alkmaar,Vitesse,3,0,3,W
72932,4,HOL1,2005-03-19,De Graafschap,Roosendaal,0,1,-1,L
72933,4,HOL1,2005-03-19,NAC Breda,NEC Nijmegen,1,2,-1,L
72934,4,HOL1,2005-03-19,Waalwijk,Feyenoord Rotterdam,2,4,-2,L
72935,4,HOL1,2005-03-20,Ajax Amsterdam,PSV Eindhoven,0,4,-4,L
72936,4,HOL1,2005-03-20,Groningen,Willem II,1,1,0,D
72937,4,HOL1,2005-03-20,Twente Enschede,ADO Den Haag,2,1,1,W
72938,4,HOL1,2005-03-20,Utrecht,Heerenveen,0,1,-1,L
72939,4,HOL1,2005-04-01,Vitesse,Twente Enschede,1,1,0,D
72940,4,HOL1,2005-04-02,ADO Den Haag,Waalwijk,0,0,0,D
72941,4,HOL1,2005-04-02,Heerenveen,Ajax Amsterdam,2,1,1,W
72942,4,HOL1,2005-04-02,PSV Eindhoven,Utrecht,2,0,2,W
72943,4,HOL1,2005-04-02,Willem II,De Graafschap,4,1,3,W
72944,4,HOL1,2005-04-03,Feyenoord Rotterdam,AZ Alkmaar,4,2,2,W
72945,4,HOL1,2005-04-03,NEC Nijmegen,Groningen,4,3,1,W
72946,4,HOL1,2005-04-03,Roda,NAC Breda,2,1,1,W
72947,4,HOL1,2005-04-03,Roosendaal,Den Bosch,1,2,-1,L
72948,4,HOL1,2005-04-07,Ajax Amsterdam,Willem II,2,0,2,W
72949,4,HOL1,2005-04-08,ADO Den Haag,De Graafschap,2,0,2,W
72950,4,HOL1,2005-04-09,Groningen,Roosendaal,3,0,3,W
72951,4,HOL1,2005-04-09,Heerenveen,Twente Enschede,1,2,-1,L
72952,4,HOL1,2005-04-09,PSV Eindhoven,Den Bosch,3,0,3,W
72953,4,HOL1,2005-04-10,Ajax Amsterdam,AZ Alkmaar,4,2,2,W
72954,4,HOL1,2005-04-10,NAC Breda,Feyenoord Rotterdam,0,2,-2,L
72955,4,HOL1,2005-04-10,NEC Nijmegen,Vitesse,1,1,0,D
72956,4,HOL1,2005-04-10,Waalwijk,Roda,1,0,1,W
72957,4,HOL1,2005-04-13,Den Bosch,Feyenoord Rotterdam,4,1,3,W
72958,4,HOL1,2005-04-15,Roda,Utrecht,3,2,1,W
72959,4,HOL1,2005-04-16,De Graafschap,Waalwijk,2,4,-2,L
72960,4,HOL1,2005-04-16,Roosendaal,ADO Den Haag,2,0,2,W
72961,4,HOL1,2005-04-16,Vitesse,Heerenveen,1,3,-2,L
72962,4,HOL1,2005-04-17,AZ Alkmaar,NAC Breda,1,1,0,D
72963,4,HOL1,2005-04-17,Den Bosch,Groningen,1,2,-1,L
72964,4,HOL1,2005-04-17,Feyenoord Rotterdam,Ajax Amsterdam,2,3,-1,L
72965,4,HOL1,2005-04-17,Twente Enschede,NEC Nijmegen,2,1,1,W
72966,4,HOL1,2005-04-17,Willem II,PSV Eindhoven,0,1,-1,L
72967,4,HOL1,2005-04-20,Utrecht,AZ Alkmaar,3,2,1,W
72968,4,HOL1,2005-04-22,Heerenveen,Roosendaal,7,1,6,W
72969,4,HOL1,2005-04-23,ADO Den Haag,Roda,1,4,-3,L
72970,4,HOL1,2005-04-23,PSV Eindhoven,Vitesse,3,0,3,W
72971,4,HOL1,2005-04-23,Waalwijk,AZ Alkmaar,2,1,1,W
72972,4,HOL1,2005-04-24,Ajax Amsterdam,De Graafschap,1,0,1,W
72973,4,HOL1,2005-04-24,Groningen,Feyenoord Rotterdam,0,2,-2,L
72974,4,HOL1,2005-04-24,NAC Breda,Willem II,1,2,-1,L
72975,4,HOL1,2005-04-24,NEC Nijmegen,Den Bosch,2,2,0,D
72976,4,HOL1,2005-04-24,Utrecht,Twente Enschede,2,2,0,D
72977,4,HOL1,2005-04-29,Roda,NEC Nijmegen,1,0,1,W
72978,4,HOL1,2005-04-29,Twente Enschede,PSV Eindhoven,2,2,0,D
72979,4,HOL1,2005-04-30,Roosendaal,Ajax Amsterdam,1,4,-3,L
72980,4,HOL1,2005-05-01,AZ Alkmaar,Groningen,2,1,1,W
72981,4,HOL1,2005-05-01,Den Bosch,NAC Breda,0,2,-2,L
72982,4,HOL1,2005-05-01,Feyenoord Rotterdam,Heerenveen,1,3,-2,L
72983,4,HOL1,2005-05-01,De Graafschap,Utrecht,0,0,0,D
72984,4,HOL1,2005-05-01,Vitesse,Waalwijk,3,1,2,W
72985,4,HOL1,2005-05-01,Willem II,ADO Den Haag,1,0,1,W
72986,4,HOL1,2005-05-06,NAC Breda,Roosendaal,1,2,-1,L
72987,4,HOL1,2005-05-07,Ajax Amsterdam,Waalwijk,4,0,4,W
72988,4,HOL1,2005-05-07,Den Bosch,Twente Enschede,1,0,1,W
72989,4,HOL1,2005-05-07,Heerenveen,Willem II,2,2,0,D
72990,4,HOL1,2005-05-08,ADO Den Haag,AZ Alkmaar,2,1,1,W
72991,4,HOL1,2005-05-08,Groningen,Roda,4,4,0,D
72992,4,HOL1,2005-05-08,NEC Nijmegen,Feyenoord Rotterdam,2,0,2,W
72993,4,HOL1,2005-05-08,PSV Eindhoven,De Graafschap,4,1,3,W
72994,4,HOL1,2005-05-08,Utrecht,Vitesse,1,2,-1,L
72995,4,HOL1,2005-05-15,ADO Den Haag,NAC Breda,6,2,4,W
72996,4,HOL1,2005-05-15,Groningen,Heerenveen,1,2,-1,L
72997,4,HOL1,2005-05-15,NEC Nijmegen,De Graafschap,3,0,3,W
72998,4,HOL1,2005-05-15,PSV Eindhoven,Feyenoord Rotterdam,4,2,2,W
72999,4,HOL1,2005-05-15,Roosendaal,Roda,3,1,2,W
73000,4,HOL1,2005-05-15,Twente Enschede,AZ Alkmaar,3,0,3,W
73001,4,HOL1,2005-05-15,Utrecht,Willem II,0,3,-3,L
73002,4,HOL1,2005-05-15,Vitesse,Ajax Amsterdam,0,2,-2,L
73003,4,HOL1,2005-05-15,Waalwijk,Den Bosch,2,0,2,W
73004,4,HOL1,2005-05-22,Ajax Amsterdam,Groningen,2,1,1,W
73005,4,HOL1,2005-05-22,AZ Alkmaar,Roosendaal,1,3,-2,L
73006,4,HOL1,2005-05-22,Den Bosch,Utrecht,0,3,-3,L
73007,4,HOL1,2005-05-22,Feyenoord Rotterdam,ADO Den Haag,6,3,3,W
73008,4,HOL1,2005-05-22,De Graafschap,Vitesse,1,2,-1,L
73009,4,HOL1,2005-05-22,Heerenveen,NEC Nijmegen,2,1,1,W
73010,4,HOL1,2005-05-22,NAC Breda,Twente Enschede,1,1,0,D
73011,4,HOL1,2005-05-22,Roda,PSV Eindhoven,0,0,0,D
73012,4,HOL1,2005-05-22,Willem II,Waalwijk,3,0,3,W
73013,5,HOL1,2005-08-12,AZ Alkmaar,Sparta Rotterdam,3,0,3,W
73014,5,HOL1,2005-08-13,Heracles,PSV Eindhoven,1,1,0,D
73015,5,HOL1,2005-08-13,Roda,Twente Enschede,2,0,2,W
73016,5,HOL1,2005-08-13,Vitesse,Heerenveen,2,2,0,D
73017,5,HOL1,2005-08-13,Willem II,Waalwijk,1,2,-1,L
73018,5,HOL1,2005-08-14,Feyenoord Rotterdam,NAC Breda,2,0,2,W
73019,5,HOL1,2005-08-14,Groningen,Roosendaal,1,0,1,W
73020,5,HOL1,2005-08-14,NEC Nijmegen,Utrecht,0,0,0,D
73021,5,HOL1,2005-08-19,NAC Breda,Willem II,1,0,1,W
73022,5,HOL1,2005-08-20,ADO Den Haag,Heracles,1,2,-1,L
73023,5,HOL1,2005-08-20,Heerenveen,Roda,5,4,1,W
73024,5,HOL1,2005-08-20,Roosendaal,Ajax Amsterdam,0,2,-2,L
73025,5,HOL1,2005-08-20,Twente Enschede,NEC Nijmegen,0,1,-1,L
73026,5,HOL1,2005-08-21,PSV Eindhoven,Vitesse,2,1,1,W
73027,5,HOL1,2005-08-21,Sparta Rotterdam,Feyenoord Rotterdam,1,3,-2,L
73028,5,HOL1,2005-08-21,Utrecht,AZ Alkmaar,1,2,-1,L
73029,5,HOL1,2005-08-21,Waalwijk,Groningen,2,1,1,W
73030,5,HOL1,2005-08-26,ADO Den Haag,Heerenveen,1,0,1,W
73031,5,HOL1,2005-08-27,NEC Nijmegen,Waalwijk,1,3,-2,L
73032,5,HOL1,2005-08-27,Sparta Rotterdam,NAC Breda,1,0,1,W
73033,5,HOL1,2005-08-27,Vitesse,AZ Alkmaar,0,5,-5,L
73034,5,HOL1,2005-08-28,Ajax Amsterdam,Feyenoord Rotterdam,1,2,-1,L
73035,5,HOL1,2005-08-28,Heracles,Groningen,2,1,1,W
73036,5,HOL1,2005-08-28,Roda,PSV Eindhoven,0,3,-3,L
73037,5,HOL1,2005-08-28,Roosendaal,Willem II,1,1,0,D
73038,5,HOL1,2005-08-28,Utrecht,Twente Enschede,1,3,-2,L
73039,5,HOL1,2005-09-09,Waalwijk,Roda,2,0,2,W
73040,5,HOL1,2005-09-10,AZ Alkmaar,Roosendaal,7,0,7,W
73041,5,HOL1,2005-09-10,Heerenveen,Heracles,1,2,-1,L
73042,5,HOL1,2005-09-10,PSV Eindhoven,Utrecht,1,0,1,W
73043,5,HOL1,2005-09-10,Willem II,Ajax Amsterdam,0,2,-2,L
73044,5,HOL1,2005-09-11,Feyenoord Rotterdam,NEC Nijmegen,3,0,3,W
73045,5,HOL1,2005-09-11,Groningen,Sparta Rotterdam,0,1,-1,L
73046,5,HOL1,2005-09-11,NAC Breda,ADO Den Haag,4,1,3,W
73047,5,HOL1,2005-09-11,Twente Enschede,Vitesse,0,1,-1,L
73048,5,HOL1,2005-09-16,ADO Den Haag,Twente Enschede,0,0,0,D
73049,5,HOL1,2005-09-17,Heracles,Waalwijk,0,2,-2,L
73050,5,HOL1,2005-09-17,NEC Nijmegen,NAC Breda,1,1,0,D
73051,5,HOL1,2005-09-17,Roosendaal,Sparta Rotterdam,1,1,0,D
73052,5,HOL1,2005-09-18,AZ Alkmaar,Ajax Amsterdam,4,2,2,W
73053,5,HOL1,2005-09-18,Feyenoord Rotterdam,Heerenveen,5,1,4,W
73054,5,HOL1,2005-09-18,Groningen,PSV Eindhoven,1,0,1,W
73055,5,HOL1,2005-09-18,Roda,Willem II,0,2,-2,L
73056,5,HOL1,2005-09-18,Utrecht,Vitesse,1,0,1,W
73057,5,HOL1,2005-09-21,Ajax Amsterdam,ADO Den Haag,2,2,0,D
73058,5,HOL1,2005-09-23,Heerenveen,NEC Nijmegen,2,1,1,W
73059,5,HOL1,2005-09-24,Ajax Amsterdam,Roda,4,1,3,W
73060,5,HOL1,2005-09-24,PSV Eindhoven,Roosendaal,2,0,2,W
73061,5,HOL1,2005-09-24,Vitesse,Groningen,2,0,2,W
73062,5,HOL1,2005-09-24,Waalwijk,Utrecht,2,3,-1,L
73063,5,HOL1,2005-09-24,Willem II,ADO Den Haag,1,0,1,W
73064,5,HOL1,2005-09-25,NAC Breda,AZ Alkmaar,2,1,1,W
73065,5,HOL1,2005-09-25,Sparta Rotterdam,Heracles,2,0,2,W
73066,5,HOL1,2005-09-25,Twente Enschede,Feyenoord Rotterdam,1,3,-2,L
73067,5,HOL1,2005-09-30,Roosendaal,NAC Breda,1,2,-1,L
73068,5,HOL1,2005-10-01,ADO Den Haag,Waalwijk,2,1,1,W
73069,5,HOL1,2005-10-01,Roda,Vitesse,3,2,1,W
73070,5,HOL1,2005-10-02,AZ Alkmaar,NEC Nijmegen,3,2,1,W
73071,5,HOL1,2005-10-02,Groningen,Willem II,2,0,2,W
73072,5,HOL1,2005-10-02,Heerenveen,PSV Eindhoven,2,3,-1,L
73073,5,HOL1,2005-10-02,Heracles,Twente Enschede,0,4,-4,L
73074,5,HOL1,2005-10-02,Sparta Rotterdam,Ajax Amsterdam,1,2,-1,L
73075,5,HOL1,2005-10-02,Utrecht,Feyenoord Rotterdam,3,1,2,W
73076,5,HOL1,2005-10-14,Willem II,Sparta Rotterdam,0,0,0,D
73077,5,HOL1,2005-10-15,Ajax Amsterdam,Heracles,0,0,0,D
73078,5,HOL1,2005-10-15,NAC Breda,Heerenveen,0,3,-3,L
73079,5,HOL1,2005-10-15,PSV Eindhoven,AZ Alkmaar,3,0,3,W
73080,5,HOL1,2005-10-15,Twente Enschede,Waalwijk,2,0,2,W
73081,5,HOL1,2005-10-16,Feyenoord Rotterdam,Groningen,4,1,3,W
73082,5,HOL1,2005-10-16,NEC Nijmegen,Roosendaal,3,1,2,W
73083,5,HOL1,2005-10-16,Roda,Utrecht,2,1,1,W
73084,5,HOL1,2005-10-16,Vitesse,ADO Den Haag,3,1,2,W
73085,5,HOL1,2005-10-21,Heracles,NEC Nijmegen,0,2,-2,L
73086,5,HOL1,2005-10-22,NAC Breda,Twente Enschede,1,1,0,D
73087,5,HOL1,2005-10-22,Roosendaal,Vitesse,0,3,-3,L
73088,5,HOL1,2005-10-22,Sparta Rotterdam,Roda,2,3,-1,L
73089,5,HOL1,2005-10-23,AZ Alkmaar,Willem II,5,1,4,W
73090,5,HOL1,2005-10-23,Groningen,ADO Den Haag,3,1,2,W
73091,5,HOL1,2005-10-23,Heerenveen,Utrecht,1,1,0,D
73092,5,HOL1,2005-10-23,PSV Eindhoven,Ajax Amsterdam,1,0,1,W
73093,5,HOL1,2005-10-23,Waalwijk,Feyenoord Rotterdam,2,1,1,W
73094,5,HOL1,2005-10-28,Ajax Amsterdam,Heerenveen,0,0,0,D
73095,5,HOL1,2005-10-29,ADO Den Haag,AZ Alkmaar,0,2,-2,L
73096,5,HOL1,2005-10-29,Twente Enschede,PSV Eindhoven,0,1,-1,L
73097,5,HOL1,2005-10-29,Vitesse,Heracles,5,1,4,W
73098,5,HOL1,2005-10-29,Waalwijk,NAC Breda,4,1,3,W
73099,5,HOL1,2005-10-30,Groningen,Roda,1,0,1,W
73100,5,HOL1,2005-10-30,NEC Nijmegen,Sparta Rotterdam,0,0,0,D
73101,5,HOL1,2005-10-30,Utrecht,Roosendaal,4,1,3,W
73102,5,HOL1,2005-10-30,Willem II,Feyenoord Rotterdam,1,3,-2,L
73103,5,HOL1,2005-11-04,Roosendaal,Waalwijk,1,1,0,D
73104,5,HOL1,2005-11-05,AZ Alkmaar,Heracles,2,2,0,D
73105,5,HOL1,2005-11-05,PSV Eindhoven,Sparta Rotterdam,3,0,3,W
73106,5,HOL1,2005-11-05,Roda,NAC Breda,3,3,0,D
73107,5,HOL1,2005-11-05,Twente Enschede,Willem II,3,1,2,W
73108,5,HOL1,2005-11-06,Feyenoord Rotterdam,Vitesse,0,0,0,D
73109,5,HOL1,2005-11-06,Heerenveen,Groningen,4,0,4,W
73110,5,HOL1,2005-11-06,NEC Nijmegen,Ajax Amsterdam,1,0,1,W
73111,5,HOL1,2005-11-06,Utrecht,ADO Den Haag,1,1,0,D
73112,5,HOL1,2005-11-18,Willem II,Vitesse,3,4,-1,L
73113,5,HOL1,2005-11-19,Ajax Amsterdam,Twente Enschede,2,0,2,W
73114,5,HOL1,2005-11-19,ADO Den Haag,NEC Nijmegen,0,1,-1,L
73115,5,HOL1,2005-11-19,NAC Breda,Utrecht,0,1,-1,L
73116,5,HOL1,2005-11-19,Waalwijk,PSV Eindhoven,4,4,0,D
73117,5,HOL1,2005-11-20,Groningen,AZ Alkmaar,0,0,0,D
73118,5,HOL1,2005-11-20,Heracles,Roosendaal,3,0,3,W
73119,5,HOL1,2005-11-20,Roda,Feyenoord Rotterdam,2,3,-1,L
73120,5,HOL1,2005-11-20,Sparta Rotterdam,Heerenveen,1,2,-1,L
73121,5,HOL1,2005-11-27,AZ Alkmaar,Roda,2,0,2,W
73122,5,HOL1,2005-11-27,Feyenoord Rotterdam,Heracles,7,1,6,W
73123,5,HOL1,2005-11-27,Heerenveen,Roosendaal,2,0,2,W
73124,5,HOL1,2005-11-27,PSV Eindhoven,ADO Den Haag,3,0,3,W
73125,5,HOL1,2005-11-27,Utrecht,Ajax Amsterdam,1,0,1,W
73126,5,HOL1,2005-11-29,Vitesse,Waalwijk,4,2,2,W
73127,5,HOL1,2005-11-30,NAC Breda,Groningen,2,2,0,D
73128,5,HOL1,2005-11-30,NEC Nijmegen,Willem II,2,0,2,W
73129,5,HOL1,2005-11-30,Twente Enschede,Sparta Rotterdam,1,0,1,W
73130,5,HOL1,2005-12-02,Heracles,Roda,0,1,-1,L
73131,5,HOL1,2005-12-03,AZ Alkmaar,Heerenveen,2,1,1,W
73132,5,HOL1,2005-12-03,PSV Eindhoven,NAC Breda,3,0,3,W
73133,5,HOL1,2005-12-03,Roosendaal,Feyenoord Rotterdam,2,2,0,D
73134,5,HOL1,2005-12-04,Ajax Amsterdam,Waalwijk,4,1,3,W
73135,5,HOL1,2005-12-04,Groningen,Twente Enschede,1,0,1,W
73136,5,HOL1,2005-12-04,NEC Nijmegen,Vitesse,1,0,1,W
73137,5,HOL1,2005-12-04,Sparta Rotterdam,ADO Den Haag,2,3,-1,L
73138,5,HOL1,2005-12-09,Roda,NEC Nijmegen,0,1,-1,L
73139,5,HOL1,2005-12-10,ADO Den Haag,Roosendaal,3,0,3,W
73140,5,HOL1,2005-12-10,Heerenveen,Willem II,3,3,0,D
73141,5,HOL1,2005-12-10,NAC Breda,Heracles,2,1,1,W
73142,5,HOL1,2005-12-10,Twente Enschede,AZ Alkmaar,1,3,-2,L
73143,5,HOL1,2005-12-11,Feyenoord Rotterdam,PSV Eindhoven,1,0,1,W
73144,5,HOL1,2005-12-11,Utrecht,Groningen,0,2,-2,L
73145,5,HOL1,2005-12-11,Vitesse,Ajax Amsterdam,0,2,-2,L
73146,5,HOL1,2005-12-11,Waalwijk,Sparta Rotterdam,3,2,1,W
73147,5,HOL1,2005-12-14,Willem II,Utrecht,0,1,-1,L
73148,5,HOL1,2005-12-16,Sparta Rotterdam,Vitesse,1,0,1,W
73149,5,HOL1,2005-12-17,Heerenveen,Twente Enschede,3,1,2,W
73150,5,HOL1,2005-12-17,PSV Eindhoven,Willem II,4,1,3,W
73151,5,HOL1,2005-12-17,Roosendaal,Roda,0,2,-2,L
73152,5,HOL1,2005-12-18,AZ Alkmaar,Waalwijk,3,0,3,W
73153,5,HOL1,2005-12-18,ADO Den Haag,Feyenoord Rotterdam,2,1,1,W
73154,5,HOL1,2005-12-18,Groningen,NEC Nijmegen,3,0,3,W
73155,5,HOL1,2005-12-18,Heracles,Utrecht,1,1,0,D
73156,5,HOL1,2005-12-18,NAC Breda,Ajax Amsterdam,0,2,-2,L
73157,5,HOL1,2005-12-26,Feyenoord Rotterdam,AZ Alkmaar,2,0,2,W
73158,5,HOL1,2005-12-26,NEC Nijmegen,PSV Eindhoven,0,2,-2,L
73159,5,HOL1,2005-12-26,Twente Enschede,Roosendaal,4,1,3,W
73160,5,HOL1,2005-12-26,Utrecht,Sparta Rotterdam,1,1,0,D
73161,5,HOL1,2005-12-27,Ajax Amsterdam,Groningen,3,2,1,W
73162,5,HOL1,2005-12-27,Roda,ADO Den Haag,3,1,2,W
73163,5,HOL1,2005-12-27,Vitesse,NAC Breda,2,1,1,W
73164,5,HOL1,2005-12-27,Waalwijk,Heerenveen,2,2,0,D
73165,5,HOL1,2005-12-29,Feyenoord Rotterdam,Willem II,6,1,5,W
73166,5,HOL1,2005-12-29,PSV Eindhoven,Twente Enschede,1,1,0,D
73167,5,HOL1,2005-12-29,Roosendaal,Utrecht,1,2,-1,L
73168,5,HOL1,2005-12-30,Heerenveen,Ajax Amsterdam,4,2,2,W
73169,5,HOL1,2005-12-30,Heracles,Vitesse,3,1,2,W
73170,5,HOL1,2005-12-30,Roda,Groningen,1,3,-2,L
73171,5,HOL1,2006-01-11,NAC Breda,Waalwijk,1,2,-1,L
73172,5,HOL1,2006-01-11,Willem II,Heracles,1,2,-1,L
73173,5,HOL1,2006-01-13,Groningen,Heerenveen,2,0,2,W
73174,5,HOL1,2006-01-14,Heracles,AZ Alkmaar,0,2,-2,L
73175,5,HOL1,2006-01-14,NAC Breda,Roda,0,4,-4,L
73176,5,HOL1,2006-01-14,Waalwijk,Roosendaal,1,1,0,D
73177,5,HOL1,2006-01-15,Ajax Amsterdam,NEC Nijmegen,1,1,0,D
73178,5,HOL1,2006-01-15,ADO Den Haag,Utrecht,2,3,-1,L
73179,5,HOL1,2006-01-15,Sparta Rotterdam,PSV Eindhoven,0,1,-1,L
73180,5,HOL1,2006-01-15,Vitesse,Feyenoord Rotterdam,0,1,-1,L
73181,5,HOL1,2006-01-15,Willem II,Twente Enschede,1,1,0,D
73182,5,HOL1,2006-01-18,AZ Alkmaar,ADO Den Haag,3,1,2,W
73183,5,HOL1,2006-01-18,Sparta Rotterdam,NEC Nijmegen,1,3,-2,L
73184,5,HOL1,2006-01-20,PSV Eindhoven,Waalwijk,2,0,2,W
73185,5,HOL1,2006-01-21,AZ Alkmaar,Groningen,1,1,0,D
73186,5,HOL1,2006-01-21,Heerenveen,Sparta Rotterdam,0,0,0,D
73187,5,HOL1,2006-01-21,Roosendaal,Heracles,1,2,-1,L
73188,5,HOL1,2006-01-21,Vitesse,Willem II,2,1,1,W
73189,5,HOL1,2006-01-22,Feyenoord Rotterdam,Roda,0,0,0,D
73190,5,HOL1,2006-01-22,NEC Nijmegen,ADO Den Haag,5,0,5,W
73191,5,HOL1,2006-01-22,Twente Enschede,Ajax Amsterdam,2,3,-1,L
73192,5,HOL1,2006-01-22,Utrecht,NAC Breda,2,2,0,D
73193,5,HOL1,2006-01-27,Roda,AZ Alkmaar,1,4,-3,L
73194,5,HOL1,2006-01-28,Roosendaal,Heerenveen,0,2,-2,L
73195,5,HOL1,2006-01-28,Sparta Rotterdam,Twente Enschede,1,0,1,W
73196,5,HOL1,2006-01-28,Willem II,NEC Nijmegen,2,2,0,D
73197,5,HOL1,2006-01-29,Ajax Amsterdam,Utrecht,1,4,-3,L
73198,5,HOL1,2006-01-29,ADO Den Haag,PSV Eindhoven,0,2,-2,L
73199,5,HOL1,2006-01-29,Groningen,NAC Breda,3,2,1,W
73200,5,HOL1,2006-01-29,Heracles,Feyenoord Rotterdam,0,4,-4,L
73201,5,HOL1,2006-01-29,Waalwijk,Vitesse,0,1,-1,L
73202,5,HOL1,2006-02-03,Willem II,Roosendaal,3,1,2,W
73203,5,HOL1,2006-02-04,AZ Alkmaar,Vitesse,1,1,0,D
73204,5,HOL1,2006-02-04,Groningen,Heracles,0,0,0,D
73205,5,HOL1,2006-02-04,NAC Breda,Sparta Rotterdam,0,0,0,D
73206,5,HOL1,2006-02-04,PSV Eindhoven,Roda,3,2,1,W
73207,5,HOL1,2006-02-05,Feyenoord Rotterdam,Ajax Amsterdam,3,2,1,W
73208,5,HOL1,2006-02-05,Heerenveen,ADO Den Haag,3,0,3,W
73209,5,HOL1,2006-02-05,Twente Enschede,Utrecht,3,0,3,W
73210,5,HOL1,2006-02-05,Waalwijk,NEC Nijmegen,1,3,-2,L
73211,5,HOL1,2006-02-07,Roosendaal,AZ Alkmaar,0,5,-5,L
73212,5,HOL1,2006-02-07,Sparta Rotterdam,Groningen,1,0,1,W
73213,5,HOL1,2006-02-08,Ajax Amsterdam,Willem II,1,0,1,W
73214,5,HOL1,2006-02-08,ADO Den Haag,NAC Breda,0,3,-3,L
73215,5,HOL1,2006-02-08,Heracles,Heerenveen,1,1,0,D
73216,5,HOL1,2006-02-08,NEC Nijmegen,Feyenoord Rotterdam,1,2,-1,L
73217,5,HOL1,2006-02-08,Roda,Waalwijk,1,0,1,W
73218,5,HOL1,2006-02-08,Utrecht,PSV Eindhoven,1,2,-1,L
73219,5,HOL1,2006-02-08,Vitesse,Twente Enschede,1,2,-1,L
73220,5,HOL1,2006-02-10,Sparta Rotterdam,AZ Alkmaar,0,1,-1,L
73221,5,HOL1,2006-02-11,Heerenveen,Vitesse,4,1,3,W
73222,5,HOL1,2006-02-11,PSV Eindhoven,Heracles,1,0,1,W
73223,5,HOL1,2006-02-11,Twente Enschede,Roda,1,0,1,W
73224,5,HOL1,2006-02-11,Waalwijk,Willem II,1,0,1,W
73225,5,HOL1,2006-02-12,ADO Den Haag,Ajax Amsterdam,1,2,-1,L
73226,5,HOL1,2006-02-12,NAC Breda,Feyenoord Rotterdam,3,3,0,D
73227,5,HOL1,2006-02-12,Roosendaal,Groningen,1,2,-1,L
73228,5,HOL1,2006-02-12,Utrecht,NEC Nijmegen,1,1,0,D
73229,5,HOL1,2006-02-17,NEC Nijmegen,Twente Enschede,0,3,-3,L
73230,5,HOL1,2006-02-17,Vitesse,PSV Eindhoven,1,3,-2,L
73231,5,HOL1,2006-02-18,Groningen,Waalwijk,1,0,1,W
73232,5,HOL1,2006-02-18,Roda,Heerenveen,2,1,1,W
73233,5,HOL1,2006-02-19,Ajax Amsterdam,Roosendaal,6,0,6,W
73234,5,HOL1,2006-02-19,AZ Alkmaar,Utrecht,2,3,-1,L
73235,5,HOL1,2006-02-19,Feyenoord Rotterdam,Sparta Rotterdam,4,0,4,W
73236,5,HOL1,2006-02-19,Heracles,ADO Den Haag,1,3,-2,L
73237,5,HOL1,2006-02-19,Willem II,NAC Breda,2,0,2,W
73238,5,HOL1,2006-02-24,Roosendaal,NEC Nijmegen,2,0,2,W
73239,5,HOL1,2006-02-24,Waalwijk,Twente Enschede,0,0,0,D
73240,5,HOL1,2006-02-25,ADO Den Haag,Vitesse,2,0,2,W
73241,5,HOL1,2006-02-25,Sparta Rotterdam,Willem II,3,2,1,W
73242,5,HOL1,2006-02-26,AZ Alkmaar,PSV Eindhoven,1,2,-1,L
73243,5,HOL1,2006-02-26,Groningen,Feyenoord Rotterdam,1,1,0,D
73244,5,HOL1,2006-02-26,Heerenveen,NAC Breda,2,1,1,W
73245,5,HOL1,2006-02-26,Heracles,Ajax Amsterdam,1,3,-2,L
73246,5,HOL1,2006-02-26,Utrecht,Roda,2,1,1,W
73247,5,HOL1,2006-03-03,NEC Nijmegen,AZ Alkmaar,0,2,-2,L
73248,5,HOL1,2006-03-04,NAC Breda,Roosendaal,2,1,1,W
73249,5,HOL1,2006-03-04,PSV Eindhoven,Heerenveen,4,1,3,W
73250,5,HOL1,2006-03-04,Vitesse,Roda,1,3,-2,L
73251,5,HOL1,2006-03-04,Willem II,Groningen,5,0,5,W
73252,5,HOL1,2006-03-05,Ajax Amsterdam,Sparta Rotterdam,6,0,6,W
73253,5,HOL1,2006-03-05,Feyenoord Rotterdam,Utrecht,3,0,3,W
73254,5,HOL1,2006-03-05,Twente Enschede,Heracles,2,0,2,W
73255,5,HOL1,2006-03-05,Waalwijk,ADO Den Haag,3,0,3,W
73256,5,HOL1,2006-03-10,Twente Enschede,NAC Breda,1,0,1,W
73257,5,HOL1,2006-03-11,Ajax Amsterdam,PSV Eindhoven,0,0,0,D
73258,5,HOL1,2006-03-11,ADO Den Haag,Groningen,2,1,1,W
73259,5,HOL1,2006-03-11,NEC Nijmegen,Heracles,2,0,2,W
73260,5,HOL1,2006-03-11,Roda,Sparta Rotterdam,1,1,0,D
73261,5,HOL1,2006-03-12,Feyenoord Rotterdam,Waalwijk,1,1,0,D
73262,5,HOL1,2006-03-12,Utrecht,Heerenveen,2,0,2,W
73263,5,HOL1,2006-03-12,Vitesse,Roosendaal,5,1,4,W
73264,5,HOL1,2006-03-12,Willem II,AZ Alkmaar,1,3,-2,L
73265,5,HOL1,2006-03-17,NAC Breda,Vitesse,2,2,0,D
73266,5,HOL1,2006-03-18,ADO Den Haag,Roda,1,1,0,D
73267,5,HOL1,2006-03-18,Heerenveen,Waalwijk,2,1,1,W
73268,5,HOL1,2006-03-18,Heracles,Willem II,1,0,1,W
73269,5,HOL1,2006-03-18,PSV Eindhoven,NEC Nijmegen,1,0,1,W
73270,5,HOL1,2006-03-19,AZ Alkmaar,Feyenoord Rotterdam,1,0,1,W
73271,5,HOL1,2006-03-19,Groningen,Ajax Amsterdam,3,2,1,W
73272,5,HOL1,2006-03-19,Roosendaal,Twente Enschede,1,1,0,D
73273,5,HOL1,2006-03-19,Sparta Rotterdam,Utrecht,0,1,-1,L
73274,5,HOL1,2006-03-24,Vitesse,Sparta Rotterdam,3,1,2,W
73275,5,HOL1,2006-03-25,NEC Nijmegen,Groningen,2,2,0,D
73276,5,HOL1,2006-03-25,Twente Enschede,Heerenveen,1,2,-1,L
73277,5,HOL1,2006-03-25,Willem II,PSV Eindhoven,0,3,-3,L
73278,5,HOL1,2006-03-26,Ajax Amsterdam,NAC Breda,1,1,0,D
73279,5,HOL1,2006-03-26,Feyenoord Rotterdam,ADO Den Haag,0,2,-2,L
73280,5,HOL1,2006-03-26,Roda,Roosendaal,5,1,4,W
73281,5,HOL1,2006-03-26,Utrecht,Heracles,1,0,1,W
73282,5,HOL1,2006-03-26,Waalwijk,AZ Alkmaar,0,1,-1,L
73283,5,HOL1,2006-03-31,Utrecht,Waalwijk,3,1,2,W
73284,5,HOL1,2006-04-01,ADO Den Haag,Willem II,1,1,0,D
73285,5,HOL1,2006-04-01,Heracles,Sparta Rotterdam,1,0,1,W
73286,5,HOL1,2006-04-01,NEC Nijmegen,Heerenveen,4,1,3,W
73287,5,HOL1,2006-04-01,Roosendaal,PSV Eindhoven,1,2,-1,L
73288,5,HOL1,2006-04-02,Feyenoord Rotterdam,Twente Enschede,4,2,2,W
73289,5,HOL1,2006-04-02,Groningen,Vitesse,2,1,1,W
73290,5,HOL1,2006-04-02,Roda,Ajax Amsterdam,2,1,1,W
73291,5,HOL1,2006-04-04,AZ Alkmaar,NAC Breda,3,2,1,W
73292,5,HOL1,2006-04-07,Heerenveen,Feyenoord Rotterdam,1,1,0,D
73293,5,HOL1,2006-04-08,NAC Breda,NEC Nijmegen,2,1,1,W
73294,5,HOL1,2006-04-08,Sparta Rotterdam,Roosendaal,5,0,5,W
73295,5,HOL1,2006-04-08,Waalwijk,Heracles,0,2,-2,L
73296,5,HOL1,2006-04-09,Ajax Amsterdam,AZ Alkmaar,1,0,1,W
73297,5,HOL1,2006-04-09,PSV Eindhoven,Groningen,1,1,0,D
73298,5,HOL1,2006-04-09,Twente Enschede,ADO Den Haag,2,0,2,W
73299,5,HOL1,2006-04-09,Vitesse,Utrecht,1,0,1,W
73300,5,HOL1,2006-04-09,Willem II,Roda,2,2,0,D
73301,5,HOL1,2006-04-12,Ajax Amsterdam,Vitesse,2,1,1,W
73302,5,HOL1,2006-04-12,AZ Alkmaar,Twente Enschede,0,0,0,D
73303,5,HOL1,2006-04-12,Groningen,Utrecht,2,1,1,W
73304,5,HOL1,2006-04-12,Heracles,NAC Breda,4,2,2,W
73305,5,HOL1,2006-04-12,NEC Nijmegen,Roda,0,3,-3,L
73306,5,HOL1,2006-04-12,PSV Eindhoven,Feyenoord Rotterdam,1,1,0,D
73307,5,HOL1,2006-04-12,Roosendaal,ADO Den Haag,1,2,-1,L
73308,5,HOL1,2006-04-12,Sparta Rotterdam,Waalwijk,3,2,1,W
73309,5,HOL1,2006-04-12,Willem II,Heerenveen,4,3,1,W
73310,5,HOL1,2006-04-16,ADO Den Haag,Sparta Rotterdam,0,2,-2,L
73311,5,HOL1,2006-04-16,Feyenoord Rotterdam,Roosendaal,2,0,2,W
73312,5,HOL1,2006-04-16,Heerenveen,AZ Alkmaar,2,4,-2,L
73313,5,HOL1,2006-04-16,NAC Breda,PSV Eindhoven,2,6,-4,L
73314,5,HOL1,2006-04-16,Roda,Heracles,2,1,1,W
73315,5,HOL1,2006-04-16,Twente Enschede,Groningen,1,1,0,D
73316,5,HOL1,2006-04-16,Utrecht,Willem II,1,4,-3,L
73317,5,HOL1,2006-04-16,Vitesse,NEC Nijmegen,1,1,0,D
73318,5,HOL1,2006-04-16,Waalwijk,Ajax Amsterdam,2,4,-2,L
73319,6,HOL1,2006-08-18,Sparta Rotterdam,Vitesse,1,2,-1,L
73320,6,HOL1,2006-08-19,AZ Alkmaar,NAC Breda,8,1,7,W
73321,6,HOL1,2006-08-19,ADO Den Haag,Heerenveen,2,3,-1,L
73322,6,HOL1,2006-08-19,Excelsior,Roda,0,1,-1,L
73323,6,HOL1,2006-08-19,Willem II,Utrecht,2,1,1,W
73324,6,HOL1,2006-08-20,Ajax Amsterdam,Waalwijk,5,0,5,W
73325,6,HOL1,2006-08-20,Groningen,Feyenoord Rotterdam,3,0,3,W
73326,6,HOL1,2006-08-20,Heracles,Twente Enschede,3,0,3,W
73327,6,HOL1,2006-08-20,PSV Eindhoven,NEC Nijmegen,3,1,2,W
73328,6,HOL1,2006-08-25,Roda,ADO Den Haag,1,0,1,W
73329,6,HOL1,2006-08-26,Heerenveen,Willem II,5,0,5,W
73330,6,HOL1,2006-08-26,Utrecht,Sparta Rotterdam,2,2,0,D
73331,6,HOL1,2006-08-26,Vitesse,AZ Alkmaar,1,3,-2,L
73332,6,HOL1,2006-08-26,Waalwijk,Excelsior,1,1,0,D
73333,6,HOL1,2006-08-27,Feyenoord Rotterdam,Heracles,0,0,0,D
73334,6,HOL1,2006-08-27,NAC Breda,Ajax Amsterdam,1,2,-1,L
73335,6,HOL1,2006-08-27,NEC Nijmegen,Groningen,1,1,0,D
73336,6,HOL1,2006-08-27,Twente Enschede,PSV Eindhoven,1,0,1,W
73337,6,HOL1,2006-09-08,ADO Den Haag,NAC Breda,0,2,-2,L
73338,6,HOL1,2006-09-08,Twente Enschede,Roda,2,2,0,D
73339,6,HOL1,2006-09-09,Excelsior,Heerenveen,3,1,2,W
73340,6,HOL1,2006-09-09,Willem II,PSV Eindhoven,1,3,-2,L
73341,6,HOL1,2006-09-10,Ajax Amsterdam,Vitesse,3,0,3,W
73342,6,HOL1,2006-09-10,Groningen,Heracles,2,1,1,W
73343,6,HOL1,2006-09-10,NEC Nijmegen,AZ Alkmaar,0,2,-2,L
73344,6,HOL1,2006-09-10,Sparta Rotterdam,Feyenoord Rotterdam,1,4,-3,L
73345,6,HOL1,2006-09-10,Utrecht,Waalwijk,5,0,5,W
73346,6,HOL1,2006-09-15,Waalwijk,ADO Den Haag,1,0,1,W
73347,6,HOL1,2006-09-16,Excelsior,Willem II,3,2,1,W
73348,6,HOL1,2006-09-16,Heracles,Utrecht,3,0,3,W
73349,6,HOL1,2006-09-16,Vitesse,NAC Breda,0,1,-1,L
73350,6,HOL1,2006-09-17,AZ Alkmaar,Twente Enschede,2,2,0,D
73351,6,HOL1,2006-09-17,Heerenveen,NEC Nijmegen,3,0,3,W
73352,6,HOL1,2006-09-17,PSV Eindhoven,Feyenoord Rotterdam,2,1,1,W
73353,6,HOL1,2006-09-17,Roda,Ajax Amsterdam,2,0,2,W
73354,6,HOL1,2006-09-17,Sparta Rotterdam,Groningen,0,1,-1,L
73355,6,HOL1,2006-09-22,NAC Breda,Willem II,0,0,0,D
73356,6,HOL1,2006-09-23,ADO Den Haag,PSV Eindhoven,0,2,-2,L
73357,6,HOL1,2006-09-23,Twente Enschede,Sparta Rotterdam,2,0,2,W
73358,6,HOL1,2006-09-23,Vitesse,Heracles,4,0,4,W
73359,6,HOL1,2006-09-24,Ajax Amsterdam,NEC Nijmegen,2,0,2,W
73360,6,HOL1,2006-09-24,Feyenoord Rotterdam,Excelsior,1,0,1,W
73361,6,HOL1,2006-09-24,Groningen,Waalwijk,1,1,0,D
73362,6,HOL1,2006-09-24,Roda,AZ Alkmaar,0,2,-2,L
73363,6,HOL1,2006-09-24,Utrecht,Heerenveen,1,0,1,W
73364,6,HOL1,2006-09-29,NEC Nijmegen,Heracles,2,0,2,W
73365,6,HOL1,2006-09-30,Excelsior,Sparta Rotterdam,3,1,2,W
73366,6,HOL1,2006-09-30,Twente Enschede,Waalwijk,4,3,1,W
73367,6,HOL1,2006-09-30,Willem II,Roda,0,1,-1,L
73368,6,HOL1,2006-10-01,AZ Alkmaar,ADO Den Haag,2,2,0,D
73369,6,HOL1,2006-10-01,Feyenoord Rotterdam,NAC Breda,3,2,1,W
73370,6,HOL1,2006-10-01,Groningen,Vitesse,4,3,1,W
73371,6,HOL1,2006-10-01,Heerenveen,PSV Eindhoven,0,0,0,D
73372,6,HOL1,2006-10-01,Utrecht,Ajax Amsterdam,2,3,-1,L
73373,6,HOL1,2006-10-13,ADO Den Haag,Twente Enschede,1,2,-1,L
73374,6,HOL1,2006-10-14,Ajax Amsterdam,Groningen,3,2,1,W
73375,6,HOL1,2006-10-14,NAC Breda,NEC Nijmegen,0,2,-2,L
73376,6,HOL1,2006-10-14,Sparta Rotterdam,AZ Alkmaar,0,2,-2,L
73377,6,HOL1,2006-10-14,Vitesse,Willem II,1,0,1,W
73378,6,HOL1,2006-10-15,Excelsior,Utrecht,0,1,-1,L
73379,6,HOL1,2006-10-15,Heracles,Heerenveen,1,0,1,W
73380,6,HOL1,2006-10-15,PSV Eindhoven,Roda,4,1,3,W
73381,6,HOL1,2006-10-15,Waalwijk,Feyenoord Rotterdam,2,2,0,D
73382,6,HOL1,2006-10-20,Willem II,Heracles,2,0,2,W
73383,6,HOL1,2006-10-21,Roda,Sparta Rotterdam,2,1,1,W
73384,6,HOL1,2006-10-21,Twente Enschede,Excelsior,4,1,3,W
73385,6,HOL1,2006-10-21,Waalwijk,NAC Breda,0,1,-1,L
73386,6,HOL1,2006-10-22,AZ Alkmaar,PSV Eindhoven,1,3,-2,L
73387,6,HOL1,2006-10-22,Feyenoord Rotterdam,Ajax Amsterdam,0,4,-4,L
73388,6,HOL1,2006-10-22,Heerenveen,Groningen,4,2,2,W
73389,6,HOL1,2006-10-22,NEC Nijmegen,Vitesse,1,0,1,W
73390,6,HOL1,2006-10-22,Utrecht,ADO Den Haag,2,0,2,W
73391,6,HOL1,2006-10-25,Ajax Amsterdam,ADO Den Haag,2,0,2,W
73392,6,HOL1,2006-10-25,Groningen,Excelsior,2,1,1,W
73393,6,HOL1,2006-10-25,Heracles,Waalwijk,1,1,0,D
73394,6,HOL1,2006-10-25,NEC Nijmegen,Roda,0,0,0,D
73395,6,HOL1,2006-10-25,PSV Eindhoven,Sparta Rotterdam,7,0,7,W
73396,6,HOL1,2006-10-26,Feyenoord Rotterdam,Twente Enschede,2,1,1,W
73397,6,HOL1,2006-10-26,NAC Breda,Utrecht,2,1,1,W
73398,6,HOL1,2006-10-26,Willem II,AZ Alkmaar,0,4,-4,L
73399,6,HOL1,2006-10-28,ADO Den Haag,Heracles,2,0,2,W
73400,6,HOL1,2006-10-28,Excelsior,Vitesse,2,2,0,D
73401,6,HOL1,2006-10-28,Heerenveen,Ajax Amsterdam,0,2,-2,L
73402,6,HOL1,2006-10-28,Waalwijk,PSV Eindhoven,0,3,-3,L
73403,6,HOL1,2006-10-29,AZ Alkmaar,Utrecht,5,1,4,W
73404,6,HOL1,2006-10-29,NAC Breda,Groningen,0,0,0,D
73405,6,HOL1,2006-10-29,Roda,Feyenoord Rotterdam,1,2,-1,L
73406,6,HOL1,2006-10-29,Sparta Rotterdam,Willem II,1,0,1,W
73407,6,HOL1,2006-10-29,Twente Enschede,NEC Nijmegen,4,0,4,W
73408,6,HOL1,2006-11-03,NEC Nijmegen,Willem II,1,2,-1,L
73409,6,HOL1,2006-11-04,ADO Den Haag,Excelsior,2,2,0,D
73410,6,HOL1,2006-11-04,Groningen,Roda,2,1,1,W
73411,6,HOL1,2006-11-04,PSV Eindhoven,NAC Breda,3,0,3,W
73412,6,HOL1,2006-11-05,Feyenoord Rotterdam,Vitesse,2,1,1,W
73413,6,HOL1,2006-11-05,Heerenveen,Sparta Rotterdam,2,0,2,W
73414,6,HOL1,2006-11-05,Heracles,Ajax Amsterdam,0,3,-3,L
73415,6,HOL1,2006-11-05,Utrecht,Twente Enschede,0,0,0,D
73416,6,HOL1,2006-11-05,Waalwijk,AZ Alkmaar,0,2,-2,L
73417,6,HOL1,2006-11-10,NAC Breda,Heerenveen,1,1,0,D
73418,6,HOL1,2006-11-11,AZ Alkmaar,Heracles,5,0,5,W
73419,6,HOL1,2006-11-11,Excelsior,NEC Nijmegen,1,1,0,D
73420,6,HOL1,2006-11-11,Roda,Waalwijk,1,1,0,D
73421,6,HOL1,2006-11-12,Ajax Amsterdam,PSV Eindhoven,0,1,-1,L
73422,6,HOL1,2006-11-12,Sparta Rotterdam,ADO Den Haag,2,1,1,W
73423,6,HOL1,2006-11-12,Twente Enschede,Groningen,7,1,6,W
73424,6,HOL1,2006-11-12,Vitesse,Utrecht,4,2,2,W
73425,6,HOL1,2006-11-12,Willem II,Feyenoord Rotterdam,3,5,-2,L
73426,6,HOL1,2006-11-17,Heracles,NAC Breda,2,0,2,W
73427,6,HOL1,2006-11-18,Feyenoord Rotterdam,AZ Alkmaar,3,2,1,W
73428,6,HOL1,2006-11-18,NEC Nijmegen,Sparta Rotterdam,1,2,-1,L
73429,6,HOL1,2006-11-18,PSV Eindhoven,Excelsior,4,0,4,W
73430,6,HOL1,2006-11-18,Waalwijk,Heerenveen,0,2,-2,L
73431,6,HOL1,2006-11-19,Ajax Amsterdam,Twente Enschede,1,1,0,D
73432,6,HOL1,2006-11-19,ADO Den Haag,Vitesse,0,3,-3,L
73433,6,HOL1,2006-11-19,Groningen,Willem II,4,1,3,W
73434,6,HOL1,2006-11-19,Utrecht,Roda,2,0,2,W
73435,6,HOL1,2006-11-24,Twente Enschede,Vitesse,2,0,2,W
73436,6,HOL1,2006-11-25,Excelsior,Heracles,6,1,5,W
73437,6,HOL1,2006-11-25,PSV Eindhoven,Utrecht,5,0,5,W
73438,6,HOL1,2006-11-25,Willem II,Waalwijk,3,1,2,W
73439,6,HOL1,2006-11-26,Groningen,ADO Den Haag,2,5,-3,L
73440,6,HOL1,2006-11-26,Heerenveen,AZ Alkmaar,1,3,-2,L
73441,6,HOL1,2006-11-26,NEC Nijmegen,Feyenoord Rotterdam,4,1,3,W
73442,6,HOL1,2006-11-26,Roda,NAC Breda,3,2,1,W
73443,6,HOL1,2006-11-26,Sparta Rotterdam,Ajax Amsterdam,3,0,3,W
73444,6,HOL1,2006-11-29,Vitesse,Heerenveen,1,3,-2,L
73445,6,HOL1,2006-12-01,Waalwijk,Sparta Rotterdam,2,1,1,W
73446,6,HOL1,2006-12-02,ADO Den Haag,NEC Nijmegen,0,2,-2,L
73447,6,HOL1,2006-12-02,Heracles,Roda,1,1,0,D
73448,6,HOL1,2006-12-02,NAC Breda,Twente Enschede,0,0,0,D
73449,6,HOL1,2006-12-02,Vitesse,PSV Eindhoven,0,1,-1,L
73450,6,HOL1,2006-12-03,Ajax Amsterdam,Willem II,6,0,6,W
73451,6,HOL1,2006-12-03,AZ Alkmaar,Excelsior,5,0,5,W
73452,6,HOL1,2006-12-03,Feyenoord Rotterdam,Heerenveen,4,3,1,W
73453,6,HOL1,2006-12-03,Utrecht,Groningen,3,0,3,W
73454,6,HOL1,2006-12-08,Heerenveen,Roda,1,0,1,W
73455,6,HOL1,2006-12-09,Groningen,PSV Eindhoven,0,2,-2,L
73456,6,HOL1,2006-12-09,Heracles,Sparta Rotterdam,2,3,-1,L
73457,6,HOL1,2006-12-09,NAC Breda,Excelsior,2,1,1,W
73458,6,HOL1,2006-12-09,NEC Nijmegen,Utrecht,2,0,2,W
73459,6,HOL1,2006-12-10,Ajax Amsterdam,AZ Alkmaar,2,2,0,D
73460,6,HOL1,2006-12-10,Feyenoord Rotterdam,ADO Den Haag,3,1,2,W
73461,6,HOL1,2006-12-10,Vitesse,Waalwijk,3,1,2,W
73462,6,HOL1,2006-12-10,Willem II,Twente Enschede,1,3,-2,L
73463,6,HOL1,2006-12-15,PSV Eindhoven,Heracles,3,0,3,W
73464,6,HOL1,2006-12-16,ADO Den Haag,Willem II,2,1,1,W
73465,6,HOL1,2006-12-16,Roda,Vitesse,2,4,-2,L
73466,6,HOL1,2006-12-16,Sparta Rotterdam,NAC Breda,0,3,-3,L
73467,6,HOL1,2006-12-17,AZ Alkmaar,Groningen,2,0,2,W
73468,6,HOL1,2006-12-17,Excelsior,Ajax Amsterdam,1,3,-2,L
73469,6,HOL1,2006-12-17,Twente Enschede,Heerenveen,5,1,4,W
73470,6,HOL1,2006-12-17,Utrecht,Feyenoord Rotterdam,2,1,1,W
73471,6,HOL1,2006-12-17,Waalwijk,NEC Nijmegen,0,1,-1,L
73472,6,HOL1,2006-12-22,Heracles,Groningen,0,1,-1,L
73473,6,HOL1,2006-12-23,Feyenoord Rotterdam,Sparta Rotterdam,3,2,1,W
73474,6,HOL1,2006-12-23,Heerenveen,Excelsior,2,0,2,W
73475,6,HOL1,2006-12-23,NAC Breda,ADO Den Haag,2,2,0,D
73476,6,HOL1,2006-12-23,PSV Eindhoven,Willem II,4,0,4,W
73477,6,HOL1,2006-12-24,AZ Alkmaar,NEC Nijmegen,0,0,0,D
73478,6,HOL1,2006-12-24,Roda,Twente Enschede,2,0,2,W
73479,6,HOL1,2006-12-24,Vitesse,Ajax Amsterdam,4,2,2,W
73480,6,HOL1,2006-12-24,Waalwijk,Utrecht,1,1,0,D
73481,6,HOL1,2006-12-26,Feyenoord Rotterdam,PSV Eindhoven,1,1,0,D
73482,6,HOL1,2006-12-26,Groningen,Sparta Rotterdam,0,1,-1,L
73483,6,HOL1,2006-12-26,Willem II,Excelsior,2,1,1,W
73484,6,HOL1,2006-12-27,Ajax Amsterdam,Roda,2,0,2,W
73485,6,HOL1,2006-12-27,ADO Den Haag,Waalwijk,1,1,0,D
73486,6,HOL1,2006-12-27,NAC Breda,Vitesse,2,1,1,W
73487,6,HOL1,2006-12-27,NEC Nijmegen,Heerenveen,0,2,-2,L
73488,6,HOL1,2006-12-27,Twente Enschede,AZ Alkmaar,3,0,3,W
73489,6,HOL1,2006-12-27,Utrecht,Heracles,0,0,0,D
73490,6,HOL1,2006-12-29,Excelsior,Feyenoord Rotterdam,1,3,-2,L
73491,6,HOL1,2006-12-30,Heerenveen,Utrecht,0,0,0,D
73492,6,HOL1,2006-12-30,NEC Nijmegen,Ajax Amsterdam,2,2,0,D
73493,6,HOL1,2006-12-30,PSV Eindhoven,ADO Den Haag,2,1,1,W
73494,6,HOL1,2006-12-30,Sparta Rotterdam,Twente Enschede,3,0,3,W
73495,6,HOL1,2006-12-30,Waalwijk,Groningen,0,2,-2,L
73496,6,HOL1,2006-12-31,AZ Alkmaar,Roda,2,2,0,D
73497,6,HOL1,2006-12-31,Heracles,Vitesse,2,2,0,D
73498,6,HOL1,2007-01-14,Willem II,NAC Breda,0,2,-2,L
73499,6,HOL1,2007-01-19,ADO Den Haag,AZ Alkmaar,1,3,-2,L
73500,6,HOL1,2007-01-20,Heracles,NEC Nijmegen,0,0,0,D
73501,6,HOL1,2007-01-20,PSV Eindhoven,Heerenveen,3,1,2,W
73502,6,HOL1,2007-01-20,Roda,Willem II,2,1,1,W
73503,6,HOL1,2007-01-20,Waalwijk,Twente Enschede,1,2,-1,L
73504,6,HOL1,2007-01-21,Ajax Amsterdam,Utrecht,2,0,2,W
73505,6,HOL1,2007-01-21,NAC Breda,Feyenoord Rotterdam,4,1,3,W
73506,6,HOL1,2007-01-21,Sparta Rotterdam,Excelsior,2,1,1,W
73507,6,HOL1,2007-01-21,Vitesse,Groningen,3,2,1,W
73508,6,HOL1,2007-01-26,Heerenveen,Heracles,5,1,4,W
73509,6,HOL1,2007-01-27,AZ Alkmaar,Sparta Rotterdam,3,0,3,W
73510,6,HOL1,2007-01-27,NEC Nijmegen,NAC Breda,2,1,1,W
73511,6,HOL1,2007-01-27,Utrecht,Excelsior,1,0,1,W
73512,6,HOL1,2007-01-27,Willem II,Vitesse,0,0,0,D
73513,6,HOL1,2007-01-28,Feyenoord Rotterdam,Waalwijk,3,1,2,W
73514,6,HOL1,2007-01-28,Groningen,Ajax Amsterdam,2,3,-1,L
73515,6,HOL1,2007-01-28,Roda,PSV Eindhoven,2,0,2,W
73516,6,HOL1,2007-01-28,Twente Enschede,ADO Den Haag,3,1,2,W
73517,6,HOL1,2007-02-02,Groningen,Heerenveen,1,1,0,D
73518,6,HOL1,2007-02-03,Excelsior,Twente Enschede,1,2,-1,L
73519,6,HOL1,2007-02-03,Heracles,Willem II,2,2,0,D
73520,6,HOL1,2007-02-03,NAC Breda,Waalwijk,2,1,1,W
73521,6,HOL1,2007-02-03,PSV Eindhoven,AZ Alkmaar,2,3,-1,L
73522,6,HOL1,2007-02-04,Ajax Amsterdam,Feyenoord Rotterdam,4,1,3,W
73523,6,HOL1,2007-02-04,ADO Den Haag,Utrecht,1,1,0,D
73524,6,HOL1,2007-02-04,Sparta Rotterdam,Roda,2,2,0,D
73525,6,HOL1,2007-02-04,Vitesse,NEC Nijmegen,1,1,0,D
73526,6,HOL1,2007-02-09,Excelsior,Groningen,0,2,-2,L
73527,6,HOL1,2007-02-10,AZ Alkmaar,Willem II,2,0,2,W
73528,6,HOL1,2007-02-10,Heerenveen,Vitesse,0,0,0,D
73529,6,HOL1,2007-02-10,Roda,NEC Nijmegen,1,0,1,W
73530,6,HOL1,2007-02-10,Waalwijk,Heracles,2,0,2,W
73531,6,HOL1,2007-02-11,ADO Den Haag,Ajax Amsterdam,1,2,-1,L
73532,6,HOL1,2007-02-11,Sparta Rotterdam,PSV Eindhoven,1,1,0,D
73533,6,HOL1,2007-02-11,Twente Enschede,Feyenoord Rotterdam,3,0,3,W
73534,6,HOL1,2007-02-11,Utrecht,NAC Breda,1,0,1,W
73535,6,HOL1,2007-02-16,NAC Breda,Sparta Rotterdam,3,1,2,W
73536,6,HOL1,2007-02-16,Willem II,ADO Den Haag,2,1,1,W
73537,6,HOL1,2007-02-17,Heracles,PSV Eindhoven,0,2,-2,L
73538,6,HOL1,2007-02-17,NEC Nijmegen,Waalwijk,1,0,1,W
73539,6,HOL1,2007-02-17,Vitesse,Roda,0,0,0,D
73540,6,HOL1,2007-02-18,Ajax Amsterdam,Excelsior,2,2,0,D
73541,6,HOL1,2007-02-18,Feyenoord Rotterdam,Utrecht,2,0,2,W
73542,6,HOL1,2007-02-18,Groningen,AZ Alkmaar,1,1,0,D
73543,6,HOL1,2007-02-18,Heerenveen,Twente Enschede,1,2,-1,L
73544,6,HOL1,2007-02-23,Utrecht,NEC Nijmegen,3,0,3,W
73545,6,HOL1,2007-02-24,PSV Eindhoven,Groningen,1,0,1,W
73546,6,HOL1,2007-02-24,Roda,Heerenveen,1,0,1,W
73547,6,HOL1,2007-02-24,Sparta Rotterdam,Heracles,0,0,0,D
73548,6,HOL1,2007-02-24,Twente Enschede,Willem II,0,0,0,D
73549,6,HOL1,2007-02-25,AZ Alkmaar,Ajax Amsterdam,1,1,0,D
73550,6,HOL1,2007-02-25,ADO Den Haag,Feyenoord Rotterdam,3,3,0,D
73551,6,HOL1,2007-02-25,Excelsior,NAC Breda,0,2,-2,L
73552,6,HOL1,2007-02-25,Waalwijk,Vitesse,3,1,2,W
73553,6,HOL1,2007-03-02,NEC Nijmegen,Twente Enschede,0,3,-3,L
73554,6,HOL1,2007-03-03,Groningen,NAC Breda,3,1,2,W
73555,6,HOL1,2007-03-03,PSV Eindhoven,Waalwijk,2,0,2,W
73556,6,HOL1,2007-03-03,Vitesse,Excelsior,2,3,-1,L
73557,6,HOL1,2007-03-03,Willem II,Sparta Rotterdam,0,0,0,D
73558,6,HOL1,2007-03-04,Ajax Amsterdam,Heerenveen,0,1,-1,L
73559,6,HOL1,2007-03-04,Feyenoord Rotterdam,Roda,1,1,0,D
73560,6,HOL1,2007-03-04,Heracles,ADO Den Haag,3,1,2,W
73561,6,HOL1,2007-03-04,Utrecht,AZ Alkmaar,0,4,-4,L
73562,6,HOL1,2007-03-09,Roda,Utrecht,0,0,0,D
73563,6,HOL1,2007-03-10,Heerenveen,Waalwijk,1,0,1,W
73564,6,HOL1,2007-03-10,NAC Breda,Heracles,1,1,0,D
73565,6,HOL1,2007-03-10,Sparta Rotterdam,NEC Nijmegen,0,4,-4,L
73566,6,HOL1,2007-03-10,Willem II,Groningen,3,0,3,W
73567,6,HOL1,2007-03-11,AZ Alkmaar,Feyenoord Rotterdam,0,0,0,D
73568,6,HOL1,2007-03-11,Excelsior,PSV Eindhoven,0,0,0,D
73569,6,HOL1,2007-03-11,Twente Enschede,Ajax Amsterdam,1,4,-3,L
73570,6,HOL1,2007-03-11,Vitesse,ADO Den Haag,2,2,0,D
73571,6,HOL1,2007-03-16,Waalwijk,Roda,3,2,1,W
73572,6,HOL1,2007-03-17,ADO Den Haag,Sparta Rotterdam,2,4,-2,L
73573,6,HOL1,2007-03-17,Heerenveen,NAC Breda,4,2,2,W
73574,6,HOL1,2007-03-17,NEC Nijmegen,Excelsior,0,1,-1,L
73575,6,HOL1,2007-03-18,Feyenoord Rotterdam,Willem II,0,0,0,D
73576,6,HOL1,2007-03-18,Groningen,Twente Enschede,1,1,0,D
73577,6,HOL1,2007-03-18,Heracles,AZ Alkmaar,0,0,0,D
73578,6,HOL1,2007-03-18,PSV Eindhoven,Ajax Amsterdam,1,5,-4,L
73579,6,HOL1,2007-03-18,Utrecht,Vitesse,2,0,2,W
73580,6,HOL1,2007-03-30,Roda,Groningen,0,1,-1,L
73581,6,HOL1,2007-03-31,AZ Alkmaar,Waalwijk,2,0,2,W
73582,6,HOL1,2007-03-31,NAC Breda,PSV Eindhoven,1,1,0,D
73583,6,HOL1,2007-03-31,Willem II,NEC Nijmegen,1,0,1,W
73584,6,HOL1,2007-04-01,Ajax Amsterdam,Heracles,3,0,3,W
73585,6,HOL1,2007-04-01,Excelsior,ADO Den Haag,3,1,2,W
73586,6,HOL1,2007-04-01,Sparta Rotterdam,Heerenveen,2,2,0,D
73587,6,HOL1,2007-04-01,Twente Enschede,Utrecht,3,0,3,W
73588,6,HOL1,2007-04-01,Vitesse,Feyenoord Rotterdam,0,1,-1,L
73589,6,HOL1,2007-04-06,Vitesse,Sparta Rotterdam,3,0,3,W
73590,6,HOL1,2007-04-07,Heerenveen,ADO Den Haag,1,1,0,D
73591,6,HOL1,2007-04-07,NEC Nijmegen,PSV Eindhoven,2,1,1,W
73592,6,HOL1,2007-04-07,Roda,Excelsior,2,0,2,W
73593,6,HOL1,2007-04-08,Feyenoord Rotterdam,Groningen,0,4,-4,L
73594,6,HOL1,2007-04-08,NAC Breda,AZ Alkmaar,1,4,-3,L
73595,6,HOL1,2007-04-08,Twente Enschede,Heracles,1,1,0,D
73596,6,HOL1,2007-04-08,Utrecht,Willem II,3,0,3,W
73597,6,HOL1,2007-04-08,Waalwijk,Ajax Amsterdam,2,2,0,D
73598,6,HOL1,2007-04-13,Ajax Amsterdam,NAC Breda,2,0,2,W
73599,6,HOL1,2007-04-13,Sparta Rotterdam,Utrecht,1,1,0,D
73600,6,HOL1,2007-04-14,ADO Den Haag,Roda,0,2,-2,L
73601,6,HOL1,2007-04-14,Excelsior,Waalwijk,0,3,-3,L
73602,6,HOL1,2007-04-14,PSV Eindhoven,Twente Enschede,2,0,2,W
73603,6,HOL1,2007-04-15,AZ Alkmaar,Vitesse,1,0,1,W
73604,6,HOL1,2007-04-15,Groningen,NEC Nijmegen,4,1,3,W
73605,6,HOL1,2007-04-15,Heracles,Feyenoord Rotterdam,4,1,3,W
73606,6,HOL1,2007-04-15,Willem II,Heerenveen,1,3,-2,L
73607,6,HOL1,2007-04-22,Ajax Amsterdam,Sparta Rotterdam,5,2,3,W
73608,6,HOL1,2007-04-22,AZ Alkmaar,Heerenveen,3,1,2,W
73609,6,HOL1,2007-04-22,Feyenoord Rotterdam,NEC Nijmegen,1,1,0,D
73610,6,HOL1,2007-04-22,Heracles,Excelsior,3,2,1,W
73611,6,HOL1,2007-04-22,NAC Breda,Roda,0,2,-2,L
73612,6,HOL1,2007-04-22,Utrecht,PSV Eindhoven,1,1,0,D
73613,6,HOL1,2007-04-22,Vitesse,Twente Enschede,1,1,0,D
73614,6,HOL1,2007-04-22,Waalwijk,Willem II,1,1,0,D
73615,6,HOL1,2007-04-25,ADO Den Haag,Groningen,1,3,-2,L
73616,6,HOL1,2007-04-29,Excelsior,AZ Alkmaar,3,2,1,W
73617,6,HOL1,2007-04-29,Groningen,Utrecht,0,2,-2,L
73618,6,HOL1,2007-04-29,Heerenveen,Feyenoord Rotterdam,5,1,4,W
73619,6,HOL1,2007-04-29,NEC Nijmegen,ADO Den Haag,3,2,1,W
73620,6,HOL1,2007-04-29,PSV Eindhoven,Vitesse,5,1,4,W
73621,6,HOL1,2007-04-29,Roda,Heracles,7,0,7,W
73622,6,HOL1,2007-04-29,Sparta Rotterdam,Waalwijk,1,0,1,W
73623,6,HOL1,2007-04-29,Twente Enschede,NAC Breda,2,1,1,W
73624,6,HOL1,2007-04-29,Willem II,Ajax Amsterdam,0,2,-2,L
73625,7,HOL1,2007-08-17,Heerenveen,Willem II,0,0,0,D
73626,7,HOL1,2007-08-18,AZ Alkmaar,VVV Venlo,4,0,4,W
73627,7,HOL1,2007-08-18,Excelsior,Twente Enschede,0,2,-2,L
73628,7,HOL1,2007-08-18,NAC Breda,Groningen,0,3,-3,L
73629,7,HOL1,2007-08-18,NEC Nijmegen,Roda,1,1,0,D
73630,7,HOL1,2007-08-19,De Graafschap,Ajax Amsterdam,1,8,-7,L
73631,7,HOL1,2007-08-19,Heracles,PSV Eindhoven,0,2,-2,L
73632,7,HOL1,2007-08-19,Sparta Rotterdam,Vitesse,1,2,-1,L
73633,7,HOL1,2007-08-19,Utrecht,Feyenoord Rotterdam,0,3,-3,L
73634,7,HOL1,2007-08-24,Roda,Heracles,2,1,1,W
73635,7,HOL1,2007-08-25,PSV Eindhoven,NEC Nijmegen,5,0,5,W
73636,7,HOL1,2007-08-25,Vitesse,AZ Alkmaar,1,0,1,W
73637,7,HOL1,2007-08-25,VVV Venlo,Excelsior,3,1,2,W
73638,7,HOL1,2007-08-25,Willem II,Sparta Rotterdam,2,2,0,D
73639,7,HOL1,2007-08-26,Ajax Amsterdam,Heerenveen,4,1,3,W
73640,7,HOL1,2007-08-26,Feyenoord Rotterdam,NAC Breda,5,0,5,W
73641,7,HOL1,2007-08-26,Groningen,De Graafschap,0,2,-2,L
73642,7,HOL1,2007-08-26,Twente Enschede,Utrecht,2,2,0,D
73643,7,HOL1,2007-08-31,AZ Alkmaar,Excelsior,3,0,3,W
73644,7,HOL1,2007-09-01,Feyenoord Rotterdam,Willem II,2,0,2,W
73645,7,HOL1,2007-09-01,Heerenveen,Sparta Rotterdam,3,3,0,D
73646,7,HOL1,2007-09-01,NAC Breda,Heracles,4,1,3,W
73647,7,HOL1,2007-09-01,Twente Enschede,PSV Eindhoven,0,0,0,D
73648,7,HOL1,2007-09-02,Ajax Amsterdam,Groningen,2,2,0,D
73649,7,HOL1,2007-09-02,Utrecht,De Graafschap,2,2,0,D
73650,7,HOL1,2007-09-02,Vitesse,NEC Nijmegen,1,0,1,W
73651,7,HOL1,2007-09-02,VVV Venlo,Roda,3,5,-2,L
73652,7,HOL1,2007-09-14,Groningen,Utrecht,0,2,-2,L
73653,7,HOL1,2007-09-15,Excelsior,Heerenveen,2,5,-3,L
73654,7,HOL1,2007-09-15,De Graafschap,VVV Venlo,3,2,1,W
73655,7,HOL1,2007-09-15,Heracles,Ajax Amsterdam,0,1,-1,L
73656,7,HOL1,2007-09-15,PSV Eindhoven,Vitesse,1,0,1,W
73657,7,HOL1,2007-09-16,NEC Nijmegen,NAC Breda,0,1,-1,L
73658,7,HOL1,2007-09-16,Roda,Feyenoord Rotterdam,1,3,-2,L
73659,7,HOL1,2007-09-16,Sparta Rotterdam,AZ Alkmaar,2,2,0,D
73660,7,HOL1,2007-09-16,Willem II,Twente Enschede,1,3,-2,L
73661,7,HOL1,2007-09-21,VVV Venlo,NAC Breda,1,3,-2,L
73662,7,HOL1,2007-09-22,Sparta Rotterdam,Heracles,1,1,0,D
73663,7,HOL1,2007-09-22,Vitesse,De Graafschap,0,2,-2,L
73664,7,HOL1,2007-09-22,Willem II,Roda,1,0,1,W
73665,7,HOL1,2007-09-23,AZ Alkmaar,Ajax Amsterdam,2,3,-1,L
73666,7,HOL1,2007-09-23,Excelsior,Groningen,1,3,-2,L
73667,7,HOL1,2007-09-23,Heerenveen,Utrecht,2,3,-1,L
73668,7,HOL1,2007-09-23,PSV Eindhoven,Feyenoord Rotterdam,4,0,4,W
73669,7,HOL1,2007-09-23,Twente Enschede,NEC Nijmegen,3,0,3,W
73670,7,HOL1,2007-09-29,Feyenoord Rotterdam,Heerenveen,2,0,2,W
73671,7,HOL1,2007-09-29,Groningen,Sparta Rotterdam,1,0,1,W
73672,7,HOL1,2007-09-29,NAC Breda,PSV Eindhoven,1,1,0,D
73673,7,HOL1,2007-09-29,Roda,Excelsior,3,3,0,D
73674,7,HOL1,2007-09-30,Ajax Amsterdam,VVV Venlo,6,1,5,W
73675,7,HOL1,2007-09-30,De Graafschap,Twente Enschede,0,0,0,D
73676,7,HOL1,2007-09-30,Heracles,AZ Alkmaar,2,1,1,W
73677,7,HOL1,2007-09-30,NEC Nijmegen,Willem II,1,0,1,W
73678,7,HOL1,2007-09-30,Utrecht,Vitesse,2,4,-2,L
73679,7,HOL1,2007-10-05,VVV Venlo,Utrecht,1,2,-1,L
73680,7,HOL1,2007-10-06,Excelsior,NEC Nijmegen,2,0,2,W
73681,7,HOL1,2007-10-06,NAC Breda,De Graafschap,1,0,1,W
73682,7,HOL1,2007-10-06,PSV Eindhoven,Willem II,3,0,3,W
73683,7,HOL1,2007-10-07,AZ Alkmaar,Groningen,2,2,0,D
73684,7,HOL1,2007-10-07,Heerenveen,Heracles,9,0,9,W
73685,7,HOL1,2007-10-07,Sparta Rotterdam,Ajax Amsterdam,2,2,0,D
73686,7,HOL1,2007-10-07,Twente Enschede,Roda,0,1,-1,L
73687,7,HOL1,2007-10-07,Vitesse,Feyenoord Rotterdam,0,1,-1,L
73688,7,HOL1,2007-10-19,De Graafschap,Sparta Rotterdam,4,0,4,W
73689,7,HOL1,2007-10-20,Ajax Amsterdam,NEC Nijmegen,0,0,0,D
73690,7,HOL1,2007-10-20,Feyenoord Rotterdam,Excelsior,1,0,1,W
73691,7,HOL1,2007-10-20,Heracles,Vitesse,2,2,0,D
73692,7,HOL1,2007-10-20,PSV Eindhoven,VVV Venlo,3,1,2,W
73693,7,HOL1,2007-10-21,AZ Alkmaar,Heerenveen,0,1,-1,L
73694,7,HOL1,2007-10-21,Groningen,Twente Enschede,1,0,1,W
73695,7,HOL1,2007-10-21,Roda,Utrecht,1,1,0,D
73696,7,HOL1,2007-10-21,Willem II,NAC Breda,0,0,0,D
73697,7,HOL1,2007-10-26,Vitesse,Willem II,1,0,1,W
73698,7,HOL1,2007-10-27,Excelsior,Heracles,1,1,0,D
73699,7,HOL1,2007-10-27,Roda,De Graafschap,1,0,1,W
73700,7,HOL1,2007-10-27,Twente Enschede,Feyenoord Rotterdam,2,0,2,W
73701,7,HOL1,2007-10-27,VVV Venlo,Heerenveen,0,4,-4,L
73702,7,HOL1,2007-10-28,NAC Breda,AZ Alkmaar,2,3,-1,L
73703,7,HOL1,2007-10-28,NEC Nijmegen,Groningen,5,1,4,W
73704,7,HOL1,2007-10-28,Sparta Rotterdam,PSV Eindhoven,1,4,-3,L
73705,7,HOL1,2007-10-28,Utrecht,Ajax Amsterdam,0,1,-1,L
73706,7,HOL1,2007-11-02,Willem II,VVV Venlo,1,2,-1,L
73707,7,HOL1,2007-11-03,AZ Alkmaar,NEC Nijmegen,4,0,4,W
73708,7,HOL1,2007-11-03,Excelsior,Sparta Rotterdam,4,3,1,W
73709,7,HOL1,2007-11-03,Heerenveen,PSV Eindhoven,2,1,1,W
73710,7,HOL1,2007-11-04,Ajax Amsterdam,Roda,4,2,2,W
73711,7,HOL1,2007-11-04,Feyenoord Rotterdam,De Graafschap,2,0,2,W
73712,7,HOL1,2007-11-04,Groningen,Vitesse,0,0,0,D
73713,7,HOL1,2007-11-04,Heracles,Twente Enschede,0,3,-3,L
73714,7,HOL1,2007-11-04,Utrecht,NAC Breda,0,1,-1,L
73715,7,HOL1,2007-11-09,NEC Nijmegen,Heracles,3,0,3,W
73716,7,HOL1,2007-11-10,De Graafschap,Excelsior,1,1,0,D
73717,7,HOL1,2007-11-10,Twente Enschede,NAC Breda,1,1,0,D
73718,7,HOL1,2007-11-10,VVV Venlo,Sparta Rotterdam,2,0,2,W
73719,7,HOL1,2007-11-10,Willem II,Utrecht,1,4,-3,L
73720,7,HOL1,2007-11-11,Feyenoord Rotterdam,Ajax Amsterdam,2,2,0,D
73721,7,HOL1,2007-11-11,PSV Eindhoven,AZ Alkmaar,1,1,0,D
73722,7,HOL1,2007-11-11,Roda,Groningen,5,1,4,W
73723,7,HOL1,2007-11-11,Vitesse,Heerenveen,0,1,-1,L
73724,7,HOL1,2007-11-23,NAC Breda,Roda,0,0,0,D
73725,7,HOL1,2007-11-24,AZ Alkmaar,Willem II,2,0,2,W
73726,7,HOL1,2007-11-24,Excelsior,PSV Eindhoven,1,4,-3,L
73727,7,HOL1,2007-11-24,Heerenveen,De Graafschap,2,3,-1,L
73728,7,HOL1,2007-11-24,Heracles,VVV Venlo,0,0,0,D
73729,7,HOL1,2007-11-25,Ajax Amsterdam,Vitesse,4,1,3,W
73730,7,HOL1,2007-11-25,Groningen,Feyenoord Rotterdam,3,2,1,W
73731,7,HOL1,2007-11-25,Sparta Rotterdam,Twente Enschede,1,1,0,D
73732,7,HOL1,2007-11-25,Utrecht,NEC Nijmegen,3,2,1,W
73733,7,HOL1,2007-11-30,Utrecht,Sparta Rotterdam,7,1,6,W
73734,7,HOL1,2007-12-01,De Graafschap,PSV Eindhoven,0,1,-1,L
73735,7,HOL1,2007-12-01,Groningen,VVV Venlo,1,0,1,W
73736,7,HOL1,2007-12-01,Roda,Vitesse,3,2,1,W
73737,7,HOL1,2007-12-01,Willem II,Excelsior,6,0,6,W
73738,7,HOL1,2007-12-02,Ajax Amsterdam,NAC Breda,1,3,-2,L
73739,7,HOL1,2007-12-02,Feyenoord Rotterdam,Heracles,6,0,6,W
73740,7,HOL1,2007-12-02,NEC Nijmegen,Heerenveen,0,1,-1,L
73741,7,HOL1,2007-12-02,Twente Enschede,AZ Alkmaar,2,1,1,W
73742,7,HOL1,2007-12-07,PSV Eindhoven,Roda,2,4,-2,L
73743,7,HOL1,2007-12-08,Excelsior,NAC Breda,0,3,-3,L
73744,7,HOL1,2007-12-08,Heracles,De Graafschap,2,0,2,W
73745,7,HOL1,2007-12-08,Vitesse,Twente Enschede,2,2,0,D
73746,7,HOL1,2007-12-08,Willem II,Ajax Amsterdam,2,3,-1,L
73747,7,HOL1,2007-12-09,AZ Alkmaar,Utrecht,2,1,1,W
73748,7,HOL1,2007-12-09,Heerenveen,Groningen,4,2,2,W
73749,7,HOL1,2007-12-09,Sparta Rotterdam,NEC Nijmegen,1,0,1,W
73750,7,HOL1,2007-12-09,VVV Venlo,Feyenoord Rotterdam,0,0,0,D
73751,7,HOL1,2007-12-14,Roda,Sparta Rotterdam,2,3,-1,L
73752,7,HOL1,2007-12-15,De Graafschap,NEC Nijmegen,1,1,0,D
73753,7,HOL1,2007-12-15,NAC Breda,Heerenveen,1,5,-4,L
73754,7,HOL1,2007-12-15,Twente Enschede,VVV Venlo,1,1,0,D
73755,7,HOL1,2007-12-16,Groningen,Willem II,1,0,1,W
73756,7,HOL1,2007-12-16,Utrecht,Heracles,3,1,2,W
73757,7,HOL1,2007-12-16,Vitesse,Excelsior,3,0,3,W
73758,7,HOL1,2007-12-21,Willem II,De Graafschap,1,2,-1,L
73759,7,HOL1,2007-12-22,Heerenveen,Twente Enschede,1,2,-1,L
73760,7,HOL1,2007-12-22,Heracles,Groningen,1,2,-1,L
73761,7,HOL1,2007-12-22,PSV Eindhoven,Utrecht,4,1,3,W
73762,7,HOL1,2007-12-23,AZ Alkmaar,Roda,1,1,0,D
73763,7,HOL1,2007-12-23,Excelsior,Ajax Amsterdam,2,1,1,W
73764,7,HOL1,2007-12-23,NEC Nijmegen,Feyenoord Rotterdam,0,2,-2,L
73765,7,HOL1,2007-12-23,VVV Venlo,Vitesse,2,0,2,W
73766,7,HOL1,2007-12-26,Feyenoord Rotterdam,Sparta Rotterdam,2,0,2,W
73767,7,HOL1,2007-12-26,Groningen,PSV Eindhoven,2,1,1,W
73768,7,HOL1,2007-12-26,NEC Nijmegen,VVV Venlo,2,2,0,D
73769,7,HOL1,2007-12-27,Ajax Amsterdam,Twente Enschede,2,2,0,D
73770,7,HOL1,2007-12-27,Heracles,Willem II,1,0,1,W
73771,7,HOL1,2007-12-27,NAC Breda,Vitesse,1,2,-1,L
73772,7,HOL1,2007-12-27,Roda,Heerenveen,1,0,1,W
73773,7,HOL1,2007-12-27,Utrecht,Excelsior,4,1,3,W
73774,7,HOL1,2007-12-29,Sparta Rotterdam,Groningen,1,3,-2,L
73775,7,HOL1,2007-12-30,AZ Alkmaar,Heracles,1,0,1,W
73776,7,HOL1,2007-12-30,Excelsior,Roda,1,2,-1,L
73777,7,HOL1,2007-12-30,Heerenveen,Feyenoord Rotterdam,1,1,0,D
73778,7,HOL1,2007-12-30,PSV Eindhoven,NAC Breda,2,0,2,W
73779,7,HOL1,2007-12-30,Twente Enschede,De Graafschap,2,0,2,W
73780,7,HOL1,2007-12-30,Vitesse,Utrecht,2,2,0,D
73781,7,HOL1,2007-12-30,VVV Venlo,Ajax Amsterdam,2,2,0,D
73782,7,HOL1,2007-12-30,Willem II,NEC Nijmegen,3,0,3,W
73783,7,HOL1,2008-01-11,NEC Nijmegen,Twente Enschede,2,2,0,D
73784,7,HOL1,2008-01-12,Feyenoord Rotterdam,PSV Eindhoven,0,1,-1,L
73785,7,HOL1,2008-01-12,Groningen,Excelsior,3,2,1,W
73786,7,HOL1,2008-01-12,NAC Breda,VVV Venlo,0,0,0,D
73787,7,HOL1,2008-01-12,Roda,Willem II,1,1,0,D
73788,7,HOL1,2008-01-13,Ajax Amsterdam,AZ Alkmaar,6,1,5,W
73789,7,HOL1,2008-01-13,De Graafschap,Vitesse,0,3,-3,L
73790,7,HOL1,2008-01-13,Heracles,Sparta Rotterdam,2,0,2,W
73791,7,HOL1,2008-01-13,Utrecht,Heerenveen,2,2,0,D
73792,7,HOL1,2008-01-16,De Graafschap,AZ Alkmaar,1,2,-1,L
73793,7,HOL1,2008-01-18,Excelsior,Feyenoord Rotterdam,2,1,1,W
73794,7,HOL1,2008-01-19,Heerenveen,AZ Alkmaar,4,0,4,W
73795,7,HOL1,2008-01-19,NAC Breda,Willem II,1,0,1,W
73796,7,HOL1,2008-01-19,Utrecht,Roda,3,1,2,W
73797,7,HOL1,2008-01-19,Vitesse,Heracles,2,0,2,W
73798,7,HOL1,2008-01-20,NEC Nijmegen,Ajax Amsterdam,1,1,0,D
73799,7,HOL1,2008-01-20,Sparta Rotterdam,De Graafschap,6,1,5,W
73800,7,HOL1,2008-01-20,Twente Enschede,Groningen,3,1,2,W
73801,7,HOL1,2008-01-20,VVV Venlo,PSV Eindhoven,1,1,0,D
73802,7,HOL1,2008-01-22,AZ Alkmaar,NAC Breda,1,2,-1,L
73803,7,HOL1,2008-01-22,Heracles,Excelsior,2,0,2,W
73804,7,HOL1,2008-01-22,Willem II,Vitesse,4,0,4,W
73805,7,HOL1,2008-01-23,Ajax Amsterdam,Utrecht,2,0,2,W
73806,7,HOL1,2008-01-23,De Graafschap,Roda,2,1,1,W
73807,7,HOL1,2008-01-23,Groningen,NEC Nijmegen,5,1,4,W
73808,7,HOL1,2008-01-23,Heerenveen,VVV Venlo,5,1,4,W
73809,7,HOL1,2008-01-23,PSV Eindhoven,Sparta Rotterdam,3,1,2,W
73810,7,HOL1,2008-01-24,Feyenoord Rotterdam,Twente Enschede,3,1,2,W
73811,7,HOL1,2008-01-25,Willem II,AZ Alkmaar,3,0,3,W
73812,7,HOL1,2008-01-26,De Graafschap,Heerenveen,0,3,-3,L
73813,7,HOL1,2008-01-26,PSV Eindhoven,Excelsior,2,1,1,W
73814,7,HOL1,2008-01-26,Roda,NAC Breda,0,2,-2,L
73815,7,HOL1,2008-01-27,Feyenoord Rotterdam,Groningen,1,1,0,D
73816,7,HOL1,2008-01-27,NEC Nijmegen,Utrecht,2,0,2,W
73817,7,HOL1,2008-01-27,Twente Enschede,Sparta Rotterdam,1,2,-1,L
73818,7,HOL1,2008-01-27,Vitesse,Ajax Amsterdam,2,2,0,D
73819,7,HOL1,2008-01-27,VVV Venlo,Heracles,0,5,-5,L
73820,7,HOL1,2008-01-30,Ajax Amsterdam,PSV Eindhoven,0,2,-2,L
73821,7,HOL1,2008-01-30,Feyenoord Rotterdam,AZ Alkmaar,2,2,0,D
73822,7,HOL1,2008-02-01,NAC Breda,Twente Enschede,1,0,1,W
73823,7,HOL1,2008-02-02,AZ Alkmaar,PSV Eindhoven,0,2,-2,L
73824,7,HOL1,2008-02-02,Excelsior,De Graafschap,1,1,0,D
73825,7,HOL1,2008-02-02,Heerenveen,Vitesse,7,0,7,W
73826,7,HOL1,2008-02-02,Heracles,NEC Nijmegen,0,2,-2,L
73827,7,HOL1,2008-02-03,Ajax Amsterdam,Feyenoord Rotterdam,3,0,3,W
73828,7,HOL1,2008-02-03,Groningen,Roda,1,1,0,D
73829,7,HOL1,2008-02-03,Sparta Rotterdam,VVV Venlo,2,0,2,W
73830,7,HOL1,2008-02-03,Utrecht,Willem II,2,0,2,W
73831,7,HOL1,2008-02-06,Sparta Rotterdam,NAC Breda,0,1,-1,L
73832,7,HOL1,2008-02-08,Twente Enschede,Heracles,2,1,1,W
73833,7,HOL1,2008-02-09,De Graafschap,Feyenoord Rotterdam,1,3,-2,L
73834,7,HOL1,2008-02-09,NAC Breda,Utrecht,1,0,1,W
73835,7,HOL1,2008-02-09,PSV Eindhoven,Heerenveen,1,1,0,D
73836,7,HOL1,2008-02-09,Vitesse,Groningen,2,1,1,W
73837,7,HOL1,2008-02-10,NEC Nijmegen,AZ Alkmaar,5,2,3,W
73838,7,HOL1,2008-02-10,Roda,Ajax Amsterdam,2,1,1,W
73839,7,HOL1,2008-02-10,Sparta Rotterdam,Excelsior,0,1,-1,L
73840,7,HOL1,2008-02-10,VVV Venlo,Willem II,1,1,0,D
73841,7,HOL1,2008-02-15,Ajax Amsterdam,Sparta Rotterdam,6,2,4,W
73842,7,HOL1,2008-02-16,Heracles,Heerenveen,2,2,0,D
73843,7,HOL1,2008-02-16,NEC Nijmegen,Excelsior,0,1,-1,L
73844,7,HOL1,2008-02-16,Roda,Twente Enschede,3,1,2,W
73845,7,HOL1,2008-02-16,Willem II,PSV Eindhoven,0,1,-1,L
73846,7,HOL1,2008-02-17,Feyenoord Rotterdam,Vitesse,1,0,1,W
73847,7,HOL1,2008-02-17,De Graafschap,NAC Breda,0,1,-1,L
73848,7,HOL1,2008-02-17,Groningen,AZ Alkmaar,2,1,1,W
73849,7,HOL1,2008-02-17,Utrecht,VVV Venlo,1,4,-3,L
73850,7,HOL1,2008-02-22,Sparta Rotterdam,Utrecht,2,1,1,W
73851,7,HOL1,2008-02-23,AZ Alkmaar,Twente Enschede,0,0,0,D
73852,7,HOL1,2008-02-23,Excelsior,Willem II,0,0,0,D
73853,7,HOL1,2008-02-23,Heracles,Feyenoord Rotterdam,3,3,0,D
73854,7,HOL1,2008-02-23,Vitesse,Roda,1,1,0,D
73855,7,HOL1,2008-02-24,Heerenveen,NEC Nijmegen,2,3,-1,L
73856,7,HOL1,2008-02-24,NAC Breda,Ajax Amsterdam,2,3,-1,L
73857,7,HOL1,2008-02-24,PSV Eindhoven,De Graafschap,4,1,3,W
73858,7,HOL1,2008-02-24,VVV Venlo,Groningen,2,5,-3,L
73859,7,HOL1,2008-02-29,Vitesse,VVV Venlo,1,3,-2,L
73860,7,HOL1,2008-03-01,De Graafschap,Willem II,1,2,-1,L
73861,7,HOL1,2008-03-01,NAC Breda,Sparta Rotterdam,3,0,3,W
73862,7,HOL1,2008-03-01,Roda,AZ Alkmaar,1,1,0,D
73863,7,HOL1,2008-03-01,Twente Enschede,Heerenveen,1,0,1,W
73864,7,HOL1,2008-03-02,Ajax Amsterdam,Excelsior,4,0,4,W
73865,7,HOL1,2008-03-02,Feyenoord Rotterdam,NEC Nijmegen,1,3,-2,L
73866,7,HOL1,2008-03-02,Groningen,Heracles,1,2,-1,L
73867,7,HOL1,2008-03-02,Utrecht,PSV Eindhoven,3,1,2,W
73868,7,HOL1,2008-03-07,Heracles,Utrecht,2,1,1,W
73869,7,HOL1,2008-03-08,Excelsior,Vitesse,1,2,-1,L
73870,7,HOL1,2008-03-08,Heerenveen,NAC Breda,3,0,3,W
73871,7,HOL1,2008-03-08,NEC Nijmegen,De Graafschap,3,1,2,W
73872,7,HOL1,2008-03-08,Willem II,Groningen,1,2,-1,L
73873,7,HOL1,2008-03-09,Sparta Rotterdam,Roda,4,1,3,W
73874,7,HOL1,2008-03-11,VVV Venlo,Twente Enschede,0,2,-2,L
73875,7,HOL1,2008-03-12,AZ Alkmaar,Feyenoord Rotterdam,0,1,-1,L
73876,7,HOL1,2008-03-14,Groningen,Heerenveen,0,1,-1,L
73877,7,HOL1,2008-03-15,Feyenoord Rotterdam,VVV Venlo,4,1,3,W
73878,7,HOL1,2008-03-15,De Graafschap,Heracles,0,0,0,D
73879,7,HOL1,2008-03-15,NAC Breda,Excelsior,2,0,2,W
73880,7,HOL1,2008-03-15,Twente Enschede,Vitesse,4,3,1,W
73881,7,HOL1,2008-03-16,Ajax Amsterdam,Willem II,4,1,3,W
73882,7,HOL1,2008-03-16,NEC Nijmegen,Sparta Rotterdam,4,2,2,W
73883,7,HOL1,2008-03-16,Roda,PSV Eindhoven,1,1,0,D
73884,7,HOL1,2008-03-16,Utrecht,AZ Alkmaar,2,2,0,D
73885,7,HOL1,2008-03-19,PSV Eindhoven,Ajax Amsterdam,0,0,0,D
73886,7,HOL1,2008-03-21,Vitesse,NAC Breda,3,3,0,D
73887,7,HOL1,2008-03-22,AZ Alkmaar,De Graafschap,0,0,0,D
73888,7,HOL1,2008-03-22,Excelsior,Utrecht,0,2,-2,L
73889,7,HOL1,2008-03-22,Heerenveen,Roda,4,3,1,W
73890,7,HOL1,2008-03-22,PSV Eindhoven,Groningen,3,0,3,W
73891,7,HOL1,2008-03-23,Sparta Rotterdam,Feyenoord Rotterdam,3,2,1,W
73892,7,HOL1,2008-03-23,Twente Enschede,Ajax Amsterdam,2,1,1,W
73893,7,HOL1,2008-03-23,VVV Venlo,NEC Nijmegen,1,2,-1,L
73894,7,HOL1,2008-03-23,Willem II,Heracles,2,1,1,W
73895,7,HOL1,2008-03-28,De Graafschap,Groningen,1,1,0,D
73896,7,HOL1,2008-03-29,Excelsior,VVV Venlo,2,1,1,W
73897,7,HOL1,2008-03-29,Heerenveen,Ajax Amsterdam,2,4,-2,L
73898,7,HOL1,2008-03-29,Heracles,Roda,0,0,0,D
73899,7,HOL1,2008-03-29,NEC Nijmegen,PSV Eindhoven,0,0,0,D
73900,7,HOL1,2008-03-30,AZ Alkmaar,Vitesse,2,1,1,W
73901,7,HOL1,2008-03-30,NAC Breda,Feyenoord Rotterdam,3,1,2,W
73902,7,HOL1,2008-03-30,Sparta Rotterdam,Willem II,2,2,0,D
73903,7,HOL1,2008-03-30,Utrecht,Twente Enschede,0,1,-1,L
73904,7,HOL1,2008-04-04,Roda,NEC Nijmegen,0,2,-2,L
73905,7,HOL1,2008-04-05,Twente Enschede,Excelsior,1,0,1,W
73906,7,HOL1,2008-04-05,Vitesse,Sparta Rotterdam,3,0,3,W
73907,7,HOL1,2008-04-05,Willem II,Heerenveen,2,3,-1,L
73908,7,HOL1,2008-04-06,Ajax Amsterdam,De Graafschap,4,1,3,W
73909,7,HOL1,2008-04-06,Feyenoord Rotterdam,Utrecht,3,1,2,W
73910,7,HOL1,2008-04-06,Groningen,NAC Breda,1,2,-1,L
73911,7,HOL1,2008-04-06,PSV Eindhoven,Heracles,2,0,2,W
73912,7,HOL1,2008-04-06,VVV Venlo,AZ Alkmaar,2,3,-1,L
73913,7,HOL1,2008-04-13,Excelsior,AZ Alkmaar,1,1,0,D
73914,7,HOL1,2008-04-13,De Graafschap,Utrecht,1,1,0,D
73915,7,HOL1,2008-04-13,Heracles,NAC Breda,0,1,-1,L
73916,7,HOL1,2008-04-13,NEC Nijmegen,Vitesse,1,0,1,W
73917,7,HOL1,2008-04-13,PSV Eindhoven,Twente Enschede,1,1,0,D
73918,7,HOL1,2008-04-13,Roda,VVV Venlo,4,1,3,W
73919,7,HOL1,2008-04-13,Sparta Rotterdam,Heerenveen,4,2,2,W
73920,7,HOL1,2008-04-13,Willem II,Feyenoord Rotterdam,3,1,2,W
73921,7,HOL1,2008-04-16,Groningen,Ajax Amsterdam,1,2,-1,L
73922,7,HOL1,2008-04-20,Ajax Amsterdam,Heracles,5,1,4,W
73923,7,HOL1,2008-04-20,AZ Alkmaar,Sparta Rotterdam,1,0,1,W
73924,7,HOL1,2008-04-20,Feyenoord Rotterdam,Roda,3,0,3,W
73925,7,HOL1,2008-04-20,Heerenveen,Excelsior,5,0,5,W
73926,7,HOL1,2008-04-20,NAC Breda,NEC Nijmegen,1,3,-2,L
73927,7,HOL1,2008-04-20,Twente Enschede,Willem II,2,0,2,W
73928,7,HOL1,2008-04-20,Utrecht,Groningen,1,0,1,W
73929,7,HOL1,2008-04-20,Vitesse,PSV Eindhoven,0,1,-1,L
73930,7,HOL1,2008-04-20,VVV Venlo,De Graafschap,3,0,3,W
73931,8,HOL1,2008-08-29,Vitesse,Groningen,0,4,-4,L
73932,8,HOL1,2008-08-30,NEC Nijmegen,De Graafschap,2,0,2,W
73933,8,HOL1,2008-08-30,Roda,Twente Enschede,1,1,0,D
73934,8,HOL1,2008-08-30,Utrecht,PSV Eindhoven,1,5,-4,L
73935,8,HOL1,2008-08-30,Willem II,Ajax Amsterdam,2,1,1,W
73936,8,HOL1,2008-08-31,AZ Alkmaar,NAC Breda,1,2,-1,L
73937,8,HOL1,2008-08-31,Heracles,Feyenoord Rotterdam,3,1,2,W
73938,8,HOL1,2008-08-31,Sparta Rotterdam,ADO Den Haag,2,5,-3,L
73939,8,HOL1,2008-08-31,Volendam,Heerenveen,2,3,-1,L
73940,8,HOL1,2008-09-12,Heerenveen,Heracles,2,2,0,D
73941,8,HOL1,2008-09-13,ADO Den Haag,AZ Alkmaar,3,0,3,W
73942,8,HOL1,2008-09-13,Feyenoord Rotterdam,Volendam,5,0,5,W
73943,8,HOL1,2008-09-13,PSV Eindhoven,Sparta Rotterdam,1,0,1,W
73944,8,HOL1,2008-09-13,Twente Enschede,NEC Nijmegen,1,1,0,D
73945,8,HOL1,2008-09-14,Ajax Amsterdam,Roda,1,0,1,W
73946,8,HOL1,2008-09-14,De Graafschap,Vitesse,1,0,1,W
73947,8,HOL1,2008-09-14,Groningen,Utrecht,2,0,2,W
73948,8,HOL1,2008-09-14,NAC Breda,Willem II,1,3,-2,L
73949,8,HOL1,2008-09-19,Utrecht,Willem II,1,0,1,W
73950,8,HOL1,2008-09-20,AZ Alkmaar,PSV Eindhoven,1,0,1,W
73951,8,HOL1,2008-09-20,Heracles,Groningen,1,1,0,D
73952,8,HOL1,2008-09-20,Vitesse,Sparta Rotterdam,1,1,0,D
73953,8,HOL1,2008-09-21,Feyenoord Rotterdam,Ajax Amsterdam,2,2,0,D
73954,8,HOL1,2008-09-21,De Graafschap,ADO Den Haag,2,0,2,W
73955,8,HOL1,2008-09-21,Heerenveen,NEC Nijmegen,2,1,1,W
73956,8,HOL1,2008-09-21,Roda,NAC Breda,0,3,-3,L
73957,8,HOL1,2008-09-21,Volendam,Twente Enschede,1,2,-1,L
73958,8,HOL1,2008-09-27,NAC Breda,Heerenveen,4,2,2,W
73959,8,HOL1,2008-09-27,PSV Eindhoven,Volendam,1,0,1,W
73960,8,HOL1,2008-09-27,Twente Enschede,De Graafschap,3,0,3,W
73961,8,HOL1,2008-09-27,Willem II,AZ Alkmaar,2,5,-3,L
73962,8,HOL1,2008-09-28,Ajax Amsterdam,Vitesse,3,0,3,W
73963,8,HOL1,2008-09-28,ADO Den Haag,Utrecht,0,0,0,D
73964,8,HOL1,2008-09-28,Groningen,Feyenoord Rotterdam,3,1,2,W
73965,8,HOL1,2008-09-28,NEC Nijmegen,Heracles,1,1,0,D
73966,8,HOL1,2008-09-28,Sparta Rotterdam,Roda,2,2,0,D
73967,8,HOL1,2008-10-03,AZ Alkmaar,Sparta Rotterdam,6,0,6,W
73968,8,HOL1,2008-10-04,Heracles,Roda,2,0,2,W
73969,8,HOL1,2008-10-04,PSV Eindhoven,De Graafschap,3,0,3,W
73970,8,HOL1,2008-10-04,Vitesse,Willem II,2,2,0,D
73971,8,HOL1,2008-10-05,Feyenoord Rotterdam,NEC Nijmegen,0,2,-2,L
73972,8,HOL1,2008-10-05,Groningen,ADO Den Haag,3,0,3,W
73973,8,HOL1,2008-10-05,Heerenveen,Ajax Amsterdam,5,2,3,W
73974,8,HOL1,2008-10-05,Utrecht,Twente Enschede,3,0,3,W
73975,8,HOL1,2008-10-05,Volendam,NAC Breda,2,4,-2,L
73976,8,HOL1,2008-10-17,ADO Den Haag,Volendam,2,0,2,W
73977,8,HOL1,2008-10-18,Ajax Amsterdam,Groningen,1,0,1,W
73978,8,HOL1,2008-10-18,NAC Breda,PSV Eindhoven,2,1,1,W
73979,8,HOL1,2008-10-18,Roda,Heerenveen,2,2,0,D
73980,8,HOL1,2008-10-18,Twente Enschede,Heracles,2,0,2,W
73981,8,HOL1,2008-10-19,De Graafschap,AZ Alkmaar,0,2,-2,L
73982,8,HOL1,2008-10-19,NEC Nijmegen,Vitesse,3,1,2,W
73983,8,HOL1,2008-10-19,Sparta Rotterdam,Utrecht,1,0,1,W
73984,8,HOL1,2008-10-19,Willem II,Feyenoord Rotterdam,1,0,1,W
73985,8,HOL1,2008-10-24,Heracles,ADO Den Haag,3,1,2,W
73986,8,HOL1,2008-10-25,AZ Alkmaar,Volendam,3,0,3,W
73987,8,HOL1,2008-10-25,Groningen,Sparta Rotterdam,3,0,3,W
73988,8,HOL1,2008-10-25,PSV Eindhoven,Roda,2,3,-1,L
73989,8,HOL1,2008-10-25,Willem II,De Graafschap,1,1,0,D
73990,8,HOL1,2008-10-26,Ajax Amsterdam,NEC Nijmegen,2,0,2,W
73991,8,HOL1,2008-10-26,Feyenoord Rotterdam,Heerenveen,2,2,0,D
73992,8,HOL1,2008-10-26,Utrecht,NAC Breda,0,0,0,D
73993,8,HOL1,2008-10-26,Vitesse,Twente Enschede,0,2,-2,L
73994,8,HOL1,2008-10-28,ADO Den Haag,PSV Eindhoven,0,2,-2,L
73995,8,HOL1,2008-10-28,Roda,AZ Alkmaar,0,2,-2,L
73996,8,HOL1,2008-10-28,Volendam,Willem II,2,2,0,D
73997,8,HOL1,2008-10-29,Heerenveen,Vitesse,0,2,-2,L
73998,8,HOL1,2008-10-29,Heracles,Ajax Amsterdam,1,3,-2,L
73999,8,HOL1,2008-10-29,NAC Breda,Twente Enschede,0,1,-1,L
74000,8,HOL1,2008-10-29,NEC Nijmegen,Groningen,2,2,0,D
74001,8,HOL1,2008-10-29,Sparta Rotterdam,Feyenoord Rotterdam,2,1,1,W
74002,8,HOL1,2008-10-30,De Graafschap,Utrecht,0,2,-2,L
74003,8,HOL1,2008-11-01,Heerenveen,AZ Alkmaar,3,3,0,D
74004,8,HOL1,2008-11-01,NAC Breda,Groningen,1,0,1,W
74005,8,HOL1,2008-11-01,PSV Eindhoven,Willem II,2,0,2,W
74006,8,HOL1,2008-11-01,Twente Enschede,Ajax Amsterdam,0,2,-2,L
74007,8,HOL1,2008-11-02,Roda,Feyenoord Rotterdam,0,4,-4,L
74008,8,HOL1,2008-11-02,Sparta Rotterdam,NEC Nijmegen,0,2,-2,L
74009,8,HOL1,2008-11-02,Utrecht,Heracles,2,0,2,W
74010,8,HOL1,2008-11-02,Vitesse,ADO Den Haag,3,1,2,W
74011,8,HOL1,2008-11-02,Volendam,De Graafschap,3,1,2,W
74012,8,HOL1,2008-11-07,De Graafschap,NAC Breda,0,2,-2,L
74013,8,HOL1,2008-11-08,Heracles,Vitesse,0,0,0,D
74014,8,HOL1,2008-11-08,NEC Nijmegen,PSV Eindhoven,1,0,1,W
74015,8,HOL1,2008-11-08,Willem II,Roda,2,1,1,W
74016,8,HOL1,2008-11-09,Ajax Amsterdam,Sparta Rotterdam,5,2,3,W
74017,8,HOL1,2008-11-09,AZ Alkmaar,Twente Enschede,3,0,3,W
74018,8,HOL1,2008-11-09,ADO Den Haag,Heerenveen,0,1,-1,L
74019,8,HOL1,2008-11-09,Feyenoord Rotterdam,Utrecht,5,2,3,W
74020,8,HOL1,2008-11-09,Groningen,Volendam,5,0,5,W
74021,8,HOL1,2008-11-14,NAC Breda,Heracles,3,0,3,W
74022,8,HOL1,2008-11-15,ADO Den Haag,Willem II,0,1,-1,L
74023,8,HOL1,2008-11-15,Heerenveen,Utrecht,3,2,1,W
74024,8,HOL1,2008-11-15,Roda,NEC Nijmegen,3,0,3,W
74025,8,HOL1,2008-11-15,Sparta Rotterdam,Volendam,4,0,4,W
74026,8,HOL1,2008-11-16,Ajax Amsterdam,PSV Eindhoven,4,1,3,W
74027,8,HOL1,2008-11-16,Groningen,De Graafschap,3,0,3,W
74028,8,HOL1,2008-11-16,Twente Enschede,Feyenoord Rotterdam,1,1,0,D
74029,8,HOL1,2008-11-16,Vitesse,AZ Alkmaar,1,1,0,D
74030,8,HOL1,2008-11-21,Volendam,Roda,3,1,2,W
74031,8,HOL1,2008-11-22,De Graafschap,Sparta Rotterdam,3,3,0,D
74032,8,HOL1,2008-11-22,NAC Breda,NEC Nijmegen,1,1,0,D
74033,8,HOL1,2008-11-22,PSV Eindhoven,Heracles,4,0,4,W
74034,8,HOL1,2008-11-22,Twente Enschede,Heerenveen,6,0,6,W
74035,8,HOL1,2008-11-23,AZ Alkmaar,Ajax Amsterdam,2,0,2,W
74036,8,HOL1,2008-11-23,Feyenoord Rotterdam,ADO Den Haag,3,1,2,W
74037,8,HOL1,2008-11-23,Utrecht,Vitesse,4,0,4,W
74038,8,HOL1,2008-11-23,Willem II,Groningen,3,0,3,W
74039,8,HOL1,2008-11-28,Groningen,AZ Alkmaar,0,2,-2,L
74040,8,HOL1,2008-11-29,ADO Den Haag,Twente Enschede,1,2,-1,L
74041,8,HOL1,2008-11-29,De Graafschap,Roda,1,1,0,D
74042,8,HOL1,2008-11-29,Heerenveen,PSV Eindhoven,2,2,0,D
74043,8,HOL1,2008-11-29,Heracles,Willem II,1,0,1,W
74044,8,HOL1,2008-11-30,Ajax Amsterdam,Utrecht,1,1,0,D
74045,8,HOL1,2008-11-30,NEC Nijmegen,Volendam,6,1,5,W
74046,8,HOL1,2008-11-30,Sparta Rotterdam,NAC Breda,4,0,4,W
74047,8,HOL1,2008-11-30,Vitesse,Feyenoord Rotterdam,1,1,0,D
74048,8,HOL1,2008-12-06,AZ Alkmaar,Heracles,2,0,2,W
74049,8,HOL1,2008-12-06,PSV Eindhoven,Groningen,4,2,2,W
74050,8,HOL1,2008-12-06,Roda,Vitesse,3,0,3,W
74051,8,HOL1,2008-12-06,Twente Enschede,Sparta Rotterdam,6,2,4,W
74052,8,HOL1,2008-12-07,Feyenoord Rotterdam,De Graafschap,1,3,-2,L
74053,8,HOL1,2008-12-07,NAC Breda,ADO Den Haag,0,4,-4,L
74054,8,HOL1,2008-12-07,NEC Nijmegen,Utrecht,1,2,-1,L
74055,8,HOL1,2008-12-07,Volendam,Ajax Amsterdam,1,2,-1,L
74056,8,HOL1,2008-12-07,Willem II,Heerenveen,1,3,-2,L
74057,8,HOL1,2008-12-12,Ajax Amsterdam,NAC Breda,3,0,3,W
74058,8,HOL1,2008-12-13,ADO Den Haag,Roda,1,1,0,D
74059,8,HOL1,2008-12-13,Feyenoord Rotterdam,AZ Alkmaar,0,1,-1,L
74060,8,HOL1,2008-12-13,Heerenveen,De Graafschap,2,0,2,W
74061,8,HOL1,2008-12-13,Willem II,NEC Nijmegen,1,2,-1,L
74062,8,HOL1,2008-12-14,Groningen,Twente Enschede,1,4,-3,L
74063,8,HOL1,2008-12-14,Heracles,Sparta Rotterdam,2,1,1,W
74064,8,HOL1,2008-12-14,Utrecht,Volendam,0,0,0,D
74065,8,HOL1,2008-12-14,Vitesse,PSV Eindhoven,1,1,0,D
74066,8,HOL1,2008-12-19,AZ Alkmaar,Utrecht,2,0,2,W
74067,8,HOL1,2008-12-20,NAC Breda,Vitesse,2,0,2,W
74068,8,HOL1,2008-12-20,Roda,Groningen,2,5,-3,L
74069,8,HOL1,2008-12-20,Sparta Rotterdam,Heerenveen,4,1,3,W
74070,8,HOL1,2008-12-21,De Graafschap,Ajax Amsterdam,0,6,-6,L
74071,8,HOL1,2008-12-21,NEC Nijmegen,ADO Den Haag,0,0,0,D
74072,8,HOL1,2008-12-21,PSV Eindhoven,Feyenoord Rotterdam,1,0,1,W
74073,8,HOL1,2008-12-21,Twente Enschede,Willem II,2,0,2,W
74074,8,HOL1,2008-12-21,Volendam,Heracles,3,1,2,W
74075,8,HOL1,2008-12-26,Feyenoord Rotterdam,NAC Breda,3,1,2,W
74076,8,HOL1,2008-12-27,Heracles,De Graafschap,0,0,0,D
74077,8,HOL1,2008-12-27,PSV Eindhoven,Twente Enschede,0,0,0,D
74078,8,HOL1,2008-12-27,Vitesse,Volendam,3,1,2,W
74079,8,HOL1,2008-12-27,Willem II,Sparta Rotterdam,3,2,1,W
74080,8,HOL1,2008-12-28,Ajax Amsterdam,ADO Den Haag,3,0,3,W
74081,8,HOL1,2008-12-28,AZ Alkmaar,NEC Nijmegen,1,0,1,W
74082,8,HOL1,2008-12-28,Groningen,Heerenveen,2,3,-1,L
74083,8,HOL1,2008-12-28,Utrecht,Roda,3,1,2,W
74084,8,HOL1,2009-01-16,Heerenveen,Feyenoord Rotterdam,3,1,2,W
74085,8,HOL1,2009-01-17,ADO Den Haag,Heracles,2,2,0,D
74086,8,HOL1,2009-01-17,De Graafschap,Willem II,1,0,1,W
74087,8,HOL1,2009-01-17,NAC Breda,Utrecht,1,1,0,D
74088,8,HOL1,2009-01-17,Twente Enschede,Vitesse,2,1,1,W
74089,8,HOL1,2009-01-18,NEC Nijmegen,Ajax Amsterdam,2,4,-2,L
74090,8,HOL1,2009-01-18,Roda,PSV Eindhoven,1,1,0,D
74091,8,HOL1,2009-01-18,Sparta Rotterdam,Groningen,1,1,0,D
74092,8,HOL1,2009-01-18,Volendam,AZ Alkmaar,0,2,-2,L
74093,8,HOL1,2009-01-24,AZ Alkmaar,De Graafschap,2,0,2,W
74094,8,HOL1,2009-01-24,Feyenoord Rotterdam,Willem II,1,1,0,D
74095,8,HOL1,2009-01-24,Heerenveen,Roda,2,0,2,W
74096,8,HOL1,2009-01-24,PSV Eindhoven,NAC Breda,2,2,0,D
74097,8,HOL1,2009-01-25,Groningen,Ajax Amsterdam,1,0,1,W
74098,8,HOL1,2009-01-25,Heracles,Twente Enschede,1,2,-1,L
74099,8,HOL1,2009-01-25,Utrecht,Sparta Rotterdam,3,3,0,D
74100,8,HOL1,2009-01-25,Vitesse,NEC Nijmegen,0,0,0,D
74101,8,HOL1,2009-01-25,Volendam,ADO Den Haag,0,1,-1,L
74102,8,HOL1,2009-01-30,Roda,Heracles,3,1,2,W
74103,8,HOL1,2009-01-31,Ajax Amsterdam,Heerenveen,0,1,-1,L
74104,8,HOL1,2009-01-31,ADO Den Haag,Groningen,0,1,-1,L
74105,8,HOL1,2009-01-31,NAC Breda,Volendam,1,1,0,D
74106,8,HOL1,2009-01-31,Willem II,Vitesse,0,2,-2,L
74107,8,HOL1,2009-02-01,De Graafschap,PSV Eindhoven,0,3,-3,L
74108,8,HOL1,2009-02-01,NEC Nijmegen,Feyenoord Rotterdam,1,0,1,W
74109,8,HOL1,2009-02-01,Sparta Rotterdam,AZ Alkmaar,0,2,-2,L
74110,8,HOL1,2009-02-01,Twente Enschede,Utrecht,0,0,0,D
74111,8,HOL1,2009-02-03,Ajax Amsterdam,Heracles,2,2,0,D
74112,8,HOL1,2009-02-03,Vitesse,Heerenveen,1,0,1,W
74113,8,HOL1,2009-02-03,Willem II,Volendam,1,2,-1,L
74114,8,HOL1,2009-02-04,AZ Alkmaar,Roda,1,0,1,W
74115,8,HOL1,2009-02-04,Feyenoord Rotterdam,Sparta Rotterdam,1,0,1,W
74116,8,HOL1,2009-02-04,Groningen,NEC Nijmegen,2,0,2,W
74117,8,HOL1,2009-02-04,Twente Enschede,NAC Breda,4,1,3,W
74118,8,HOL1,2009-02-04,Utrecht,De Graafschap,3,0,3,W
74119,8,HOL1,2009-02-05,PSV Eindhoven,ADO Den Haag,6,0,6,W
74120,8,HOL1,2009-02-07,AZ Alkmaar,Willem II,3,1,2,W
74121,8,HOL1,2009-02-07,Heerenveen,NAC Breda,3,1,2,W
74122,8,HOL1,2009-02-07,Heracles,NEC Nijmegen,1,1,0,D
74123,8,HOL1,2009-02-07,Roda,Sparta Rotterdam,0,1,-1,L
74124,8,HOL1,2009-02-08,Feyenoord Rotterdam,Groningen,0,0,0,D
74125,8,HOL1,2009-02-08,De Graafschap,Twente Enschede,2,2,0,D
74126,8,HOL1,2009-02-08,Utrecht,ADO Den Haag,3,1,2,W
74127,8,HOL1,2009-02-08,Vitesse,Ajax Amsterdam,4,1,3,W
74128,8,HOL1,2009-02-08,Volendam,PSV Eindhoven,3,5,-2,L
74129,8,HOL1,2009-02-13,Willem II,Utrecht,0,2,-2,L
74130,8,HOL1,2009-02-14,ADO Den Haag,De Graafschap,1,0,1,W
74131,8,HOL1,2009-02-14,NAC Breda,Roda,1,0,1,W
74132,8,HOL1,2009-02-14,PSV Eindhoven,AZ Alkmaar,2,2,0,D
74133,8,HOL1,2009-02-14,Twente Enschede,Volendam,2,1,1,W
74134,8,HOL1,2009-02-15,Ajax Amsterdam,Feyenoord Rotterdam,2,0,2,W
74135,8,HOL1,2009-02-15,Groningen,Heracles,2,0,2,W
74136,8,HOL1,2009-02-15,NEC Nijmegen,Heerenveen,1,1,0,D
74137,8,HOL1,2009-02-15,Sparta Rotterdam,Vitesse,0,0,0,D
74138,8,HOL1,2009-02-20,Vitesse,Roda,3,0,3,W
74139,8,HOL1,2009-02-21,ADO Den Haag,NAC Breda,1,1,0,D
74140,8,HOL1,2009-02-21,Groningen,PSV Eindhoven,0,1,-1,L
74141,8,HOL1,2009-02-21,Heerenveen,Willem II,3,1,2,W
74142,8,HOL1,2009-02-21,Heracles,AZ Alkmaar,0,2,-2,L
74143,8,HOL1,2009-02-22,Ajax Amsterdam,Volendam,2,1,1,W
74144,8,HOL1,2009-02-22,De Graafschap,Feyenoord Rotterdam,0,2,-2,L
74145,8,HOL1,2009-02-22,Sparta Rotterdam,Twente Enschede,1,2,-1,L
74146,8,HOL1,2009-02-22,Utrecht,NEC Nijmegen,0,2,-2,L
74147,8,HOL1,2009-02-27,PSV Eindhoven,Heerenveen,2,3,-1,L
74148,8,HOL1,2009-02-28,AZ Alkmaar,Groningen,3,0,3,W
74149,8,HOL1,2009-02-28,NAC Breda,Sparta Rotterdam,3,1,2,W
74150,8,HOL1,2009-02-28,Roda,De Graafschap,3,1,2,W
74151,8,HOL1,2009-02-28,Willem II,Heracles,0,3,-3,L
74152,8,HOL1,2009-03-01,Feyenoord Rotterdam,Vitesse,2,2,0,D
74153,8,HOL1,2009-03-01,Twente Enschede,ADO Den Haag,1,0,1,W
74154,8,HOL1,2009-03-01,Utrecht,Ajax Amsterdam,0,2,-2,L
74155,8,HOL1,2009-03-01,Volendam,NEC Nijmegen,1,1,0,D
74156,8,HOL1,2009-03-06,Sparta Rotterdam,Willem II,0,1,-1,L
74157,8,HOL1,2009-03-07,De Graafschap,Heracles,1,0,1,W
74158,8,HOL1,2009-03-07,Heerenveen,Groningen,2,1,1,W
74159,8,HOL1,2009-03-07,Twente Enschede,PSV Eindhoven,1,1,0,D
74160,8,HOL1,2009-03-08,ADO Den Haag,Ajax Amsterdam,1,1,0,D
74161,8,HOL1,2009-03-08,NAC Breda,Feyenoord Rotterdam,1,2,-1,L
74162,8,HOL1,2009-03-08,NEC Nijmegen,AZ Alkmaar,0,1,-1,L
74163,8,HOL1,2009-03-08,Roda,Utrecht,0,0,0,D
74164,8,HOL1,2009-03-08,Volendam,Vitesse,1,0,1,W
74165,8,HOL1,2009-03-13,Groningen,Roda,2,0,2,W
74166,8,HOL1,2009-03-14,Heerenveen,Sparta Rotterdam,5,1,4,W
74167,8,HOL1,2009-03-14,Heracles,Volendam,1,1,0,D
74168,8,HOL1,2009-03-14,Vitesse,NAC Breda,0,3,-3,L
74169,8,HOL1,2009-03-14,Willem II,Twente Enschede,0,2,-2,L
74170,8,HOL1,2009-03-15,Ajax Amsterdam,De Graafschap,3,0,3,W
74171,8,HOL1,2009-03-15,ADO Den Haag,NEC Nijmegen,3,0,3,W
74172,8,HOL1,2009-03-15,Feyenoord Rotterdam,PSV Eindhoven,1,0,1,W
74173,8,HOL1,2009-03-15,Utrecht,AZ Alkmaar,0,1,-1,L
74174,8,HOL1,2009-03-20,De Graafschap,Heerenveen,2,0,2,W
74175,8,HOL1,2009-03-21,NEC Nijmegen,Willem II,0,0,0,D
74176,8,HOL1,2009-03-21,PSV Eindhoven,Vitesse,2,0,2,W
74177,8,HOL1,2009-03-21,Sparta Rotterdam,Heracles,1,0,1,W
74178,8,HOL1,2009-03-22,AZ Alkmaar,Feyenoord Rotterdam,0,0,0,D
74179,8,HOL1,2009-03-22,NAC Breda,Ajax Amsterdam,0,3,-3,L
74180,8,HOL1,2009-03-22,Roda,ADO Den Haag,2,0,2,W
74181,8,HOL1,2009-03-22,Twente Enschede,Groningen,2,1,1,W
74182,8,HOL1,2009-03-22,Volendam,Utrecht,0,0,0,D
74183,8,HOL1,2009-04-03,NEC Nijmegen,Twente Enschede,1,1,0,D
74184,8,HOL1,2009-04-04,AZ Alkmaar,ADO Den Haag,4,1,3,W
74185,8,HOL1,2009-04-04,Heracles,Heerenveen,1,1,0,D
74186,8,HOL1,2009-04-04,Sparta Rotterdam,PSV Eindhoven,0,2,-2,L
74187,8,HOL1,2009-04-04,Utrecht,Groningen,0,1,-1,L
74188,8,HOL1,2009-04-05,Roda,Ajax Amsterdam,1,2,-1,L
74189,8,HOL1,2009-04-05,Vitesse,De Graafschap,0,0,0,D
74190,8,HOL1,2009-04-05,Volendam,Feyenoord Rotterdam,2,1,1,W
74191,8,HOL1,2009-04-05,Willem II,NAC Breda,2,0,2,W
74192,8,HOL1,2009-04-10,NAC Breda,AZ Alkmaar,0,1,-1,L
74193,8,HOL1,2009-04-11,ADO Den Haag,Sparta Rotterdam,1,2,-1,L
74194,8,HOL1,2009-04-11,De Graafschap,NEC Nijmegen,2,2,0,D
74195,8,HOL1,2009-04-11,PSV Eindhoven,Utrecht,2,0,2,W
74196,8,HOL1,2009-04-11,Twente Enschede,Roda,4,2,2,W
74197,8,HOL1,2009-04-12,Ajax Amsterdam,Willem II,7,0,7,W
74198,8,HOL1,2009-04-12,Feyenoord Rotterdam,Heracles,5,1,4,W
74199,8,HOL1,2009-04-12,Groningen,Vitesse,2,3,-1,L
74200,8,HOL1,2009-04-12,Heerenveen,Volendam,1,0,1,W
74201,8,HOL1,2009-04-17,Heracles,NAC Breda,4,0,4,W
74202,8,HOL1,2009-04-18,AZ Alkmaar,Vitesse,1,2,-1,L
74203,8,HOL1,2009-04-18,Feyenoord Rotterdam,Twente Enschede,1,0,1,W
74204,8,HOL1,2009-04-18,De Graafschap,Groningen,0,1,-1,L
74205,8,HOL1,2009-04-18,NEC Nijmegen,Roda,1,1,0,D
74206,8,HOL1,2009-04-19,PSV Eindhoven,Ajax Amsterdam,6,2,4,W
74207,8,HOL1,2009-04-19,Utrecht,Heerenveen,2,1,1,W
74208,8,HOL1,2009-04-19,Volendam,Sparta Rotterdam,3,0,3,W
74209,8,HOL1,2009-04-19,Willem II,ADO Den Haag,3,3,0,D
74210,8,HOL1,2009-04-24,Sparta Rotterdam,De Graafschap,0,0,0,D
74211,8,HOL1,2009-04-25,Heerenveen,Twente Enschede,1,1,0,D
74212,8,HOL1,2009-04-25,Heracles,PSV Eindhoven,0,2,-2,L
74213,8,HOL1,2009-04-25,NEC Nijmegen,NAC Breda,2,3,-1,L
74214,8,HOL1,2009-04-25,Roda,Volendam,1,1,0,D
74215,8,HOL1,2009-04-26,Ajax Amsterdam,AZ Alkmaar,1,1,0,D
74216,8,HOL1,2009-04-26,ADO Den Haag,Feyenoord Rotterdam,2,3,-1,L
74217,8,HOL1,2009-04-26,Groningen,Willem II,0,0,0,D
74218,8,HOL1,2009-04-26,Vitesse,Utrecht,6,1,5,W
74219,8,HOL1,2009-05-03,Heerenveen,ADO Den Haag,2,2,0,D
74220,8,HOL1,2009-05-03,NAC Breda,De Graafschap,0,1,-1,L
74221,8,HOL1,2009-05-03,PSV Eindhoven,NEC Nijmegen,1,1,0,D
74222,8,HOL1,2009-05-03,Roda,Willem II,0,1,-1,L
74223,8,HOL1,2009-05-03,Sparta Rotterdam,Ajax Amsterdam,4,0,4,W
74224,8,HOL1,2009-05-03,Twente Enschede,AZ Alkmaar,3,0,3,W
74225,8,HOL1,2009-05-03,Utrecht,Feyenoord Rotterdam,2,2,0,D
74226,8,HOL1,2009-05-03,Vitesse,Heracles,1,0,1,W
74227,8,HOL1,2009-05-03,Volendam,Groningen,0,1,-1,L
74228,8,HOL1,2009-05-10,Ajax Amsterdam,Twente Enschede,1,0,1,W
74229,8,HOL1,2009-05-10,AZ Alkmaar,Heerenveen,3,1,2,W
74230,8,HOL1,2009-05-10,ADO Den Haag,Vitesse,3,1,2,W
74231,8,HOL1,2009-05-10,Feyenoord Rotterdam,Roda,2,3,-1,L
74232,8,HOL1,2009-05-10,De Graafschap,Volendam,2,2,0,D
74233,8,HOL1,2009-05-10,Groningen,NAC Breda,1,0,1,W
74234,8,HOL1,2009-05-10,Heracles,Utrecht,1,1,0,D
74235,8,HOL1,2009-05-10,NEC Nijmegen,Sparta Rotterdam,1,1,0,D
74236,8,HOL1,2009-05-10,Willem II,PSV Eindhoven,0,3,-3,L
74237,9,HOL1,2009-07-31,Heerenveen,Roda,0,0,0,D
74238,9,HOL1,2009-08-01,Heracles,AZ Alkmaar,3,2,1,W
74239,9,HOL1,2009-08-01,Sparta Rotterdam,Twente Enschede,0,2,-2,L
74240,9,HOL1,2009-08-01,Waalwijk,Utrecht,0,1,-1,L
74241,9,HOL1,2009-08-01,Willem II,Vitesse,3,1,2,W
74242,9,HOL1,2009-08-02,ADO Den Haag,NAC Breda,1,2,-1,L
74243,9,HOL1,2009-08-02,Feyenoord Rotterdam,NEC Nijmegen,2,0,2,W
74244,9,HOL1,2009-08-02,Groningen,Ajax Amsterdam,0,2,-2,L
74245,9,HOL1,2009-08-02,PSV Eindhoven,VVV Venlo,3,3,0,D
74246,9,HOL1,2009-08-07,AZ Alkmaar,Sparta Rotterdam,2,0,2,W
74247,9,HOL1,2009-08-07,NEC Nijmegen,Heerenveen,4,1,3,W
74248,9,HOL1,2009-08-08,Ajax Amsterdam,Waalwijk,4,1,3,W
74249,9,HOL1,2009-08-08,Roda,Groningen,1,1,0,D
74250,9,HOL1,2009-08-09,NAC Breda,Heracles,0,0,0,D
74251,9,HOL1,2009-08-09,Twente Enschede,PSV Eindhoven,1,1,0,D
74252,9,HOL1,2009-08-09,Utrecht,Willem II,1,0,1,W
74253,9,HOL1,2009-08-09,Vitesse,Feyenoord Rotterdam,0,0,0,D
74254,9,HOL1,2009-08-09,VVV Venlo,ADO Den Haag,2,2,0,D
74255,9,HOL1,2009-08-15,ADO Den Haag,Twente Enschede,0,1,-1,L
74256,9,HOL1,2009-08-15,Heerenveen,Vitesse,1,0,1,W
74257,9,HOL1,2009-08-15,Sparta Rotterdam,Willem II,2,1,1,W
74258,9,HOL1,2009-08-15,Waalwijk,AZ Alkmaar,0,6,-6,L
74259,9,HOL1,2009-08-16,Groningen,NAC Breda,1,2,-1,L
74260,9,HOL1,2009-08-16,Heracles,Feyenoord Rotterdam,0,1,-1,L
74261,9,HOL1,2009-08-16,PSV Eindhoven,Ajax Amsterdam,4,3,1,W
74262,9,HOL1,2009-08-16,Roda,NEC Nijmegen,1,0,1,W
74263,9,HOL1,2009-08-16,Utrecht,VVV Venlo,2,2,0,D
74264,9,HOL1,2009-08-22,Vitesse,ADO Den Haag,1,3,-2,L
74265,9,HOL1,2009-08-22,VVV Venlo,Groningen,2,2,0,D
74266,9,HOL1,2009-08-22,Willem II,Heracles,0,1,-1,L
74267,9,HOL1,2009-08-23,Ajax Amsterdam,Sparta Rotterdam,0,0,0,D
74268,9,HOL1,2009-08-23,Feyenoord Rotterdam,Roda,4,0,4,W
74269,9,HOL1,2009-08-23,Heerenveen,AZ Alkmaar,0,2,-2,L
74270,9,HOL1,2009-08-23,PSV Eindhoven,NAC Breda,3,1,2,W
74271,9,HOL1,2009-08-23,Twente Enschede,Waalwijk,2,1,1,W
74272,9,HOL1,2009-08-28,Roda,Vitesse,3,4,-1,L
74273,9,HOL1,2009-08-28,Waalwijk,ADO Den Haag,0,2,-2,L
74274,9,HOL1,2009-08-29,AZ Alkmaar,Willem II,2,1,1,W
74275,9,HOL1,2009-08-29,NEC Nijmegen,VVV Venlo,1,1,0,D
74276,9,HOL1,2009-08-29,Utrecht,Sparta Rotterdam,2,0,2,W
74277,9,HOL1,2009-08-30,Feyenoord Rotterdam,Twente Enschede,1,1,0,D
74278,9,HOL1,2009-08-30,Groningen,PSV Eindhoven,0,2,-2,L
74279,9,HOL1,2009-08-30,Heracles,Ajax Amsterdam,0,3,-3,L
74280,9,HOL1,2009-08-30,NAC Breda,Heerenveen,2,0,2,W
74281,9,HOL1,2009-09-12,ADO Den Haag,AZ Alkmaar,2,1,1,W
74282,9,HOL1,2009-09-12,Heerenveen,Groningen,0,1,-1,L
74283,9,HOL1,2009-09-12,PSV Eindhoven,Roda,3,0,3,W
74284,9,HOL1,2009-09-12,Twente Enschede,Utrecht,3,2,1,W
74285,9,HOL1,2009-09-13,Ajax Amsterdam,NAC Breda,6,0,6,W
74286,9,HOL1,2009-09-13,Sparta Rotterdam,Waalwijk,1,0,1,W
74287,9,HOL1,2009-09-13,Vitesse,NEC Nijmegen,2,2,0,D
74288,9,HOL1,2009-09-13,VVV Venlo,Heracles,1,0,1,W
74289,9,HOL1,2009-09-13,Willem II,Feyenoord Rotterdam,2,3,-1,L
74290,9,HOL1,2009-09-18,Willem II,Groningen,2,1,1,W
74291,9,HOL1,2009-09-19,AZ Alkmaar,NEC Nijmegen,0,1,-1,L
74292,9,HOL1,2009-09-19,Heracles,Sparta Rotterdam,1,1,0,D
74293,9,HOL1,2009-09-19,Roda,NAC Breda,2,0,2,W
74294,9,HOL1,2009-09-19,Vitesse,Waalwijk,3,1,2,W
74295,9,HOL1,2009-09-20,ADO Den Haag,Utrecht,0,1,-1,L
74296,9,HOL1,2009-09-20,Feyenoord Rotterdam,PSV Eindhoven,1,3,-2,L
74297,9,HOL1,2009-09-20,Heerenveen,Twente Enschede,0,2,-2,L
74298,9,HOL1,2009-09-20,VVV Venlo,Ajax Amsterdam,0,4,-4,L
74299,9,HOL1,2009-09-26,PSV Eindhoven,Willem II,3,1,2,W
74300,9,HOL1,2009-09-26,Twente Enschede,VVV Venlo,2,1,1,W
74301,9,HOL1,2009-09-26,Utrecht,AZ Alkmaar,1,0,1,W
74302,9,HOL1,2009-09-26,Waalwijk,Roda,4,1,3,W
74303,9,HOL1,2009-09-27,Ajax Amsterdam,ADO Den Haag,3,0,3,W
74304,9,HOL1,2009-09-27,Groningen,Vitesse,1,0,1,W
74305,9,HOL1,2009-09-27,NAC Breda,Feyenoord Rotterdam,0,2,-2,L
74306,9,HOL1,2009-09-27,NEC Nijmegen,Heracles,0,2,-2,L
74307,9,HOL1,2009-09-27,Sparta Rotterdam,Heerenveen,0,2,-2,L
74308,9,HOL1,2009-09-30,NEC Nijmegen,Utrecht,1,1,0,D
74309,9,HOL1,2009-10-02,Vitesse,Sparta Rotterdam,2,0,2,W
74310,9,HOL1,2009-10-03,AZ Alkmaar,NAC Breda,1,0,1,W
74311,9,HOL1,2009-10-03,ADO Den Haag,Groningen,1,1,0,D
74312,9,HOL1,2009-10-03,Feyenoord Rotterdam,Waalwijk,3,0,3,W
74313,9,HOL1,2009-10-03,Willem II,NEC Nijmegen,1,1,0,D
74314,9,HOL1,2009-10-04,Heerenveen,VVV Venlo,1,1,0,D
74315,9,HOL1,2009-10-04,Heracles,Twente Enschede,1,3,-2,L
74316,9,HOL1,2009-10-04,Roda,Ajax Amsterdam,2,2,0,D
74317,9,HOL1,2009-10-04,Utrecht,PSV Eindhoven,0,0,0,D
74318,9,HOL1,2009-10-17,Ajax Amsterdam,Willem II,4,0,4,W
74319,9,HOL1,2009-10-17,NAC Breda,Vitesse,4,0,4,W
74320,9,HOL1,2009-10-17,PSV Eindhoven,Heerenveen,1,0,1,W
74321,9,HOL1,2009-10-17,Twente Enschede,AZ Alkmaar,3,2,1,W
74322,9,HOL1,2009-10-18,Groningen,Utrecht,0,0,0,D
74323,9,HOL1,2009-10-18,NEC Nijmegen,ADO Den Haag,1,1,0,D
74324,9,HOL1,2009-10-18,Sparta Rotterdam,Feyenoord Rotterdam,2,1,1,W
74325,9,HOL1,2009-10-18,VVV Venlo,Roda,1,1,0,D
74326,9,HOL1,2009-10-18,Waalwijk,Heracles,0,1,-1,L
74327,9,HOL1,2009-10-23,Utrecht,Roda,2,1,1,W
74328,9,HOL1,2009-10-24,ADO Den Haag,Sparta Rotterdam,2,3,-1,L
74329,9,HOL1,2009-10-24,Feyenoord Rotterdam,VVV Venlo,1,0,1,W
74330,9,HOL1,2009-10-24,NAC Breda,Waalwijk,1,0,1,W
74331,9,HOL1,2009-10-24,Vitesse,Heracles,0,2,-2,L
74332,9,HOL1,2009-10-25,AZ Alkmaar,Ajax Amsterdam,2,4,-2,L
74333,9,HOL1,2009-10-25,NEC Nijmegen,PSV Eindhoven,0,4,-4,L
74334,9,HOL1,2009-10-25,Twente Enschede,Groningen,4,0,4,W
74335,9,HOL1,2009-10-25,Willem II,Heerenveen,4,1,3,W
74336,9,HOL1,2009-10-30,VVV Venlo,NAC Breda,1,1,0,D
74337,9,HOL1,2009-10-31,Groningen,AZ Alkmaar,0,1,-1,L
74338,9,HOL1,2009-10-31,Heerenveen,ADO Den Haag,3,0,3,W
74339,9,HOL1,2009-10-31,PSV Eindhoven,Vitesse,1,0,1,W
74340,9,HOL1,2009-10-31,Roda,Twente Enschede,1,2,-1,L
74341,9,HOL1,2009-11-01,Ajax Amsterdam,Feyenoord Rotterdam,5,1,4,W
74342,9,HOL1,2009-11-01,Heracles,Utrecht,3,1,2,W
74343,9,HOL1,2009-11-01,Sparta Rotterdam,NEC Nijmegen,2,0,2,W
74344,9,HOL1,2009-11-01,Waalwijk,Willem II,0,1,-1,L
74345,9,HOL1,2009-11-06,Groningen,Heracles,4,1,3,W
74346,9,HOL1,2009-11-07,NEC Nijmegen,Waalwijk,0,1,-1,L
74347,9,HOL1,2009-11-07,Sparta Rotterdam,Roda,1,2,-1,L
74348,9,HOL1,2009-11-07,Vitesse,VVV Venlo,2,0,2,W
74349,9,HOL1,2009-11-08,AZ Alkmaar,Feyenoord Rotterdam,1,1,0,D
74350,9,HOL1,2009-11-08,ADO Den Haag,PSV Eindhoven,1,5,-4,L
74351,9,HOL1,2009-11-08,NAC Breda,Willem II,4,0,4,W
74352,9,HOL1,2009-11-08,Twente Enschede,Ajax Amsterdam,1,0,1,W
74353,9,HOL1,2009-11-08,Utrecht,Heerenveen,2,3,-1,L
74354,9,HOL1,2009-11-21,NAC Breda,NEC Nijmegen,3,3,0,D
74355,9,HOL1,2009-11-21,Roda,AZ Alkmaar,2,4,-2,L
74356,9,HOL1,2009-11-21,Twente Enschede,Vitesse,1,0,1,W
74357,9,HOL1,2009-11-21,Waalwijk,Groningen,3,1,2,W
74358,9,HOL1,2009-11-22,Ajax Amsterdam,Heerenveen,5,1,4,W
74359,9,HOL1,2009-11-22,Feyenoord Rotterdam,Utrecht,0,0,0,D
74360,9,HOL1,2009-11-22,PSV Eindhoven,Heracles,4,0,4,W
74361,9,HOL1,2009-11-22,VVV Venlo,Sparta Rotterdam,5,0,5,W
74362,9,HOL1,2009-11-22,Willem II,ADO Den Haag,1,1,0,D
74363,9,HOL1,2009-11-27,Sparta Rotterdam,PSV Eindhoven,2,3,-1,L
74364,9,HOL1,2009-11-28,AZ Alkmaar,VVV Venlo,2,0,2,W
74365,9,HOL1,2009-11-28,Heerenveen,Waalwijk,3,1,2,W
74366,9,HOL1,2009-11-28,Heracles,Roda,3,2,1,W
74367,9,HOL1,2009-11-28,Willem II,Twente Enschede,1,3,-2,L
74368,9,HOL1,2009-11-29,ADO Den Haag,Feyenoord Rotterdam,0,2,-2,L
74369,9,HOL1,2009-11-29,Groningen,NEC Nijmegen,2,2,0,D
74370,9,HOL1,2009-11-29,Utrecht,NAC Breda,3,1,2,W
74371,9,HOL1,2009-11-29,Vitesse,Ajax Amsterdam,1,5,-4,L
74372,9,HOL1,2009-12-04,AZ Alkmaar,Vitesse,1,2,-1,L
74373,9,HOL1,2009-12-04,NAC Breda,Sparta Rotterdam,2,2,0,D
74374,9,HOL1,2009-12-04,Roda,ADO Den Haag,1,1,0,D
74375,9,HOL1,2009-12-04,VVV Venlo,Willem II,2,1,1,W
74376,9,HOL1,2009-12-06,Feyenoord Rotterdam,Groningen,3,1,2,W
74377,9,HOL1,2009-12-06,Heracles,Heerenveen,3,1,2,W
74378,9,HOL1,2009-12-06,NEC Nijmegen,Twente Enschede,3,4,-1,L
74379,9,HOL1,2009-12-06,Utrecht,Ajax Amsterdam,2,0,2,W
74380,9,HOL1,2009-12-06,Waalwijk,PSV Eindhoven,0,2,-2,L
74381,9,HOL1,2009-12-11,Ajax Amsterdam,NEC Nijmegen,3,0,3,W
74382,9,HOL1,2009-12-12,Heerenveen,Feyenoord Rotterdam,0,2,-2,L
74383,9,HOL1,2009-12-12,PSV Eindhoven,AZ Alkmaar,1,0,1,W
74384,9,HOL1,2009-12-12,Twente Enschede,NAC Breda,3,1,2,W
74385,9,HOL1,2009-12-12,VVV Venlo,Waalwijk,3,0,3,W
74386,9,HOL1,2009-12-13,ADO Den Haag,Heracles,1,4,-3,L
74387,9,HOL1,2009-12-13,Sparta Rotterdam,Groningen,2,4,-2,L
74388,9,HOL1,2009-12-13,Vitesse,Utrecht,2,2,0,D
74389,9,HOL1,2009-12-13,Willem II,Roda,1,3,-2,L
74390,9,HOL1,2009-12-18,Heracles,VVV Venlo,1,0,1,W
74391,9,HOL1,2009-12-19,AZ Alkmaar,ADO Den Haag,3,0,3,W
74392,9,HOL1,2009-12-19,Feyenoord Rotterdam,Willem II,1,0,1,W
74393,9,HOL1,2009-12-19,Waalwijk,Sparta Rotterdam,4,1,3,W
74394,9,HOL1,2010-01-17,NAC Breda,Ajax Amsterdam,1,1,0,D
74395,9,HOL1,2010-01-17,NEC Nijmegen,Vitesse,2,1,1,W
74396,9,HOL1,2010-01-17,Utrecht,Twente Enschede,0,0,0,D
74397,9,HOL1,2010-01-19,Roda,PSV Eindhoven,0,1,-1,L
74398,9,HOL1,2010-01-20,Groningen,Heerenveen,2,0,2,W
74399,9,HOL1,2010-01-22,PSV Eindhoven,NEC Nijmegen,3,0,3,W
74400,9,HOL1,2010-01-23,Heerenveen,Willem II,4,2,2,W
74401,9,HOL1,2010-01-23,Heracles,Vitesse,1,2,-1,L
74402,9,HOL1,2010-01-23,Roda,Utrecht,2,0,2,W
74403,9,HOL1,2010-01-23,Waalwijk,NAC Breda,0,1,-1,L
74404,9,HOL1,2010-01-24,Ajax Amsterdam,AZ Alkmaar,1,0,1,W
74405,9,HOL1,2010-01-24,Groningen,Twente Enschede,0,0,0,D
74406,9,HOL1,2010-01-24,Sparta Rotterdam,ADO Den Haag,0,0,0,D
74407,9,HOL1,2010-01-24,VVV Venlo,Feyenoord Rotterdam,1,1,0,D
74408,9,HOL1,2010-01-29,Willem II,Waalwijk,2,1,1,W
74409,9,HOL1,2010-01-30,AZ Alkmaar,Groningen,0,1,-1,L
74410,9,HOL1,2010-01-30,ADO Den Haag,Heerenveen,2,1,1,W
74411,9,HOL1,2010-01-30,NAC Breda,VVV Venlo,2,0,2,W
74412,9,HOL1,2010-01-30,NEC Nijmegen,Sparta Rotterdam,1,0,1,W
74413,9,HOL1,2010-01-31,Feyenoord Rotterdam,Ajax Amsterdam,1,1,0,D
74414,9,HOL1,2010-01-31,Twente Enschede,Roda,2,0,2,W
74415,9,HOL1,2010-01-31,Utrecht,Heracles,0,0,0,D
74416,9,HOL1,2010-01-31,Vitesse,PSV Eindhoven,0,0,0,D
74417,9,HOL1,2010-02-02,NAC Breda,AZ Alkmaar,1,1,0,D
74418,9,HOL1,2010-02-02,VVV Venlo,Heerenveen,3,1,2,W
74419,9,HOL1,2010-02-03,Ajax Amsterdam,Roda,4,0,4,W
74420,9,HOL1,2010-02-03,Groningen,ADO Den Haag,2,0,2,W
74421,9,HOL1,2010-02-03,PSV Eindhoven,Utrecht,2,1,1,W
74422,9,HOL1,2010-02-03,Sparta Rotterdam,Vitesse,1,1,0,D
74423,9,HOL1,2010-02-03,Twente Enschede,Heracles,2,0,2,W
74424,9,HOL1,2010-02-04,Waalwijk,Feyenoord Rotterdam,0,1,-1,L
74425,9,HOL1,2010-02-05,Willem II,NAC Breda,1,2,-1,L
74426,9,HOL1,2010-02-06,Heerenveen,Utrecht,2,0,2,W
74427,9,HOL1,2010-02-06,Heracles,Groningen,4,3,1,W
74428,9,HOL1,2010-02-06,PSV Eindhoven,ADO Den Haag,2,0,2,W
74429,9,HOL1,2010-02-06,Roda,Sparta Rotterdam,2,1,1,W
74430,9,HOL1,2010-02-07,Ajax Amsterdam,Twente Enschede,3,0,3,W
74431,9,HOL1,2010-02-07,Feyenoord Rotterdam,AZ Alkmaar,1,2,-1,L
74432,9,HOL1,2010-02-07,VVV Venlo,Vitesse,2,0,2,W
74433,9,HOL1,2010-02-07,Waalwijk,NEC Nijmegen,0,1,-1,L
74434,9,HOL1,2010-02-12,NEC Nijmegen,NAC Breda,4,2,2,W
74435,9,HOL1,2010-02-13,AZ Alkmaar,Roda,2,0,2,W
74436,9,HOL1,2010-02-13,ADO Den Haag,Willem II,3,0,3,W
74437,9,HOL1,2010-02-13,Heerenveen,Ajax Amsterdam,0,2,-2,L
74438,9,HOL1,2010-02-13,Vitesse,Twente Enschede,1,2,-1,L
74439,9,HOL1,2010-02-14,Groningen,Waalwijk,2,1,1,W
74440,9,HOL1,2010-02-14,Heracles,PSV Eindhoven,0,1,-1,L
74441,9,HOL1,2010-02-14,Sparta Rotterdam,VVV Venlo,2,0,2,W
74442,9,HOL1,2010-02-14,Utrecht,Feyenoord Rotterdam,0,0,0,D
74443,9,HOL1,2010-02-17,NEC Nijmegen,Willem II,2,1,1,W
74444,9,HOL1,2010-02-19,Roda,Heracles,2,1,1,W
74445,9,HOL1,2010-02-20,NAC Breda,Utrecht,0,2,-2,L
74446,9,HOL1,2010-02-20,NEC Nijmegen,Groningen,0,2,-2,L
74447,9,HOL1,2010-02-20,VVV Venlo,AZ Alkmaar,3,3,0,D
74448,9,HOL1,2010-02-20,Waalwijk,Heerenveen,1,2,-1,L
74449,9,HOL1,2010-02-21,Ajax Amsterdam,Vitesse,4,0,4,W
74450,9,HOL1,2010-02-21,Feyenoord Rotterdam,ADO Den Haag,2,2,0,D
74451,9,HOL1,2010-02-21,PSV Eindhoven,Sparta Rotterdam,1,1,0,D
74452,9,HOL1,2010-02-21,Twente Enschede,Willem II,1,0,1,W
74453,9,HOL1,2010-02-26,ADO Den Haag,Roda,1,2,-1,L
74454,9,HOL1,2010-02-27,Heerenveen,Heracles,1,2,-1,L
74455,9,HOL1,2010-02-27,Vitesse,AZ Alkmaar,0,3,-3,L
74456,9,HOL1,2010-02-27,Willem II,VVV Venlo,2,1,1,W
74457,9,HOL1,2010-02-28,Ajax Amsterdam,Utrecht,4,0,4,W
74458,9,HOL1,2010-02-28,Groningen,Feyenoord Rotterdam,2,3,-1,L
74459,9,HOL1,2010-02-28,PSV Eindhoven,Waalwijk,5,1,4,W
74460,9,HOL1,2010-02-28,Sparta Rotterdam,NAC Breda,2,2,0,D
74461,9,HOL1,2010-02-28,Twente Enschede,NEC Nijmegen,2,1,1,W
74462,9,HOL1,2010-03-06,AZ Alkmaar,Heerenveen,4,1,3,W
74463,9,HOL1,2010-03-06,ADO Den Haag,Vitesse,1,1,0,D
74464,9,HOL1,2010-03-06,Heracles,Willem II,3,2,1,W
74465,9,HOL1,2010-03-06,NAC Breda,PSV Eindhoven,2,1,1,W
74466,9,HOL1,2010-03-07,Groningen,VVV Venlo,1,0,1,W
74467,9,HOL1,2010-03-07,Roda,Feyenoord Rotterdam,2,4,-2,L
74468,9,HOL1,2010-03-07,Sparta Rotterdam,Ajax Amsterdam,0,3,-3,L
74469,9,HOL1,2010-03-07,Utrecht,NEC Nijmegen,1,0,1,W
74470,9,HOL1,2010-03-07,Waalwijk,Twente Enschede,0,1,-1,L
74471,9,HOL1,2010-03-12,Twente Enschede,ADO Den Haag,3,1,2,W
74472,9,HOL1,2010-03-13,AZ Alkmaar,Waalwijk,6,2,4,W
74473,9,HOL1,2010-03-13,NAC Breda,Groningen,0,3,-3,L
74474,9,HOL1,2010-03-13,NEC Nijmegen,Roda,0,2,-2,L
74475,9,HOL1,2010-03-13,VVV Venlo,Utrecht,0,1,-1,L
74476,9,HOL1,2010-03-14,Ajax Amsterdam,PSV Eindhoven,4,1,3,W
74477,9,HOL1,2010-03-14,Feyenoord Rotterdam,Heracles,1,1,0,D
74478,9,HOL1,2010-03-14,Vitesse,Heerenveen,0,1,-1,L
74479,9,HOL1,2010-03-14,Willem II,Sparta Rotterdam,3,1,2,W
74480,9,HOL1,2010-03-19,Heerenveen,NEC Nijmegen,4,1,3,W
74481,9,HOL1,2010-03-20,Heracles,NAC Breda,3,0,3,W
74482,9,HOL1,2010-03-20,PSV Eindhoven,Twente Enschede,1,1,0,D
74483,9,HOL1,2010-03-20,Willem II,Utrecht,0,3,-3,L
74484,9,HOL1,2010-03-21,ADO Den Haag,VVV Venlo,0,0,0,D
74485,9,HOL1,2010-03-21,Groningen,Roda,1,0,1,W
74486,9,HOL1,2010-03-21,Sparta Rotterdam,AZ Alkmaar,0,1,-1,L
74487,9,HOL1,2010-03-21,Waalwijk,Ajax Amsterdam,1,5,-4,L
74488,9,HOL1,2010-03-26,NAC Breda,ADO Den Haag,3,0,3,W
74489,9,HOL1,2010-03-27,AZ Alkmaar,Heracles,3,2,1,W
74490,9,HOL1,2010-03-27,Roda,Heerenveen,4,2,2,W
74491,9,HOL1,2010-03-27,Twente Enschede,Sparta Rotterdam,3,0,3,W
74492,9,HOL1,2010-03-27,Vitesse,Willem II,2,1,1,W
74493,9,HOL1,2010-03-28,Ajax Amsterdam,Groningen,3,0,3,W
74494,9,HOL1,2010-03-28,NEC Nijmegen,Feyenoord Rotterdam,0,0,0,D
74495,9,HOL1,2010-03-28,Utrecht,Waalwijk,2,0,2,W
74496,9,HOL1,2010-03-28,VVV Venlo,PSV Eindhoven,2,4,-2,L
74497,9,HOL1,2010-03-31,Feyenoord Rotterdam,Vitesse,2,1,1,W
74498,9,HOL1,2010-04-02,Vitesse,Groningen,3,0,3,W
74499,9,HOL1,2010-04-03,AZ Alkmaar,Utrecht,2,0,2,W
74500,9,HOL1,2010-04-03,Heerenveen,Sparta Rotterdam,4,1,3,W
74501,9,HOL1,2010-04-03,Roda,Waalwijk,5,1,4,W
74502,9,HOL1,2010-04-03,VVV Venlo,Twente Enschede,0,2,-2,L
74503,9,HOL1,2010-04-04,ADO Den Haag,Ajax Amsterdam,0,1,-1,L
74504,9,HOL1,2010-04-04,Feyenoord Rotterdam,NAC Breda,0,0,0,D
74505,9,HOL1,2010-04-04,Heracles,NEC Nijmegen,2,0,2,W
74506,9,HOL1,2010-04-04,Willem II,PSV Eindhoven,0,1,-1,L
74507,9,HOL1,2010-04-09,Waalwijk,Vitesse,4,1,3,W
74508,9,HOL1,2010-04-10,NAC Breda,Roda,1,0,1,W
74509,9,HOL1,2010-04-10,NEC Nijmegen,AZ Alkmaar,0,0,0,D
74510,9,HOL1,2010-04-10,Sparta Rotterdam,Heracles,1,1,0,D
74511,9,HOL1,2010-04-10,Twente Enschede,Heerenveen,2,0,2,W
74512,9,HOL1,2010-04-11,Ajax Amsterdam,VVV Venlo,7,0,7,W
74513,9,HOL1,2010-04-11,Groningen,Willem II,4,0,4,W
74514,9,HOL1,2010-04-11,PSV Eindhoven,Feyenoord Rotterdam,0,0,0,D
74515,9,HOL1,2010-04-11,Utrecht,ADO Den Haag,0,2,-2,L
74516,9,HOL1,2010-04-13,AZ Alkmaar,Twente Enschede,1,0,1,W
74517,9,HOL1,2010-04-13,Heracles,Waalwijk,4,1,3,W
74518,9,HOL1,2010-04-13,Vitesse,NAC Breda,1,1,0,D
74519,9,HOL1,2010-04-14,ADO Den Haag,NEC Nijmegen,2,3,-1,L
74520,9,HOL1,2010-04-14,Feyenoord Rotterdam,Sparta Rotterdam,3,0,3,W
74521,9,HOL1,2010-04-14,Heerenveen,PSV Eindhoven,2,2,0,D
74522,9,HOL1,2010-04-14,Roda,VVV Venlo,4,2,2,W
74523,9,HOL1,2010-04-14,Utrecht,Groningen,1,1,0,D
74524,9,HOL1,2010-04-14,Willem II,Ajax Amsterdam,0,2,-2,L
74525,9,HOL1,2010-04-18,Ajax Amsterdam,Heracles,4,0,4,W
74526,9,HOL1,2010-04-18,ADO Den Haag,Waalwijk,4,0,4,W
74527,9,HOL1,2010-04-18,Heerenveen,NAC Breda,0,0,0,D
74528,9,HOL1,2010-04-18,PSV Eindhoven,Groningen,3,1,2,W
74529,9,HOL1,2010-04-18,Sparta Rotterdam,Utrecht,0,3,-3,L
74530,9,HOL1,2010-04-18,Twente Enschede,Feyenoord Rotterdam,2,0,2,W
74531,9,HOL1,2010-04-18,Vitesse,Roda,2,5,-3,L
74532,9,HOL1,2010-04-18,VVV Venlo,NEC Nijmegen,2,0,2,W
74533,9,HOL1,2010-04-18,Willem II,AZ Alkmaar,0,3,-3,L
74534,9,HOL1,2010-05-02,AZ Alkmaar,PSV Eindhoven,1,1,0,D
74535,9,HOL1,2010-05-02,Feyenoord Rotterdam,Heerenveen,6,2,4,W
74536,9,HOL1,2010-05-02,Groningen,Sparta Rotterdam,3,1,2,W
74537,9,HOL1,2010-05-02,Heracles,ADO Den Haag,4,2,2,W
74538,9,HOL1,2010-05-02,NAC Breda,Twente Enschede,0,2,-2,L
74539,9,HOL1,2010-05-02,NEC Nijmegen,Ajax Amsterdam,1,4,-3,L
74540,9,HOL1,2010-05-02,Roda,Willem II,3,2,1,W
74541,9,HOL1,2010-05-02,Utrecht,Vitesse,2,2,0,D
74542,9,HOL1,2010-05-02,Waalwijk,VVV Venlo,1,2,-1,L
74543,10,HOL1,2010-08-06,Roda,Twente Enschede,0,0,0,D
74544,10,HOL1,2010-08-07,De Graafschap,Excelsior,3,0,3,W
74545,10,HOL1,2010-08-07,Heerenveen,PSV Eindhoven,1,3,-2,L
74546,10,HOL1,2010-08-07,Heracles,Willem II,3,0,3,W
74547,10,HOL1,2010-08-07,NEC Nijmegen,VVV Venlo,1,0,1,W
74548,10,HOL1,2010-08-08,Feyenoord Rotterdam,Utrecht,3,1,2,W
74549,10,HOL1,2010-08-08,Groningen,Ajax Amsterdam,2,2,0,D
74550,10,HOL1,2010-08-08,NAC Breda,AZ Alkmaar,1,1,0,D
74551,10,HOL1,2010-08-08,Vitesse,ADO Den Haag,3,1,2,W
74552,10,HOL1,2010-08-14,Ajax Amsterdam,Vitesse,4,2,2,W
74553,10,HOL1,2010-08-14,AZ Alkmaar,Groningen,1,1,0,D
74554,10,HOL1,2010-08-14,PSV Eindhoven,De Graafschap,6,0,6,W
74555,10,HOL1,2010-08-14,Twente Enschede,Heerenveen,0,0,0,D
74556,10,HOL1,2010-08-14,VVV Venlo,Heracles,1,0,1,W
74557,10,HOL1,2010-08-15,ADO Den Haag,Roda,1,3,-2,L
74558,10,HOL1,2010-08-15,Excelsior,Feyenoord Rotterdam,3,2,1,W
74559,10,HOL1,2010-08-15,Utrecht,NAC Breda,3,1,2,W
74560,10,HOL1,2010-08-15,Willem II,NEC Nijmegen,3,5,-2,L
74561,10,HOL1,2010-08-20,Excelsior,NEC Nijmegen,4,2,2,W
74562,10,HOL1,2010-08-21,Ajax Amsterdam,Roda,3,0,3,W
74563,10,HOL1,2010-08-21,Groningen,De Graafschap,2,1,1,W
74564,10,HOL1,2010-08-21,Heerenveen,NAC Breda,3,1,2,W
74565,10,HOL1,2010-08-21,Vitesse,Twente Enschede,0,3,-3,L
74566,10,HOL1,2010-08-22,Heracles,Feyenoord Rotterdam,1,1,0,D
74567,10,HOL1,2010-08-22,PSV Eindhoven,AZ Alkmaar,3,1,2,W
74568,10,HOL1,2010-08-22,Utrecht,Willem II,3,0,3,W
74569,10,HOL1,2010-08-22,VVV Venlo,ADO Den Haag,2,3,-1,L
74570,10,HOL1,2010-08-27,Willem II,Groningen,0,3,-3,L
74571,10,HOL1,2010-08-28,NAC Breda,VVV Venlo,2,0,2,W
74572,10,HOL1,2010-08-28,NEC Nijmegen,Heerenveen,2,2,0,D
74573,10,HOL1,2010-08-28,Roda,Heracles,4,2,2,W
74574,10,HOL1,2010-08-29,AZ Alkmaar,Excelsior,1,1,0,D
74575,10,HOL1,2010-08-29,ADO Den Haag,PSV Eindhoven,2,2,0,D
74576,10,HOL1,2010-08-29,Feyenoord Rotterdam,Vitesse,4,0,4,W
74577,10,HOL1,2010-08-29,De Graafschap,Ajax Amsterdam,0,5,-5,L
74578,10,HOL1,2010-08-29,Twente Enschede,Utrecht,4,0,4,W
74579,10,HOL1,2010-09-11,Ajax Amsterdam,Willem II,2,0,2,W
74580,10,HOL1,2010-09-11,AZ Alkmaar,Roda,1,2,-1,L
74581,10,HOL1,2010-09-11,Excelsior,Heracles,2,1,1,W
74582,10,HOL1,2010-09-11,Heerenveen,Vitesse,2,1,1,W
74583,10,HOL1,2010-09-11,PSV Eindhoven,NEC Nijmegen,3,1,2,W
74584,10,HOL1,2010-09-11,VVV Venlo,Twente Enschede,1,2,-1,L
74585,10,HOL1,2010-09-12,ADO Den Haag,De Graafschap,2,2,0,D
74586,10,HOL1,2010-09-12,Groningen,Utrecht,1,0,1,W
74587,10,HOL1,2010-09-12,NAC Breda,Feyenoord Rotterdam,2,0,2,W
74588,10,HOL1,2010-09-17,De Graafschap,Heerenveen,3,2,1,W
74589,10,HOL1,2010-09-18,Groningen,Excelsior,2,0,2,W
74590,10,HOL1,2010-09-18,Vitesse,NAC Breda,0,0,0,D
74591,10,HOL1,2010-09-18,Willem II,ADO Den Haag,2,4,-2,L
74592,10,HOL1,2010-09-19,Feyenoord Rotterdam,Ajax Amsterdam,1,2,-1,L
74593,10,HOL1,2010-09-19,Heracles,Twente Enschede,0,0,0,D
74594,10,HOL1,2010-09-19,NEC Nijmegen,AZ Alkmaar,0,1,-1,L
74595,10,HOL1,2010-09-19,Roda,PSV Eindhoven,0,0,0,D
74596,10,HOL1,2010-09-19,Utrecht,VVV Venlo,3,2,1,W
74597,10,HOL1,2010-09-25,AZ Alkmaar,Utrecht,1,0,1,W
74598,10,HOL1,2010-09-25,ADO Den Haag,Heracles,3,2,1,W
74599,10,HOL1,2010-09-25,Heerenveen,Roda,2,2,0,D
74600,10,HOL1,2010-09-25,PSV Eindhoven,Groningen,1,1,0,D
74601,10,HOL1,2010-09-25,Twente Enschede,Ajax Amsterdam,2,2,0,D
74602,10,HOL1,2010-09-26,Excelsior,Vitesse,0,2,-2,L
74603,10,HOL1,2010-09-26,NAC Breda,Willem II,2,1,1,W
74604,10,HOL1,2010-09-26,NEC Nijmegen,Feyenoord Rotterdam,3,0,3,W
74605,10,HOL1,2010-09-26,VVV Venlo,De Graafschap,1,0,1,W
74606,10,HOL1,2010-10-01,Vitesse,Willem II,0,0,0,D
74607,10,HOL1,2010-10-02,Excelsior,Roda,1,2,-1,L
74608,10,HOL1,2010-10-02,NAC Breda,NEC Nijmegen,2,0,2,W
74609,10,HOL1,2010-10-03,Ajax Amsterdam,Utrecht,1,2,-1,L
74610,10,HOL1,2010-10-03,AZ Alkmaar,Heracles,2,1,1,W
74611,10,HOL1,2010-10-03,De Graafschap,Feyenoord Rotterdam,1,1,0,D
74612,10,HOL1,2010-10-03,Heerenveen,ADO Den Haag,0,0,0,D
74613,10,HOL1,2010-10-03,PSV Eindhoven,VVV Venlo,3,0,3,W
74614,10,HOL1,2010-10-03,Twente Enschede,Groningen,4,2,2,W
74615,10,HOL1,2010-10-16,Ajax Amsterdam,NAC Breda,3,0,3,W
74616,10,HOL1,2010-10-16,ADO Den Haag,Excelsior,2,1,1,W
74617,10,HOL1,2010-10-16,Feyenoord Rotterdam,Twente Enschede,0,1,-1,L
74618,10,HOL1,2010-10-16,Utrecht,De Graafschap,2,2,0,D
74619,10,HOL1,2010-10-16,VVV Venlo,AZ Alkmaar,0,1,-1,L
74620,10,HOL1,2010-10-17,Groningen,Heerenveen,1,0,1,W
74621,10,HOL1,2010-10-17,Heracles,NEC Nijmegen,3,2,1,W
74622,10,HOL1,2010-10-17,Roda,Vitesse,4,1,3,W
74623,10,HOL1,2010-10-17,Willem II,PSV Eindhoven,2,4,-2,L
74624,10,HOL1,2010-10-22,NAC Breda,Roda,1,2,-1,L
74625,10,HOL1,2010-10-23,De Graafschap,Heracles,1,1,0,D
74626,10,HOL1,2010-10-23,Heerenveen,VVV Venlo,2,0,2,W
74627,10,HOL1,2010-10-23,NEC Nijmegen,Groningen,3,2,1,W
74628,10,HOL1,2010-10-24,AZ Alkmaar,Willem II,3,0,3,W
74629,10,HOL1,2010-10-24,Excelsior,Ajax Amsterdam,2,2,0,D
74630,10,HOL1,2010-10-24,PSV Eindhoven,Feyenoord Rotterdam,10,0,10,W
74631,10,HOL1,2010-10-24,Twente Enschede,ADO Den Haag,3,2,1,W
74632,10,HOL1,2010-10-24,Vitesse,Utrecht,1,4,-3,L
74633,10,HOL1,2010-10-26,Heracles,NAC Breda,4,1,3,W
74634,10,HOL1,2010-10-26,Roda,NEC Nijmegen,1,1,0,D
74635,10,HOL1,2010-10-27,Ajax Amsterdam,Heerenveen,3,1,2,W
74636,10,HOL1,2010-10-27,Feyenoord Rotterdam,VVV Venlo,3,0,3,W
74637,10,HOL1,2010-10-27,De Graafschap,AZ Alkmaar,2,1,1,W
74638,10,HOL1,2010-10-27,Groningen,ADO Den Haag,3,1,2,W
74639,10,HOL1,2010-10-27,Utrecht,Excelsior,2,0,2,W
74640,10,HOL1,2010-10-27,Vitesse,PSV Eindhoven,0,2,-2,L
74641,10,HOL1,2010-10-27,Willem II,Twente Enschede,1,3,-2,L
74642,10,HOL1,2010-10-30,Excelsior,Heerenveen,0,2,-2,L
74643,10,HOL1,2010-10-30,Heracles,Ajax Amsterdam,1,4,-3,L
74644,10,HOL1,2010-10-30,NAC Breda,De Graafschap,2,0,2,W
74645,10,HOL1,2010-10-30,PSV Eindhoven,Twente Enschede,0,1,-1,L
74646,10,HOL1,2010-10-30,VVV Venlo,Groningen,3,5,-2,L
74647,10,HOL1,2010-10-31,AZ Alkmaar,Feyenoord Rotterdam,2,1,1,W
74648,10,HOL1,2010-10-31,ADO Den Haag,Utrecht,1,0,1,W
74649,10,HOL1,2010-10-31,NEC Nijmegen,Vitesse,0,0,0,D
74650,10,HOL1,2010-10-31,Roda,Willem II,2,2,0,D
74651,10,HOL1,2010-11-05,Willem II,VVV Venlo,1,4,-3,L
74652,10,HOL1,2010-11-06,De Graafschap,NEC Nijmegen,1,4,-3,L
74653,10,HOL1,2010-11-06,Groningen,NAC Breda,2,1,1,W
74654,10,HOL1,2010-11-06,Heerenveen,Heracles,3,2,1,W
74655,10,HOL1,2010-11-06,Twente Enschede,Excelsior,2,1,1,W
74656,10,HOL1,2010-11-07,Ajax Amsterdam,ADO Den Haag,0,1,-1,L
74657,10,HOL1,2010-11-07,Feyenoord Rotterdam,Roda,1,1,0,D
74658,10,HOL1,2010-11-07,Utrecht,PSV Eindhoven,1,2,-1,L
74659,10,HOL1,2010-11-07,Vitesse,AZ Alkmaar,1,1,0,D
74660,10,HOL1,2010-11-13,NAC Breda,Twente Enschede,2,1,1,W
74661,10,HOL1,2010-11-13,PSV Eindhoven,Excelsior,4,2,2,W
74662,10,HOL1,2010-11-14,AZ Alkmaar,Ajax Amsterdam,2,0,2,W
74663,10,HOL1,2010-11-14,Feyenoord Rotterdam,Heerenveen,2,2,0,D
74664,10,HOL1,2010-11-14,Heracles,Groningen,3,0,3,W
74665,10,HOL1,2010-11-14,NEC Nijmegen,ADO Den Haag,1,1,0,D
74666,10,HOL1,2010-11-14,VVV Venlo,Vitesse,1,5,-4,L
74667,10,HOL1,2010-11-20,Ajax Amsterdam,PSV Eindhoven,0,0,0,D
74668,10,HOL1,2010-11-20,Excelsior,VVV Venlo,1,0,1,W
74669,10,HOL1,2010-11-20,De Graafschap,Roda,3,1,2,W
74670,10,HOL1,2010-11-20,Twente Enschede,AZ Alkmaar,1,2,-1,L
74671,10,HOL1,2010-11-20,Vitesse,Heracles,2,0,2,W
74672,10,HOL1,2010-11-21,ADO Den Haag,NAC Breda,3,0,3,W
74673,10,HOL1,2010-11-21,Groningen,Feyenoord Rotterdam,2,0,2,W
74674,10,HOL1,2010-11-21,Heerenveen,Willem II,5,0,5,W
74675,10,HOL1,2010-11-21,Utrecht,NEC Nijmegen,4,0,4,W
74676,10,HOL1,2010-11-24,Roda,Utrecht,1,1,0,D
74677,10,HOL1,2010-11-24,Willem II,De Graafschap,0,1,-1,L
74678,10,HOL1,2010-11-26,NAC Breda,PSV Eindhoven,4,2,2,W
74679,10,HOL1,2010-11-27,AZ Alkmaar,Heerenveen,2,2,0,D
74680,10,HOL1,2010-11-27,NEC Nijmegen,Twente Enschede,2,4,-2,L
74681,10,HOL1,2010-11-27,Roda,Groningen,1,0,1,W
74682,10,HOL1,2010-11-27,Willem II,Excelsior,1,1,0,D
74683,10,HOL1,2010-11-28,Feyenoord Rotterdam,ADO Den Haag,2,1,1,W
74684,10,HOL1,2010-11-28,De Graafschap,Vitesse,1,1,0,D
74685,10,HOL1,2010-11-28,Heracles,Utrecht,2,1,1,W
74686,10,HOL1,2010-11-28,VVV Venlo,Ajax Amsterdam,0,2,-2,L
74687,10,HOL1,2010-12-03,Groningen,Vitesse,4,1,3,W
74688,10,HOL1,2010-12-04,Ajax Amsterdam,NEC Nijmegen,1,1,0,D
74689,10,HOL1,2010-12-04,PSV Eindhoven,Heracles,5,2,3,W
74690,10,HOL1,2010-12-04,Twente Enschede,De Graafschap,2,0,2,W
74691,10,HOL1,2010-12-05,ADO Den Haag,AZ Alkmaar,0,2,-2,L
74692,10,HOL1,2010-12-05,Utrecht,Heerenveen,2,1,1,W
74693,10,HOL1,2010-12-05,Willem II,Feyenoord Rotterdam,1,1,0,D
74694,10,HOL1,2010-12-10,Heracles,VVV Venlo,2,2,0,D
74695,10,HOL1,2010-12-11,De Graafschap,PSV Eindhoven,0,0,0,D
74696,10,HOL1,2010-12-11,NAC Breda,Utrecht,3,1,2,W
74697,10,HOL1,2010-12-11,NEC Nijmegen,Willem II,3,1,2,W
74698,10,HOL1,2010-12-11,Roda,ADO Den Haag,1,1,0,D
74699,10,HOL1,2010-12-12,Feyenoord Rotterdam,Excelsior,1,0,1,W
74700,10,HOL1,2010-12-12,Groningen,AZ Alkmaar,2,0,2,W
74701,10,HOL1,2010-12-12,Heerenveen,Twente Enschede,6,2,4,W
74702,10,HOL1,2010-12-12,Vitesse,Ajax Amsterdam,0,1,-1,L
74703,10,HOL1,2010-12-14,VVV Venlo,Roda,0,4,-4,L
74704,10,HOL1,2010-12-15,Excelsior,NAC Breda,1,3,-2,L
74705,10,HOL1,2010-12-18,ADO Den Haag,Willem II,2,1,1,W
74706,10,HOL1,2010-12-18,Excelsior,Groningen,2,2,0,D
74707,10,HOL1,2010-12-18,Heerenveen,De Graafschap,4,0,4,W
74708,10,HOL1,2010-12-18,NAC Breda,Vitesse,1,1,0,D
74709,10,HOL1,2010-12-19,PSV Eindhoven,Roda,3,1,2,W
74710,10,HOL1,2011-01-19,Ajax Amsterdam,Feyenoord Rotterdam,2,0,2,W
74711,10,HOL1,2011-01-19,AZ Alkmaar,NEC Nijmegen,2,2,0,D
74712,10,HOL1,2011-01-19,Twente Enschede,Heracles,5,0,5,W
74713,10,HOL1,2011-01-19,VVV Venlo,Utrecht,1,2,-1,L
74714,10,HOL1,2011-01-21,ADO Den Haag,Heerenveen,3,1,2,W
74715,10,HOL1,2011-01-22,Feyenoord Rotterdam,De Graafschap,0,1,-1,L
74716,10,HOL1,2011-01-22,Heracles,AZ Alkmaar,0,0,0,D
74717,10,HOL1,2011-01-22,NEC Nijmegen,NAC Breda,2,2,0,D
74718,10,HOL1,2011-01-22,Willem II,Vitesse,1,0,1,W
74719,10,HOL1,2011-01-23,Groningen,Twente Enschede,1,2,-1,L
74720,10,HOL1,2011-01-23,Roda,Excelsior,3,0,3,W
74721,10,HOL1,2011-01-23,Utrecht,Ajax Amsterdam,3,0,3,W
74722,10,HOL1,2011-01-23,VVV Venlo,PSV Eindhoven,0,3,-3,L
74723,10,HOL1,2011-01-28,NEC Nijmegen,Heracles,1,1,0,D
74724,10,HOL1,2011-01-29,AZ Alkmaar,VVV Venlo,6,1,5,W
74725,10,HOL1,2011-01-29,PSV Eindhoven,Willem II,2,1,1,W
74726,10,HOL1,2011-01-29,Vitesse,Roda,5,2,3,W
74727,10,HOL1,2011-01-30,Excelsior,ADO Den Haag,1,5,-4,L
74728,10,HOL1,2011-01-30,Heerenveen,Groningen,1,4,-3,L
74729,10,HOL1,2011-01-30,NAC Breda,Ajax Amsterdam,0,3,-3,L
74730,10,HOL1,2011-01-30,Twente Enschede,Feyenoord Rotterdam,2,1,1,W
74731,10,HOL1,2011-02-01,De Graafschap,Utrecht,0,0,0,D
74732,10,HOL1,2011-02-04,Ajax Amsterdam,De Graafschap,2,0,2,W
74733,10,HOL1,2011-02-05,Excelsior,AZ Alkmaar,2,1,1,W
74734,10,HOL1,2011-02-05,Heerenveen,NEC Nijmegen,0,0,0,D
74735,10,HOL1,2011-02-05,PSV Eindhoven,ADO Den Haag,0,1,-1,L
74736,10,HOL1,2011-02-05,VVV Venlo,NAC Breda,3,0,3,W
74737,10,HOL1,2011-02-06,Groningen,Willem II,7,1,6,W
74738,10,HOL1,2011-02-06,Heracles,Roda,1,0,1,W
74739,10,HOL1,2011-02-06,Utrecht,Twente Enschede,1,1,0,D
74740,10,HOL1,2011-02-06,Vitesse,Feyenoord Rotterdam,1,1,0,D
74741,10,HOL1,2011-02-12,AZ Alkmaar,PSV Eindhoven,0,4,-4,L
74742,10,HOL1,2011-02-12,ADO Den Haag,VVV Venlo,3,0,3,W
74743,10,HOL1,2011-02-12,Feyenoord Rotterdam,Heracles,2,1,1,W
74744,10,HOL1,2011-02-12,Twente Enschede,Vitesse,1,0,1,W
74745,10,HOL1,2011-02-12,Willem II,Utrecht,3,3,0,D
74746,10,HOL1,2011-02-13,De Graafschap,Groningen,1,1,0,D
74747,10,HOL1,2011-02-13,NAC Breda,Heerenveen,0,2,-2,L
74748,10,HOL1,2011-02-13,NEC Nijmegen,Excelsior,2,0,2,W
74749,10,HOL1,2011-02-13,Roda,Ajax Amsterdam,2,2,0,D
74750,10,HOL1,2011-02-18,Utrecht,Heracles,1,1,0,D
74751,10,HOL1,2011-02-19,Excelsior,Willem II,4,0,4,W
74752,10,HOL1,2011-02-19,Groningen,Roda,1,4,-3,L
74753,10,HOL1,2011-02-19,Heerenveen,AZ Alkmaar,0,2,-2,L
74754,10,HOL1,2011-02-20,Ajax Amsterdam,VVV Venlo,1,0,1,W
74755,10,HOL1,2011-02-20,ADO Den Haag,Feyenoord Rotterdam,2,2,0,D
74756,10,HOL1,2011-02-20,PSV Eindhoven,NAC Breda,4,1,3,W
74757,10,HOL1,2011-02-20,Twente Enschede,NEC Nijmegen,1,1,0,D
74758,10,HOL1,2011-02-20,Vitesse,De Graafschap,2,0,2,W
74759,10,HOL1,2011-02-25,VVV Venlo,Excelsior,1,0,1,W
74760,10,HOL1,2011-02-26,Heracles,Vitesse,6,1,5,W
74761,10,HOL1,2011-02-26,NAC Breda,ADO Den Haag,3,2,1,W
74762,10,HOL1,2011-02-26,Roda,De Graafschap,1,1,0,D
74763,10,HOL1,2011-02-26,Willem II,Heerenveen,4,3,1,W
74764,10,HOL1,2011-02-27,AZ Alkmaar,Twente Enschede,2,1,1,W
74765,10,HOL1,2011-02-27,Feyenoord Rotterdam,Groningen,5,1,4,W
74766,10,HOL1,2011-02-27,NEC Nijmegen,Utrecht,1,1,0,D
74767,10,HOL1,2011-02-27,PSV Eindhoven,Ajax Amsterdam,0,0,0,D
74768,10,HOL1,2011-03-04,De Graafschap,Willem II,2,1,1,W
74769,10,HOL1,2011-03-05,ADO Den Haag,NEC Nijmegen,5,1,4,W
74770,10,HOL1,2011-03-05,Excelsior,PSV Eindhoven,2,3,-1,L
74771,10,HOL1,2011-03-05,Twente Enschede,NAC Breda,2,0,2,W
74772,10,HOL1,2011-03-05,Vitesse,VVV Venlo,2,0,2,W
74773,10,HOL1,2011-03-06,Ajax Amsterdam,AZ Alkmaar,4,0,4,W
74774,10,HOL1,2011-03-06,Groningen,Heracles,1,4,-3,L
74775,10,HOL1,2011-03-06,Heerenveen,Feyenoord Rotterdam,0,1,-1,L
74776,10,HOL1,2011-03-06,Utrecht,Roda,1,1,0,D
74777,10,HOL1,2011-03-11,Utrecht,Groningen,1,0,1,W
74778,10,HOL1,2011-03-12,Heracles,Excelsior,4,1,3,W
74779,10,HOL1,2011-03-12,Roda,AZ Alkmaar,1,2,-1,L
74780,10,HOL1,2011-03-12,Vitesse,Heerenveen,1,1,0,D
74781,10,HOL1,2011-03-13,Feyenoord Rotterdam,NAC Breda,2,1,1,W
74782,10,HOL1,2011-03-13,De Graafschap,ADO Den Haag,1,0,1,W
74783,10,HOL1,2011-03-13,NEC Nijmegen,PSV Eindhoven,2,2,0,D
74784,10,HOL1,2011-03-13,Twente Enschede,VVV Venlo,2,1,1,W
74785,10,HOL1,2011-03-13,Willem II,Ajax Amsterdam,1,3,-2,L
74786,10,HOL1,2011-03-18,AZ Alkmaar,Vitesse,3,1,2,W
74787,10,HOL1,2011-03-19,Heracles,Heerenveen,4,2,2,W
74788,10,HOL1,2011-03-19,NAC Breda,Groningen,0,1,-1,L
74789,10,HOL1,2011-03-19,NEC Nijmegen,De Graafschap,1,0,1,W
74790,10,HOL1,2011-03-19,VVV Venlo,Willem II,0,0,0,D
74791,10,HOL1,2011-03-20,ADO Den Haag,Ajax Amsterdam,3,2,1,W
74792,10,HOL1,2011-03-20,Excelsior,Twente Enschede,0,2,-2,L
74793,10,HOL1,2011-03-20,PSV Eindhoven,Utrecht,1,0,1,W
74794,10,HOL1,2011-03-20,Roda,Feyenoord Rotterdam,3,0,3,W
74795,10,HOL1,2011-04-02,Feyenoord Rotterdam,AZ Alkmaar,0,1,-1,L
74796,10,HOL1,2011-04-02,De Graafschap,NAC Breda,1,3,-2,L
74797,10,HOL1,2011-04-02,Heerenveen,Excelsior,2,3,-1,L
74798,10,HOL1,2011-04-02,Twente Enschede,PSV Eindhoven,2,0,2,W
74799,10,HOL1,2011-04-02,Willem II,Roda,4,5,-1,L
74800,10,HOL1,2011-04-03,Ajax Amsterdam,Heracles,3,0,3,W
74801,10,HOL1,2011-04-03,Groningen,VVV Venlo,3,2,1,W
74802,10,HOL1,2011-04-03,Utrecht,ADO Den Haag,2,3,-1,L
74803,10,HOL1,2011-04-03,Vitesse,NEC Nijmegen,2,1,1,W
74804,10,HOL1,2011-04-08,AZ Alkmaar,NAC Breda,1,1,0,D
74805,10,HOL1,2011-04-09,ADO Den Haag,Vitesse,1,0,1,W
74806,10,HOL1,2011-04-09,Excelsior,De Graafschap,0,0,0,D
74807,10,HOL1,2011-04-09,VVV Venlo,NEC Nijmegen,1,4,-3,L
74808,10,HOL1,2011-04-09,Willem II,Heracles,2,6,-4,L
74809,10,HOL1,2011-04-10,Ajax Amsterdam,Groningen,2,0,2,W
74810,10,HOL1,2011-04-10,PSV Eindhoven,Heerenveen,2,2,0,D
74811,10,HOL1,2011-04-10,Twente Enschede,Roda,1,1,0,D
74812,10,HOL1,2011-04-10,Utrecht,Feyenoord Rotterdam,0,4,-4,L
74813,10,HOL1,2011-04-15,Heerenveen,Utrecht,3,0,3,W
74814,10,HOL1,2011-04-16,AZ Alkmaar,ADO Den Haag,3,1,2,W
74815,10,HOL1,2011-04-16,NAC Breda,Excelsior,1,2,-1,L
74816,10,HOL1,2011-04-16,Roda,VVV Venlo,5,2,3,W
74817,10,HOL1,2011-04-16,Vitesse,Groningen,2,1,1,W
74818,10,HOL1,2011-04-17,Feyenoord Rotterdam,Willem II,6,1,5,W
74819,10,HOL1,2011-04-17,De Graafschap,Twente Enschede,1,1,0,D
74820,10,HOL1,2011-04-17,Heracles,PSV Eindhoven,0,2,-2,L
74821,10,HOL1,2011-04-17,NEC Nijmegen,Ajax Amsterdam,1,2,-1,L
74822,10,HOL1,2011-04-22,ADO Den Haag,Twente Enschede,1,2,-1,L
74823,10,HOL1,2011-04-23,Heracles,De Graafschap,2,0,2,W
74824,10,HOL1,2011-04-23,Roda,NAC Breda,5,1,4,W
74825,10,HOL1,2011-04-23,VVV Venlo,Heerenveen,2,2,0,D
74826,10,HOL1,2011-04-23,Willem II,AZ Alkmaar,2,1,1,W
74827,10,HOL1,2011-04-24,Ajax Amsterdam,Excelsior,4,1,3,W
74828,10,HOL1,2011-04-24,Feyenoord Rotterdam,PSV Eindhoven,3,1,2,W
74829,10,HOL1,2011-04-24,Groningen,NEC Nijmegen,3,1,2,W
74830,10,HOL1,2011-04-24,Utrecht,Vitesse,4,2,2,W
74831,10,HOL1,2011-05-01,AZ Alkmaar,De Graafschap,5,1,4,W
74832,10,HOL1,2011-05-01,ADO Den Haag,Groningen,2,4,-2,L
74833,10,HOL1,2011-05-01,Excelsior,Utrecht,3,1,2,W
74834,10,HOL1,2011-05-01,Heerenveen,Ajax Amsterdam,1,2,-1,L
74835,10,HOL1,2011-05-01,NAC Breda,Heracles,1,2,-1,L
74836,10,HOL1,2011-05-01,NEC Nijmegen,Roda,5,0,5,W
74837,10,HOL1,2011-05-01,PSV Eindhoven,Vitesse,2,1,1,W
74838,10,HOL1,2011-05-01,Twente Enschede,Willem II,4,0,4,W
74839,10,HOL1,2011-05-01,VVV Venlo,Feyenoord Rotterdam,3,2,1,W
74840,10,HOL1,2011-05-15,Ajax Amsterdam,Twente Enschede,3,1,2,W
74841,10,HOL1,2011-05-15,Feyenoord Rotterdam,NEC Nijmegen,1,1,0,D
74842,10,HOL1,2011-05-15,De Graafschap,VVV Venlo,1,0,1,W
74843,10,HOL1,2011-05-15,Groningen,PSV Eindhoven,0,0,0,D
74844,10,HOL1,2011-05-15,Heracles,ADO Den Haag,3,0,3,W
74845,10,HOL1,2011-05-15,Roda,Heerenveen,0,0,0,D
74846,10,HOL1,2011-05-15,Utrecht,AZ Alkmaar,5,1,4,W
74847,10,HOL1,2011-05-15,Vitesse,Excelsior,1,4,-3,L
74848,10,HOL1,2011-05-15,Willem II,NAC Breda,0,1,-1,L
74849,11,HOL1,2011-08-05,Excelsior,Feyenoord Rotterdam,0,2,-2,L
74850,11,HOL1,2011-08-06,Heerenveen,NEC Nijmegen,2,2,0,D
74851,11,HOL1,2011-08-06,Roda,Groningen,2,1,1,W
74852,11,HOL1,2011-08-06,VVV Venlo,Utrecht,0,0,0,D
74853,11,HOL1,2011-08-06,Waalwijk,Heracles,2,2,0,D
74854,11,HOL1,2011-08-07,AZ Alkmaar,PSV Eindhoven,3,1,2,W
74855,11,HOL1,2011-08-07,ADO Den Haag,Vitesse,0,0,0,D
74856,11,HOL1,2011-08-07,De Graafschap,Ajax Amsterdam,1,4,-3,L
74857,11,HOL1,2011-08-07,NAC Breda,Twente Enschede,0,1,-1,L
74858,11,HOL1,2011-08-13,Feyenoord Rotterdam,Roda,3,0,3,W
74859,11,HOL1,2011-08-13,PSV Eindhoven,Waalwijk,1,0,1,W
74860,11,HOL1,2011-08-13,Twente Enschede,AZ Alkmaar,2,0,2,W
74861,11,HOL1,2011-08-13,Vitesse,VVV Venlo,4,0,4,W
74862,11,HOL1,2011-08-14,Ajax Amsterdam,Heerenveen,5,1,4,W
74863,11,HOL1,2011-08-14,Groningen,ADO Den Haag,4,2,2,W
74864,11,HOL1,2011-08-14,Heracles,NAC Breda,2,1,1,W
74865,11,HOL1,2011-08-14,Utrecht,De Graafschap,2,2,0,D
74866,11,HOL1,2011-08-15,NEC Nijmegen,Excelsior,2,0,2,W
74867,11,HOL1,2011-08-19,Roda,Waalwijk,0,2,-2,L
74868,11,HOL1,2011-08-20,Excelsior,De Graafschap,1,1,0,D
74869,11,HOL1,2011-08-20,Heerenveen,Twente Enschede,1,5,-4,L
74870,11,HOL1,2011-08-20,NAC Breda,Groningen,2,2,0,D
74871,11,HOL1,2011-08-20,Vitesse,Utrecht,2,1,1,W
74872,11,HOL1,2011-08-21,AZ Alkmaar,NEC Nijmegen,4,0,4,W
74873,11,HOL1,2011-08-21,ADO Den Haag,PSV Eindhoven,0,3,-3,L
74874,11,HOL1,2011-08-21,Heracles,Feyenoord Rotterdam,1,1,0,D
74875,11,HOL1,2011-08-21,VVV Venlo,Ajax Amsterdam,2,2,0,D
74876,11,HOL1,2011-08-26,Ajax Amsterdam,Vitesse,4,1,3,W
74877,11,HOL1,2011-08-27,NEC Nijmegen,Heracles,2,1,1,W
74878,11,HOL1,2011-08-27,Twente Enschede,VVV Venlo,4,1,3,W
74879,11,HOL1,2011-08-27,Utrecht,Roda,3,1,2,W
74880,11,HOL1,2011-08-27,Waalwijk,NAC Breda,2,1,1,W
74881,11,HOL1,2011-08-28,Feyenoord Rotterdam,Heerenveen,2,2,0,D
74882,11,HOL1,2011-08-28,De Graafschap,ADO Den Haag,0,3,-3,L
74883,11,HOL1,2011-08-28,Groningen,AZ Alkmaar,0,3,-3,L
74884,11,HOL1,2011-08-28,PSV Eindhoven,Excelsior,6,1,5,W
74885,11,HOL1,2011-09-10,AZ Alkmaar,Vitesse,4,0,4,W
74886,11,HOL1,2011-09-10,ADO Den Haag,Waalwijk,0,1,-1,L
74887,11,HOL1,2011-09-10,De Graafschap,NEC Nijmegen,1,0,1,W
74888,11,HOL1,2011-09-10,Heracles,Ajax Amsterdam,2,3,-1,L
74889,11,HOL1,2011-09-10,Roda,Twente Enschede,2,1,1,W
74890,11,HOL1,2011-09-11,Excelsior,Utrecht,2,3,-1,L
74891,11,HOL1,2011-09-11,Heerenveen,Groningen,3,0,3,W
74892,11,HOL1,2011-09-11,NAC Breda,Feyenoord Rotterdam,1,3,-2,L
74893,11,HOL1,2011-09-11,VVV Venlo,PSV Eindhoven,3,3,0,D
74894,11,HOL1,2011-09-16,NEC Nijmegen,NAC Breda,1,2,-1,L
74895,11,HOL1,2011-09-17,Feyenoord Rotterdam,De Graafschap,4,0,4,W
74896,11,HOL1,2011-09-17,Groningen,Excelsior,2,0,2,W
74897,11,HOL1,2011-09-17,Vitesse,Roda,5,0,5,W
74898,11,HOL1,2011-09-17,VVV Venlo,Heerenveen,0,3,-3,L
74899,11,HOL1,2011-09-18,PSV Eindhoven,Ajax Amsterdam,2,2,0,D
74900,11,HOL1,2011-09-18,Twente Enschede,ADO Den Haag,5,2,3,W
74901,11,HOL1,2011-09-18,Utrecht,Heracles,2,2,0,D
74902,11,HOL1,2011-09-18,Waalwijk,AZ Alkmaar,1,2,-1,L
74903,11,HOL1,2011-09-24,Ajax Amsterdam,Twente Enschede,1,1,0,D
74904,11,HOL1,2011-09-24,ADO Den Haag,VVV Venlo,2,0,2,W
74905,11,HOL1,2011-09-24,Heerenveen,Heracles,1,1,0,D
74906,11,HOL1,2011-09-24,NAC Breda,Utrecht,1,0,1,W
74907,11,HOL1,2011-09-24,PSV Eindhoven,Roda,7,1,6,W
74908,11,HOL1,2011-09-25,AZ Alkmaar,Feyenoord Rotterdam,2,1,1,W
74909,11,HOL1,2011-09-25,Excelsior,Vitesse,0,2,-2,L
74910,11,HOL1,2011-09-25,De Graafschap,Groningen,2,3,-1,L
74911,11,HOL1,2011-09-25,Waalwijk,NEC Nijmegen,2,0,2,W
74912,11,HOL1,2011-09-30,Heracles,De Graafschap,2,0,2,W
74913,11,HOL1,2011-10-01,Roda,NAC Breda,4,3,1,W
74914,11,HOL1,2011-10-01,Utrecht,Waalwijk,3,0,3,W
74915,11,HOL1,2011-10-01,Vitesse,Heerenveen,1,1,0,D
74916,11,HOL1,2011-10-02,Feyenoord Rotterdam,ADO Den Haag,0,3,-3,L
74917,11,HOL1,2011-10-02,Groningen,Ajax Amsterdam,1,0,1,W
74918,11,HOL1,2011-10-02,NEC Nijmegen,PSV Eindhoven,0,2,-2,L
74919,11,HOL1,2011-10-02,Twente Enschede,Excelsior,2,2,0,D
74920,11,HOL1,2011-10-02,VVV Venlo,AZ Alkmaar,1,3,-2,L
74921,11,HOL1,2011-10-15,Ajax Amsterdam,AZ Alkmaar,2,2,0,D
74922,11,HOL1,2011-10-15,Heerenveen,De Graafschap,1,1,0,D
74923,11,HOL1,2011-10-15,Heracles,Groningen,2,1,1,W
74924,11,HOL1,2011-10-15,PSV Eindhoven,Utrecht,1,0,1,W
74925,11,HOL1,2011-10-15,Waalwijk,Twente Enschede,0,4,-4,L
74926,11,HOL1,2011-10-16,Feyenoord Rotterdam,VVV Venlo,4,0,4,W
74927,11,HOL1,2011-10-16,NAC Breda,Excelsior,2,0,2,W
74928,11,HOL1,2011-10-16,NEC Nijmegen,Vitesse,0,1,-1,L
74929,11,HOL1,2011-10-16,Roda,ADO Den Haag,4,1,3,W
74930,11,HOL1,2011-10-21,De Graafschap,NAC Breda,3,1,2,W
74931,11,HOL1,2011-10-22,ADO Den Haag,NEC Nijmegen,1,0,1,W
74932,11,HOL1,2011-10-22,Excelsior,Heracles,0,2,-2,L
74933,11,HOL1,2011-10-22,Utrecht,Heerenveen,1,4,-3,L
74934,11,HOL1,2011-10-22,VVV Venlo,Waalwijk,4,1,3,W
74935,11,HOL1,2011-10-23,Ajax Amsterdam,Feyenoord Rotterdam,1,1,0,D
74936,11,HOL1,2011-10-23,AZ Alkmaar,Roda,1,0,1,W
74937,11,HOL1,2011-10-23,Groningen,Twente Enschede,1,1,0,D
74938,11,HOL1,2011-10-23,Vitesse,PSV Eindhoven,1,1,0,D
74939,11,HOL1,2011-10-28,NAC Breda,VVV Venlo,3,1,2,W
74940,11,HOL1,2011-10-29,Excelsior,Waalwijk,1,0,1,W
74941,11,HOL1,2011-10-29,Heerenveen,ADO Den Haag,4,0,4,W
74942,11,HOL1,2011-10-29,Roda,Ajax Amsterdam,0,4,-4,L
74943,11,HOL1,2011-10-29,Twente Enschede,PSV Eindhoven,2,2,0,D
74944,11,HOL1,2011-10-30,De Graafschap,Vitesse,0,1,-1,L
74945,11,HOL1,2011-10-30,Groningen,Feyenoord Rotterdam,6,0,6,W
74946,11,HOL1,2011-10-30,Heracles,AZ Alkmaar,0,1,-1,L
74947,11,HOL1,2011-10-30,NEC Nijmegen,Utrecht,3,1,2,W
74948,11,HOL1,2011-11-04,VVV Venlo,Excelsior,0,0,0,D
74949,11,HOL1,2011-11-05,Feyenoord Rotterdam,NEC Nijmegen,0,1,-1,L
74950,11,HOL1,2011-11-05,NAC Breda,Vitesse,1,0,1,W
74951,11,HOL1,2011-11-05,Roda,Heerenveen,1,2,-1,L
74952,11,HOL1,2011-11-05,Waalwijk,Groningen,1,1,0,D
74953,11,HOL1,2011-11-06,AZ Alkmaar,ADO Den Haag,3,0,3,W
74954,11,HOL1,2011-11-06,PSV Eindhoven,Heracles,4,1,3,W
74955,11,HOL1,2011-11-06,Twente Enschede,De Graafschap,4,0,4,W
74956,11,HOL1,2011-11-06,Utrecht,Ajax Amsterdam,6,4,2,W
74957,11,HOL1,2011-11-19,Ajax Amsterdam,NAC Breda,2,2,0,D
74958,11,HOL1,2011-11-19,De Graafschap,PSV Eindhoven,1,3,-2,L
74959,11,HOL1,2011-11-19,Heerenveen,Waalwijk,1,1,0,D
74960,11,HOL1,2011-11-19,Heracles,Twente Enschede,1,1,0,D
74961,11,HOL1,2011-11-19,NEC Nijmegen,Roda,1,2,-1,L
74962,11,HOL1,2011-11-20,ADO Den Haag,Utrecht,2,2,0,D
74963,11,HOL1,2011-11-20,Groningen,VVV Venlo,2,1,1,W
74964,11,HOL1,2011-11-20,Vitesse,Feyenoord Rotterdam,0,4,-4,L
74965,11,HOL1,2011-11-25,AZ Alkmaar,Utrecht,2,0,2,W
74966,11,HOL1,2011-11-26,NAC Breda,Heerenveen,2,2,0,D
74967,11,HOL1,2011-11-26,PSV Eindhoven,Groningen,6,1,5,W
74968,11,HOL1,2011-11-26,Roda,Heracles,3,1,2,W
74969,11,HOL1,2011-11-26,VVV Venlo,De Graafschap,1,2,-1,L
74970,11,HOL1,2011-11-27,Excelsior,ADO Den Haag,1,1,0,D
74971,11,HOL1,2011-11-27,NEC Nijmegen,Ajax Amsterdam,0,3,-3,L
74972,11,HOL1,2011-11-27,Twente Enschede,Vitesse,0,0,0,D
74973,11,HOL1,2011-11-27,Waalwijk,Feyenoord Rotterdam,1,2,-1,L
74974,11,HOL1,2011-12-02,Heracles,VVV Venlo,7,0,7,W
74975,11,HOL1,2011-12-03,Ajax Amsterdam,Excelsior,4,1,3,W
74976,11,HOL1,2011-12-03,ADO Den Haag,NAC Breda,3,0,3,W
74977,11,HOL1,2011-12-03,De Graafschap,Roda,1,2,-1,L
74978,11,HOL1,2011-12-03,Groningen,NEC Nijmegen,3,3,0,D
74979,11,HOL1,2011-12-04,Feyenoord Rotterdam,PSV Eindhoven,2,0,2,W
74980,11,HOL1,2011-12-04,Heerenveen,AZ Alkmaar,5,1,4,W
74981,11,HOL1,2011-12-04,Utrecht,Twente Enschede,2,6,-4,L
74982,11,HOL1,2011-12-04,Vitesse,Waalwijk,4,0,4,W
74983,11,HOL1,2011-12-07,Excelsior,AZ Alkmaar,0,0,0,D
74984,11,HOL1,2011-12-09,ADO Den Haag,Heracles,2,0,2,W
74985,11,HOL1,2011-12-10,AZ Alkmaar,De Graafschap,4,0,4,W
74986,11,HOL1,2011-12-10,Excelsior,Heerenveen,0,5,-5,L
74987,11,HOL1,2011-12-10,PSV Eindhoven,NAC Breda,1,0,1,W
74988,11,HOL1,2011-12-10,Twente Enschede,NEC Nijmegen,2,0,2,W
74989,11,HOL1,2011-12-11,Utrecht,Feyenoord Rotterdam,2,2,0,D
74990,11,HOL1,2011-12-11,Vitesse,Groningen,0,0,0,D
74991,11,HOL1,2011-12-11,VVV Venlo,Roda,2,0,2,W
74992,11,HOL1,2011-12-11,Waalwijk,Ajax Amsterdam,0,1,-1,L
74993,11,HOL1,2011-12-16,De Graafschap,Waalwijk,1,3,-2,L
74994,11,HOL1,2011-12-17,Groningen,Utrecht,1,0,1,W
74995,11,HOL1,2011-12-17,Heracles,Vitesse,0,1,-1,L
74996,11,HOL1,2011-12-17,NEC Nijmegen,VVV Venlo,2,0,2,W
74997,11,HOL1,2011-12-17,Roda,Excelsior,7,0,7,W
74998,11,HOL1,2011-12-18,Ajax Amsterdam,ADO Den Haag,4,0,4,W
74999,11,HOL1,2011-12-18,Feyenoord Rotterdam,Twente Enschede,3,2,1,W
75000,11,HOL1,2011-12-18,Heerenveen,PSV Eindhoven,1,5,-4,L
75001,11,HOL1,2011-12-18,NAC Breda,AZ Alkmaar,2,1,1,W
75002,11,HOL1,2012-01-20,ADO Den Haag,Roda,3,3,0,D
75003,11,HOL1,2012-01-21,Excelsior,NAC Breda,3,0,3,W
75004,11,HOL1,2012-01-21,De Graafschap,Heerenveen,0,2,-2,L
75005,11,HOL1,2012-01-21,Twente Enschede,Waalwijk,5,0,5,W
75006,11,HOL1,2012-01-22,AZ Alkmaar,Ajax Amsterdam,1,1,0,D
75007,11,HOL1,2012-01-22,Groningen,Heracles,2,1,1,W
75008,11,HOL1,2012-01-22,Utrecht,PSV Eindhoven,1,1,0,D
75009,11,HOL1,2012-01-22,Vitesse,NEC Nijmegen,0,1,-1,L
75010,11,HOL1,2012-01-22,VVV Venlo,Feyenoord Rotterdam,2,1,1,W
75011,11,HOL1,2012-01-27,PSV Eindhoven,Vitesse,3,1,2,W
75012,11,HOL1,2012-01-28,Heerenveen,Utrecht,2,0,2,W
75013,11,HOL1,2012-01-28,Heracles,Excelsior,3,0,3,W
75014,11,HOL1,2012-01-28,NAC Breda,De Graafschap,1,1,0,D
75015,11,HOL1,2012-01-28,Roda,AZ Alkmaar,2,0,2,W
75016,11,HOL1,2012-01-29,Feyenoord Rotterdam,Ajax Amsterdam,4,2,2,W
75017,11,HOL1,2012-01-29,NEC Nijmegen,ADO Den Haag,2,0,2,W
75018,11,HOL1,2012-01-29,Twente Enschede,Groningen,4,1,3,W
75019,11,HOL1,2012-01-29,Waalwijk,VVV Venlo,4,0,4,W
75020,11,HOL1,2012-02-03,Heerenveen,Roda,4,3,1,W
75021,11,HOL1,2012-02-04,Excelsior,VVV Venlo,3,1,2,W
75022,11,HOL1,2012-02-04,Vitesse,NAC Breda,1,0,1,W
75023,11,HOL1,2012-02-05,Ajax Amsterdam,Utrecht,0,2,-2,L
75024,11,HOL1,2012-02-05,Groningen,Waalwijk,0,3,-3,L
75025,11,HOL1,2012-02-05,Heracles,PSV Eindhoven,1,1,0,D
75026,11,HOL1,2012-02-05,NEC Nijmegen,Feyenoord Rotterdam,0,2,-2,L
75027,11,HOL1,2012-02-08,ADO Den Haag,AZ Alkmaar,0,6,-6,L
75028,11,HOL1,2012-02-10,Twente Enschede,Heracles,2,3,-1,L
75029,11,HOL1,2012-02-11,AZ Alkmaar,Excelsior,2,0,2,W
75030,11,HOL1,2012-02-11,NAC Breda,Ajax Amsterdam,0,2,-2,L
75031,11,HOL1,2012-02-11,Roda,NEC Nijmegen,1,0,1,W
75032,11,HOL1,2012-02-11,VVV Venlo,Groningen,2,0,2,W
75033,11,HOL1,2012-02-12,Feyenoord Rotterdam,Vitesse,3,1,2,W
75034,11,HOL1,2012-02-12,PSV Eindhoven,De Graafschap,4,1,3,W
75035,11,HOL1,2012-02-12,Utrecht,ADO Den Haag,1,1,0,D
75036,11,HOL1,2012-02-12,Waalwijk,Heerenveen,0,1,-1,L
75037,11,HOL1,2012-02-17,Heerenveen,NAC Breda,1,0,1,W
75038,11,HOL1,2012-02-18,ADO Den Haag,Excelsior,1,1,0,D
75039,11,HOL1,2012-02-18,Feyenoord Rotterdam,Waalwijk,1,1,0,D
75040,11,HOL1,2012-02-18,De Graafschap,VVV Venlo,1,4,-3,L
75041,11,HOL1,2012-02-18,Heracles,Roda,2,1,1,W
75042,11,HOL1,2012-02-19,Ajax Amsterdam,NEC Nijmegen,4,1,3,W
75043,11,HOL1,2012-02-19,Groningen,PSV Eindhoven,3,0,3,W
75044,11,HOL1,2012-02-19,Utrecht,AZ Alkmaar,3,0,3,W
75045,11,HOL1,2012-02-19,Vitesse,Twente Enschede,1,4,-3,L
75046,11,HOL1,2012-02-24,Waalwijk,Vitesse,1,0,1,W
75047,11,HOL1,2012-02-25,NAC Breda,ADO Den Haag,4,0,4,W
75048,11,HOL1,2012-02-25,NEC Nijmegen,Groningen,4,0,4,W
75049,11,HOL1,2012-02-25,Roda,De Graafschap,0,2,-2,L
75050,11,HOL1,2012-02-25,VVV Venlo,Heracles,3,1,2,W
75051,11,HOL1,2012-02-26,AZ Alkmaar,Heerenveen,3,3,0,D
75052,11,HOL1,2012-02-26,Excelsior,Ajax Amsterdam,1,4,-3,L
75053,11,HOL1,2012-02-26,PSV Eindhoven,Feyenoord Rotterdam,3,2,1,W
75054,11,HOL1,2012-02-26,Twente Enschede,Utrecht,1,0,1,W
75055,11,HOL1,2012-03-03,AZ Alkmaar,Heracles,3,1,2,W
75056,11,HOL1,2012-03-03,ADO Den Haag,Heerenveen,0,0,0,D
75057,11,HOL1,2012-03-03,VVV Venlo,NAC Breda,2,1,1,W
75058,11,HOL1,2012-03-03,Waalwijk,Excelsior,1,0,1,W
75059,11,HOL1,2012-03-04,Ajax Amsterdam,Roda,4,1,3,W
75060,11,HOL1,2012-03-04,Feyenoord Rotterdam,Groningen,1,0,1,W
75061,11,HOL1,2012-03-04,PSV Eindhoven,Twente Enschede,2,6,-4,L
75062,11,HOL1,2012-03-04,Utrecht,NEC Nijmegen,0,0,0,D
75063,11,HOL1,2012-03-04,Vitesse,De Graafschap,2,0,2,W
75064,11,HOL1,2012-03-09,Roda,VVV Venlo,3,1,2,W
75065,11,HOL1,2012-03-10,Groningen,Vitesse,1,3,-2,L
75066,11,HOL1,2012-03-10,Heerenveen,Excelsior,4,2,2,W
75067,11,HOL1,2012-03-10,Heracles,ADO Den Haag,0,2,-2,L
75068,11,HOL1,2012-03-11,Ajax Amsterdam,Waalwijk,3,0,3,W
75069,11,HOL1,2012-03-11,Feyenoord Rotterdam,Utrecht,1,1,0,D
75070,11,HOL1,2012-03-11,De Graafschap,AZ Alkmaar,0,2,-2,L
75071,11,HOL1,2012-03-11,NAC Breda,PSV Eindhoven,3,1,2,W
75072,11,HOL1,2012-03-11,NEC Nijmegen,Twente Enschede,3,1,2,W
75073,11,HOL1,2012-03-16,Vitesse,Heracles,2,0,2,W
75074,11,HOL1,2012-03-17,Excelsior,Roda,2,1,1,W
75075,11,HOL1,2012-03-17,VVV Venlo,NEC Nijmegen,0,2,-2,L
75076,11,HOL1,2012-03-17,Waalwijk,De Graafschap,1,0,1,W
75077,11,HOL1,2012-03-18,AZ Alkmaar,NAC Breda,0,0,0,D
75078,11,HOL1,2012-03-18,ADO Den Haag,Ajax Amsterdam,0,2,-2,L
75079,11,HOL1,2012-03-18,PSV Eindhoven,Heerenveen,5,1,4,W
75080,11,HOL1,2012-03-18,Twente Enschede,Feyenoord Rotterdam,0,2,-2,L
75081,11,HOL1,2012-03-18,Utrecht,Groningen,3,1,2,W
75082,11,HOL1,2012-03-21,De Graafschap,Twente Enschede,1,2,-1,L
75083,11,HOL1,2012-03-23,Excelsior,Groningen,0,1,-1,L
75084,11,HOL1,2012-03-24,ADO Den Haag,Twente Enschede,1,1,0,D
75085,11,HOL1,2012-03-24,Heerenveen,VVV Venlo,4,1,3,W
75086,11,HOL1,2012-03-24,NAC Breda,NEC Nijmegen,1,1,0,D
75087,11,HOL1,2012-03-24,Roda,Vitesse,3,1,2,W
75088,11,HOL1,2012-03-25,Ajax Amsterdam,PSV Eindhoven,2,0,2,W
75089,11,HOL1,2012-03-25,AZ Alkmaar,Waalwijk,1,0,1,W
75090,11,HOL1,2012-03-25,De Graafschap,Feyenoord Rotterdam,0,3,-3,L
75091,11,HOL1,2012-03-25,Heracles,Utrecht,3,1,2,W
75092,11,HOL1,2012-03-30,Utrecht,Excelsior,3,2,1,W
75093,11,HOL1,2012-03-31,Feyenoord Rotterdam,NAC Breda,3,1,2,W
75094,11,HOL1,2012-03-31,Groningen,Heerenveen,1,3,-2,L
75095,11,HOL1,2012-03-31,PSV Eindhoven,VVV Venlo,2,0,2,W
75096,11,HOL1,2012-03-31,Twente Enschede,Roda,2,0,2,W
75097,11,HOL1,2012-04-01,Ajax Amsterdam,Heracles,6,0,6,W
75098,11,HOL1,2012-04-01,NEC Nijmegen,De Graafschap,2,0,2,W
75099,11,HOL1,2012-04-01,Vitesse,AZ Alkmaar,2,2,0,D
75100,11,HOL1,2012-04-01,Waalwijk,ADO Den Haag,1,0,1,W
75101,11,HOL1,2012-04-10,Excelsior,NEC Nijmegen,0,2,-2,L
75102,11,HOL1,2012-04-11,AZ Alkmaar,Twente Enschede,2,2,0,D
75103,11,HOL1,2012-04-11,Heerenveen,Ajax Amsterdam,0,5,-5,L
75104,11,HOL1,2012-04-11,NAC Breda,Heracles,1,2,-1,L
75105,11,HOL1,2012-04-11,Roda,Feyenoord Rotterdam,0,0,0,D
75106,11,HOL1,2012-04-11,Waalwijk,PSV Eindhoven,2,1,1,W
75107,11,HOL1,2012-04-12,ADO Den Haag,Groningen,3,0,3,W
75108,11,HOL1,2012-04-12,De Graafschap,Utrecht,3,0,3,W
75109,11,HOL1,2012-04-12,VVV Venlo,Vitesse,1,3,-2,L
75110,11,HOL1,2012-04-14,Feyenoord Rotterdam,Excelsior,3,0,3,W
75111,11,HOL1,2012-04-14,NEC Nijmegen,Heerenveen,2,4,-2,L
75112,11,HOL1,2012-04-14,PSV Eindhoven,AZ Alkmaar,3,2,1,W
75113,11,HOL1,2012-04-14,Twente Enschede,NAC Breda,2,2,0,D
75114,11,HOL1,2012-04-15,Ajax Amsterdam,De Graafschap,3,1,2,W
75115,11,HOL1,2012-04-15,Groningen,Roda,0,1,-1,L
75116,11,HOL1,2012-04-15,Heracles,Waalwijk,1,1,0,D
75117,11,HOL1,2012-04-15,Utrecht,VVV Venlo,4,2,2,W
75118,11,HOL1,2012-04-15,Vitesse,ADO Den Haag,1,0,1,W
75119,11,HOL1,2012-04-20,NAC Breda,Roda,0,3,-3,L
75120,11,HOL1,2012-04-21,Excelsior,Twente Enschede,0,1,-1,L
75121,11,HOL1,2012-04-21,De Graafschap,Heracles,2,3,-1,L
75122,11,HOL1,2012-04-21,Heerenveen,Vitesse,1,1,0,D
75123,11,HOL1,2012-04-21,Waalwijk,Utrecht,0,2,-2,L
75124,11,HOL1,2012-04-22,Ajax Amsterdam,Groningen,2,0,2,W
75125,11,HOL1,2012-04-22,AZ Alkmaar,VVV Venlo,2,1,1,W
75126,11,HOL1,2012-04-22,ADO Den Haag,Feyenoord Rotterdam,1,2,-1,L
75127,11,HOL1,2012-04-22,PSV Eindhoven,NEC Nijmegen,2,1,1,W
75128,11,HOL1,2012-04-27,Groningen,De Graafschap,1,1,0,D
75129,11,HOL1,2012-04-28,Heracles,Heerenveen,2,4,-2,L
75130,11,HOL1,2012-04-28,Utrecht,NAC Breda,1,3,-2,L
75131,11,HOL1,2012-04-28,Vitesse,Excelsior,3,2,1,W
75132,11,HOL1,2012-04-28,VVV Venlo,ADO Den Haag,2,1,1,W
75133,11,HOL1,2012-04-29,Feyenoord Rotterdam,AZ Alkmaar,1,0,1,W
75134,11,HOL1,2012-04-29,NEC Nijmegen,Waalwijk,1,1,0,D
75135,11,HOL1,2012-04-29,Roda,PSV Eindhoven,1,3,-2,L
75136,11,HOL1,2012-04-29,Twente Enschede,Ajax Amsterdam,1,2,-1,L
75137,11,HOL1,2012-05-02,Ajax Amsterdam,VVV Venlo,2,0,2,W
75138,11,HOL1,2012-05-02,Feyenoord Rotterdam,Heracles,4,1,3,W
75139,11,HOL1,2012-05-02,De Graafschap,Excelsior,2,2,0,D
75140,11,HOL1,2012-05-02,Groningen,NAC Breda,1,1,0,D
75141,11,HOL1,2012-05-02,NEC Nijmegen,AZ Alkmaar,1,1,0,D
75142,11,HOL1,2012-05-02,PSV Eindhoven,ADO Den Haag,5,0,5,W
75143,11,HOL1,2012-05-02,Twente Enschede,Heerenveen,3,4,-1,L
75144,11,HOL1,2012-05-02,Utrecht,Vitesse,2,2,0,D
75145,11,HOL1,2012-05-02,Waalwijk,Roda,5,2,3,W
75146,11,HOL1,2012-05-06,AZ Alkmaar,Groningen,1,0,1,W
75147,11,HOL1,2012-05-06,ADO Den Haag,De Graafschap,3,5,-2,L
75148,11,HOL1,2012-05-06,Excelsior,PSV Eindhoven,1,3,-2,L
75149,11,HOL1,2012-05-06,Heerenveen,Feyenoord Rotterdam,2,3,-1,L
75150,11,HOL1,2012-05-06,Heracles,NEC Nijmegen,1,2,-1,L
75151,11,HOL1,2012-05-06,NAC Breda,Waalwijk,3,2,1,W
75152,11,HOL1,2012-05-06,Roda,Utrecht,1,3,-2,L
75153,11,HOL1,2012-05-06,Vitesse,Ajax Amsterdam,1,3,-2,L
75154,11,HOL1,2012-05-06,VVV Venlo,Twente Enschede,4,2,2,W
75155,12,HOL1,2012-08-10,Willem II,NAC Breda,1,1,0,D
75156,12,HOL1,2012-08-11,Heracles,VVV Venlo,1,1,0,D
75157,12,HOL1,2012-08-11,Roda,Zwolle,1,1,0,D
75158,12,HOL1,2012-08-11,Waalwijk,PSV Eindhoven,3,2,1,W
75159,12,HOL1,2012-08-12,Ajax Amsterdam,AZ Alkmaar,2,2,0,D
75160,12,HOL1,2012-08-12,Heerenveen,NEC Nijmegen,0,2,-2,L
75161,12,HOL1,2012-08-12,Twente Enschede,Groningen,4,1,3,W
75162,12,HOL1,2012-08-12,Utrecht,Feyenoord Rotterdam,0,1,-1,L
75163,12,HOL1,2012-08-12,Vitesse,ADO Den Haag,2,2,0,D
75164,12,HOL1,2012-08-18,Feyenoord Rotterdam,Heerenveen,1,1,0,D
75165,12,HOL1,2012-08-18,NAC Breda,Twente Enschede,0,1,-1,L
75166,12,HOL1,2012-08-18,PSV Eindhoven,Roda,5,0,5,W
75167,12,HOL1,2012-08-18,VVV Venlo,Utrecht,1,3,-2,L
75168,12,HOL1,2012-08-18,Zwolle,Vitesse,0,1,-1,L
75169,12,HOL1,2012-08-19,AZ Alkmaar,Heracles,3,1,2,W
75170,12,HOL1,2012-08-19,ADO Den Haag,Waalwijk,2,2,0,D
75171,12,HOL1,2012-08-19,Groningen,Willem II,1,1,0,D
75172,12,HOL1,2012-08-19,NEC Nijmegen,Ajax Amsterdam,1,6,-5,L
75173,12,HOL1,2012-08-24,Waalwijk,Roda,1,0,1,W
75174,12,HOL1,2012-08-25,Ajax Amsterdam,NAC Breda,5,0,5,W
75175,12,HOL1,2012-08-25,Heracles,Feyenoord Rotterdam,1,2,-1,L
75176,12,HOL1,2012-08-25,Utrecht,Zwolle,1,1,0,D
75177,12,HOL1,2012-08-25,VVV Venlo,ADO Den Haag,2,4,-2,L
75178,12,HOL1,2012-08-26,AZ Alkmaar,Heerenveen,0,0,0,D
75179,12,HOL1,2012-08-26,Groningen,PSV Eindhoven,1,3,-2,L
75180,12,HOL1,2012-08-26,NEC Nijmegen,Twente Enschede,1,3,-2,L
75181,12,HOL1,2012-08-26,Willem II,Vitesse,0,2,-2,L
75182,12,HOL1,2012-08-31,ADO Den Haag,Groningen,0,1,-1,L
75183,12,HOL1,2012-09-01,NAC Breda,Utrecht,1,1,0,D
75184,12,HOL1,2012-09-01,Roda,Willem II,3,0,3,W
75185,12,HOL1,2012-09-01,Waalwijk,Heracles,1,1,0,D
75186,12,HOL1,2012-09-01,Zwolle,NEC Nijmegen,0,4,-4,L
75187,12,HOL1,2012-09-02,Heerenveen,Ajax Amsterdam,2,2,0,D
75188,12,HOL1,2012-09-02,PSV Eindhoven,AZ Alkmaar,5,1,4,W
75189,12,HOL1,2012-09-02,Twente Enschede,VVV Venlo,1,0,1,W
75190,12,HOL1,2012-09-02,Vitesse,Feyenoord Rotterdam,1,0,1,W
75191,12,HOL1,2012-09-15,Ajax Amsterdam,Waalwijk,2,0,2,W
75192,12,HOL1,2012-09-15,Feyenoord Rotterdam,Zwolle,2,0,2,W
75193,12,HOL1,2012-09-15,Heerenveen,ADO Den Haag,1,3,-2,L
75194,12,HOL1,2012-09-15,VVV Venlo,NEC Nijmegen,2,2,0,D
75195,12,HOL1,2012-09-15,Willem II,Twente Enschede,2,6,-4,L
75196,12,HOL1,2012-09-16,AZ Alkmaar,Roda,4,0,4,W
75197,12,HOL1,2012-09-16,Groningen,Vitesse,0,3,-3,L
75198,12,HOL1,2012-09-16,Heracles,NAC Breda,2,1,1,W
75199,12,HOL1,2012-09-16,Utrecht,PSV Eindhoven,1,0,1,W
75200,12,HOL1,2012-09-21,Roda,Utrecht,0,1,-1,L
75201,12,HOL1,2012-09-22,NEC Nijmegen,Willem II,0,0,0,D
75202,12,HOL1,2012-09-22,Vitesse,Heracles,1,1,0,D
75203,12,HOL1,2012-09-22,Waalwijk,VVV Venlo,1,1,0,D
75204,12,HOL1,2012-09-22,Zwolle,Groningen,1,2,-1,L
75205,12,HOL1,2012-09-23,ADO Den Haag,Ajax Amsterdam,1,1,0,D
75206,12,HOL1,2012-09-23,NAC Breda,AZ Alkmaar,2,1,1,W
75207,12,HOL1,2012-09-23,PSV Eindhoven,Feyenoord Rotterdam,3,0,3,W
75208,12,HOL1,2012-09-23,Twente Enschede,Heerenveen,1,0,1,W
75209,12,HOL1,2012-09-29,Ajax Amsterdam,Twente Enschede,1,0,1,W
75210,12,HOL1,2012-09-29,Feyenoord Rotterdam,NEC Nijmegen,5,1,4,W
75211,12,HOL1,2012-09-29,Heerenveen,NAC Breda,2,0,2,W
75212,12,HOL1,2012-09-29,Heracles,ADO Den Haag,3,3,0,D
75213,12,HOL1,2012-09-29,Utrecht,Vitesse,1,2,-1,L
75214,12,HOL1,2012-09-30,AZ Alkmaar,Waalwijk,3,3,0,D
75215,12,HOL1,2012-09-30,Groningen,Roda,3,2,1,W
75216,12,HOL1,2012-09-30,VVV Venlo,PSV Eindhoven,0,6,-6,L
75217,12,HOL1,2012-09-30,Willem II,Zwolle,0,1,-1,L
75218,12,HOL1,2012-10-05,NEC Nijmegen,ADO Den Haag,1,1,0,D
75219,12,HOL1,2012-10-06,Roda,VVV Venlo,3,0,3,W
75220,12,HOL1,2012-10-06,Vitesse,Heerenveen,3,3,0,D
75221,12,HOL1,2012-10-06,Willem II,Waalwijk,1,0,1,W
75222,12,HOL1,2012-10-06,Zwolle,Heracles,0,3,-3,L
75223,12,HOL1,2012-10-07,Ajax Amsterdam,Utrecht,1,1,0,D
75224,12,HOL1,2012-10-07,Groningen,Feyenoord Rotterdam,2,2,0,D
75225,12,HOL1,2012-10-07,PSV Eindhoven,NAC Breda,4,0,4,W
75226,12,HOL1,2012-10-07,Twente Enschede,AZ Alkmaar,3,0,3,W
75227,12,HOL1,2012-10-20,AZ Alkmaar,NEC Nijmegen,0,2,-2,L
75228,12,HOL1,2012-10-20,Heracles,Ajax Amsterdam,3,3,0,D
75229,12,HOL1,2012-10-20,NAC Breda,Vitesse,0,3,-3,L
75230,12,HOL1,2012-10-20,PSV Eindhoven,Willem II,3,2,1,W
75231,12,HOL1,2012-10-20,Roda,Twente Enschede,1,1,0,D
75232,12,HOL1,2012-10-21,ADO Den Haag,Utrecht,1,2,-1,L
75233,12,HOL1,2012-10-21,Heerenveen,Groningen,3,0,3,W
75234,12,HOL1,2012-10-21,VVV Venlo,Feyenoord Rotterdam,2,3,-1,L
75235,12,HOL1,2012-10-21,Waalwijk,Zwolle,1,2,-1,L
75236,12,HOL1,2012-10-26,Utrecht,Groningen,1,0,1,W
75237,12,HOL1,2012-10-27,ADO Den Haag,Willem II,2,0,2,W
75238,12,HOL1,2012-10-27,NEC Nijmegen,Roda,0,0,0,D
75239,12,HOL1,2012-10-27,VVV Venlo,NAC Breda,1,4,-3,L
75240,12,HOL1,2012-10-28,Feyenoord Rotterdam,Ajax Amsterdam,2,2,0,D
75241,12,HOL1,2012-10-28,Heracles,Heerenveen,6,3,3,W
75242,12,HOL1,2012-10-28,Vitesse,AZ Alkmaar,1,2,-1,L
75243,12,HOL1,2012-10-28,Waalwijk,Twente Enschede,0,1,-1,L
75244,12,HOL1,2012-10-28,Zwolle,PSV Eindhoven,1,2,-1,L
75245,12,HOL1,2012-11-02,Roda,ADO Den Haag,0,0,0,D
75246,12,HOL1,2012-11-03,Ajax Amsterdam,Vitesse,0,2,-2,L
75247,12,HOL1,2012-11-03,PSV Eindhoven,Heracles,4,0,4,W
75248,12,HOL1,2012-11-03,Willem II,Utrecht,1,5,-4,L
75249,12,HOL1,2012-11-04,AZ Alkmaar,VVV Venlo,1,2,-1,L
75250,12,HOL1,2012-11-04,Groningen,NEC Nijmegen,1,2,-1,L
75251,12,HOL1,2012-11-04,Heerenveen,Zwolle,2,1,1,W
75252,12,HOL1,2012-11-04,NAC Breda,Waalwijk,2,1,1,W
75253,12,HOL1,2012-11-04,Twente Enschede,Feyenoord Rotterdam,3,0,3,W
75254,12,HOL1,2012-11-09,NAC Breda,Groningen,0,1,-1,L
75255,12,HOL1,2012-11-10,ADO Den Haag,AZ Alkmaar,2,2,0,D
75256,12,HOL1,2012-11-10,NEC Nijmegen,Heracles,3,2,1,W
75257,12,HOL1,2012-11-10,VVV Venlo,Willem II,4,1,3,W
75258,12,HOL1,2012-11-10,Waalwijk,Utrecht,4,0,4,W
75259,12,HOL1,2012-11-11,Feyenoord Rotterdam,Roda,5,2,3,W
75260,12,HOL1,2012-11-11,PSV Eindhoven,Heerenveen,5,1,4,W
75261,12,HOL1,2012-11-11,Vitesse,Twente Enschede,0,0,0,D
75262,12,HOL1,2012-11-11,Zwolle,Ajax Amsterdam,2,4,-2,L
75263,12,HOL1,2012-11-17,Ajax Amsterdam,VVV Venlo,2,0,2,W
75264,12,HOL1,2012-11-17,ADO Den Haag,PSV Eindhoven,1,6,-5,L
75265,12,HOL1,2012-11-17,Groningen,AZ Alkmaar,1,1,0,D
75266,12,HOL1,2012-11-17,Heerenveen,Waalwijk,0,2,-2,L
75267,12,HOL1,2012-11-17,Zwolle,NAC Breda,2,0,2,W
75268,12,HOL1,2012-11-18,Feyenoord Rotterdam,Willem II,3,0,3,W
75269,12,HOL1,2012-11-18,Heracles,Roda,5,1,4,W
75270,12,HOL1,2012-11-18,Utrecht,Twente Enschede,1,1,0,D
75271,12,HOL1,2012-11-18,Vitesse,NEC Nijmegen,4,1,3,W
75272,12,HOL1,2012-11-23,NAC Breda,ADO Den Haag,0,3,-3,L
75273,12,HOL1,2012-11-24,NEC Nijmegen,Utrecht,2,0,2,W
75274,12,HOL1,2012-11-24,VVV Venlo,Heerenveen,1,1,0,D
75275,12,HOL1,2012-11-24,Waalwijk,Groningen,1,1,0,D
75276,12,HOL1,2012-11-24,Willem II,Heracles,2,2,0,D
75277,12,HOL1,2012-11-25,AZ Alkmaar,Feyenoord Rotterdam,0,2,-2,L
75278,12,HOL1,2012-11-25,PSV Eindhoven,Vitesse,1,2,-1,L
75279,12,HOL1,2012-11-25,Roda,Ajax Amsterdam,1,2,-1,L
75280,12,HOL1,2012-11-25,Twente Enschede,Zwolle,2,2,0,D
75281,12,HOL1,2012-11-30,Zwolle,VVV Venlo,0,0,0,D
75282,12,HOL1,2012-12-01,Ajax Amsterdam,PSV Eindhoven,3,1,2,W
75283,12,HOL1,2012-12-01,Feyenoord Rotterdam,Waalwijk,2,0,2,W
75284,12,HOL1,2012-12-01,Twente Enschede,ADO Den Haag,2,0,2,W
75285,12,HOL1,2012-12-01,Willem II,Heerenveen,3,1,2,W
75286,12,HOL1,2012-12-02,Groningen,Heracles,2,0,2,W
75287,12,HOL1,2012-12-02,NEC Nijmegen,NAC Breda,1,1,0,D
75288,12,HOL1,2012-12-02,Utrecht,AZ Alkmaar,2,1,1,W
75289,12,HOL1,2012-12-02,Vitesse,Roda,3,0,3,W
75290,12,HOL1,2012-12-07,Heracles,Utrecht,1,1,0,D
75291,12,HOL1,2012-12-08,Ajax Amsterdam,Groningen,2,0,2,W
75292,12,HOL1,2012-12-08,AZ Alkmaar,Willem II,0,0,0,D
75293,12,HOL1,2012-12-08,ADO Den Haag,Zwolle,1,1,0,D
75294,12,HOL1,2012-12-08,Waalwijk,NEC Nijmegen,2,0,2,W
75295,12,HOL1,2012-12-09,Heerenveen,Roda,4,4,0,D
75296,12,HOL1,2012-12-09,NAC Breda,Feyenoord Rotterdam,2,2,0,D
75297,12,HOL1,2012-12-09,PSV Eindhoven,Twente Enschede,3,0,3,W
75298,12,HOL1,2012-12-09,VVV Venlo,Vitesse,3,1,2,W
75299,12,HOL1,2012-12-14,Twente Enschede,Heracles,3,2,1,W
75300,12,HOL1,2012-12-15,Groningen,VVV Venlo,0,0,0,D
75301,12,HOL1,2012-12-15,NEC Nijmegen,PSV Eindhoven,1,1,0,D
75302,12,HOL1,2012-12-15,Roda,NAC Breda,0,0,0,D
75303,12,HOL1,2012-12-15,Zwolle,AZ Alkmaar,1,2,-1,L
75304,12,HOL1,2012-12-16,Feyenoord Rotterdam,ADO Den Haag,3,2,1,W
75305,12,HOL1,2012-12-16,Utrecht,Heerenveen,3,1,2,W
75306,12,HOL1,2012-12-16,Vitesse,Waalwijk,2,2,0,D
75307,12,HOL1,2012-12-16,Willem II,Ajax Amsterdam,2,4,-2,L
75308,12,HOL1,2012-12-21,AZ Alkmaar,Twente Enschede,0,3,-3,L
75309,12,HOL1,2012-12-22,ADO Den Haag,NEC Nijmegen,2,0,2,W
75310,12,HOL1,2012-12-22,Heerenveen,Vitesse,2,1,1,W
75311,12,HOL1,2012-12-22,Heracles,Zwolle,1,1,0,D
75312,12,HOL1,2012-12-22,NAC Breda,PSV Eindhoven,1,6,-5,L
75313,12,HOL1,2012-12-23,Feyenoord Rotterdam,Groningen,2,1,1,W
75314,12,HOL1,2012-12-23,Utrecht,Ajax Amsterdam,0,0,0,D
75315,12,HOL1,2012-12-23,VVV Venlo,Roda,2,4,-2,L
75316,12,HOL1,2012-12-23,Waalwijk,Willem II,0,0,0,D
75317,12,HOL1,2013-01-18,PSV Eindhoven,Zwolle,1,3,-2,L
75318,12,HOL1,2013-01-19,AZ Alkmaar,Vitesse,4,1,3,W
75319,12,HOL1,2013-01-19,Heerenveen,Heracles,0,1,-1,L
75320,12,HOL1,2013-01-19,NAC Breda,VVV Venlo,1,0,1,W
75321,12,HOL1,2013-01-19,Twente Enschede,Waalwijk,0,0,0,D
75322,12,HOL1,2013-01-20,Ajax Amsterdam,Feyenoord Rotterdam,3,0,3,W
75323,12,HOL1,2013-01-20,Groningen,Utrecht,0,2,-2,L
75324,12,HOL1,2013-01-20,Roda,NEC Nijmegen,2,0,2,W
75325,12,HOL1,2013-01-20,Willem II,ADO Den Haag,1,1,0,D
75326,12,HOL1,2013-01-25,VVV Venlo,AZ Alkmaar,1,4,-3,L
75327,12,HOL1,2013-01-26,ADO Den Haag,Roda,2,2,0,D
75328,12,HOL1,2013-01-26,Heracles,PSV Eindhoven,1,5,-4,L
75329,12,HOL1,2013-01-26,Waalwijk,NAC Breda,0,4,-4,L
75330,12,HOL1,2013-01-26,Zwolle,Heerenveen,1,1,0,D
75331,12,HOL1,2013-01-27,Feyenoord Rotterdam,Twente Enschede,0,0,0,D
75332,12,HOL1,2013-01-27,NEC Nijmegen,Groningen,2,1,1,W
75333,12,HOL1,2013-01-27,Utrecht,Willem II,3,1,2,W
75334,12,HOL1,2013-01-27,Vitesse,Ajax Amsterdam,3,2,1,W
75335,12,HOL1,2013-02-01,Waalwijk,Heerenveen,0,1,-1,L
75336,12,HOL1,2013-02-02,AZ Alkmaar,Groningen,0,1,-1,L
75337,12,HOL1,2013-02-02,NAC Breda,Zwolle,3,0,3,W
75338,12,HOL1,2013-02-02,PSV Eindhoven,ADO Den Haag,7,0,7,W
75339,12,HOL1,2013-02-02,Roda,Heracles,3,3,0,D
75340,12,HOL1,2013-02-03,NEC Nijmegen,Vitesse,2,1,1,W
75341,12,HOL1,2013-02-03,Twente Enschede,Utrecht,2,4,-2,L
75342,12,HOL1,2013-02-03,VVV Venlo,Ajax Amsterdam,0,3,-3,L
75343,12,HOL1,2013-02-03,Willem II,Feyenoord Rotterdam,1,3,-2,L
75344,12,HOL1,2013-02-09,ADO Den Haag,NAC Breda,2,1,1,W
75345,12,HOL1,2013-02-09,Groningen,Waalwijk,2,1,1,W
75346,12,HOL1,2013-02-09,Heerenveen,VVV Venlo,2,2,0,D
75347,12,HOL1,2013-02-09,Heracles,Willem II,4,1,3,W
75348,12,HOL1,2013-02-09,Vitesse,PSV Eindhoven,2,2,0,D
75349,12,HOL1,2013-02-10,Ajax Amsterdam,Roda,1,1,0,D
75350,12,HOL1,2013-02-10,Feyenoord Rotterdam,AZ Alkmaar,3,1,2,W
75351,12,HOL1,2013-02-10,Utrecht,NEC Nijmegen,0,3,-3,L
75352,12,HOL1,2013-02-10,Zwolle,Twente Enschede,1,1,0,D
75353,12,HOL1,2013-02-15,NEC Nijmegen,VVV Venlo,1,2,-1,L
75354,12,HOL1,2013-02-16,NAC Breda,Heracles,1,1,0,D
75355,12,HOL1,2013-02-16,PSV Eindhoven,Utrecht,2,1,1,W
75356,12,HOL1,2013-02-16,Roda,AZ Alkmaar,2,2,0,D
75357,12,HOL1,2013-02-16,Twente Enschede,Willem II,1,1,0,D
75358,12,HOL1,2013-02-17,ADO Den Haag,Heerenveen,2,1,1,W
75359,12,HOL1,2013-02-17,Vitesse,Groningen,2,0,2,W
75360,12,HOL1,2013-02-17,Waalwijk,Ajax Amsterdam,0,2,-2,L
75361,12,HOL1,2013-02-17,Zwolle,Feyenoord Rotterdam,3,2,1,W
75362,12,HOL1,2013-02-22,Willem II,NEC Nijmegen,2,3,-1,L
75363,12,HOL1,2013-02-23,Groningen,Zwolle,1,0,1,W
75364,12,HOL1,2013-02-23,Heerenveen,Twente Enschede,2,1,1,W
75365,12,HOL1,2013-02-23,Heracles,Vitesse,3,5,-2,L
75366,12,HOL1,2013-02-23,VVV Venlo,Waalwijk,1,0,1,W
75367,12,HOL1,2013-02-24,Ajax Amsterdam,ADO Den Haag,1,1,0,D
75368,12,HOL1,2013-02-24,AZ Alkmaar,NAC Breda,0,1,-1,L
75369,12,HOL1,2013-02-24,Feyenoord Rotterdam,PSV Eindhoven,2,1,1,W
75370,12,HOL1,2013-02-24,Utrecht,Roda,4,0,4,W
75371,12,HOL1,2013-03-01,Vitesse,Utrecht,2,0,2,W
75372,12,HOL1,2013-03-02,NAC Breda,Heerenveen,1,2,-1,L
75373,12,HOL1,2013-03-02,PSV Eindhoven,VVV Venlo,2,0,2,W
75374,12,HOL1,2013-03-02,Twente Enschede,Ajax Amsterdam,0,2,-2,L
75375,12,HOL1,2013-03-02,Zwolle,Willem II,2,0,2,W
75376,12,HOL1,2013-03-03,ADO Den Haag,Heracles,3,1,2,W
75377,12,HOL1,2013-03-03,NEC Nijmegen,Feyenoord Rotterdam,0,3,-3,L
75378,12,HOL1,2013-03-03,Roda,Groningen,4,1,3,W
75379,12,HOL1,2013-03-03,Waalwijk,AZ Alkmaar,2,1,1,W
75380,12,HOL1,2013-03-08,Groningen,NAC Breda,1,1,0,D
75381,12,HOL1,2013-03-09,AZ Alkmaar,ADO Den Haag,1,1,0,D
75382,12,HOL1,2013-03-09,Heerenveen,PSV Eindhoven,2,1,1,W
75383,12,HOL1,2013-03-09,Heracles,NEC Nijmegen,1,0,1,W
75384,12,HOL1,2013-03-09,Willem II,VVV Venlo,1,0,1,W
75385,12,HOL1,2013-03-10,Ajax Amsterdam,Zwolle,3,0,3,W
75386,12,HOL1,2013-03-10,Roda,Feyenoord Rotterdam,0,1,-1,L
75387,12,HOL1,2013-03-10,Twente Enschede,Vitesse,0,1,-1,L
75388,12,HOL1,2013-03-10,Utrecht,Waalwijk,1,0,1,W
75389,12,HOL1,2013-03-15,Zwolle,Roda,3,2,1,W
75390,12,HOL1,2013-03-16,ADO Den Haag,Vitesse,0,4,-4,L
75391,12,HOL1,2013-03-16,NEC Nijmegen,Heerenveen,1,3,-2,L
75392,12,HOL1,2013-03-16,PSV Eindhoven,Waalwijk,2,0,2,W
75393,12,HOL1,2013-03-16,VVV Venlo,Heracles,0,2,-2,L
75394,12,HOL1,2013-03-17,AZ Alkmaar,Ajax Amsterdam,2,3,-1,L
75395,12,HOL1,2013-03-17,Feyenoord Rotterdam,Utrecht,2,1,1,W
75396,12,HOL1,2013-03-17,Groningen,Twente Enschede,0,3,-3,L
75397,12,HOL1,2013-03-17,NAC Breda,Willem II,4,0,4,W
75398,12,HOL1,2013-03-30,Heerenveen,Feyenoord Rotterdam,2,0,2,W
75399,12,HOL1,2013-03-30,Twente Enschede,NAC Breda,1,1,0,D
75400,12,HOL1,2013-03-30,Utrecht,VVV Venlo,2,1,1,W
75401,12,HOL1,2013-03-30,Willem II,Groningen,1,2,-1,L
75402,12,HOL1,2013-03-31,Ajax Amsterdam,NEC Nijmegen,4,1,3,W
75403,12,HOL1,2013-03-31,Heracles,AZ Alkmaar,1,2,-1,L
75404,12,HOL1,2013-03-31,Roda,PSV Eindhoven,2,2,0,D
75405,12,HOL1,2013-03-31,Vitesse,Zwolle,2,1,1,W
75406,12,HOL1,2013-03-31,Waalwijk,ADO Den Haag,4,0,4,W
75407,12,HOL1,2013-04-05,Feyenoord Rotterdam,VVV Venlo,1,0,1,W
75408,12,HOL1,2013-04-06,Twente Enschede,Roda,2,0,2,W
75409,12,HOL1,2013-04-06,Vitesse,NAC Breda,3,0,3,W
75410,12,HOL1,2013-04-06,Willem II,PSV Eindhoven,1,3,-2,L
75411,12,HOL1,2013-04-06,Zwolle,Waalwijk,1,1,0,D
75412,12,HOL1,2013-04-07,Ajax Amsterdam,Heracles,4,0,4,W
75413,12,HOL1,2013-04-07,Groningen,Heerenveen,3,1,2,W
75414,12,HOL1,2013-04-07,NEC Nijmegen,AZ Alkmaar,1,1,0,D
75415,12,HOL1,2013-04-07,Utrecht,ADO Den Haag,1,0,1,W
75416,12,HOL1,2013-04-12,VVV Venlo,Zwolle,0,2,-2,L
75417,12,HOL1,2013-04-13,ADO Den Haag,Twente Enschede,1,3,-2,L
75418,12,HOL1,2013-04-13,Heracles,Groningen,0,2,-2,L
75419,12,HOL1,2013-04-13,NAC Breda,NEC Nijmegen,2,0,2,W
75420,12,HOL1,2013-04-13,Roda,Vitesse,3,3,0,D
75421,12,HOL1,2013-04-14,AZ Alkmaar,Utrecht,6,0,6,W
75422,12,HOL1,2013-04-14,Heerenveen,Willem II,3,2,1,W
75423,12,HOL1,2013-04-14,PSV Eindhoven,Ajax Amsterdam,2,3,-1,L
75424,12,HOL1,2013-04-14,Waalwijk,Feyenoord Rotterdam,1,1,0,D
75425,12,HOL1,2013-04-19,Ajax Amsterdam,Heerenveen,1,1,0,D
75426,12,HOL1,2013-04-20,AZ Alkmaar,PSV Eindhoven,1,3,-2,L
75427,12,HOL1,2013-04-20,Groningen,ADO Den Haag,2,1,1,W
75428,12,HOL1,2013-04-20,Heracles,Waalwijk,4,0,4,W
75429,12,HOL1,2013-04-20,Willem II,Roda,2,1,1,W
75430,12,HOL1,2013-04-21,Feyenoord Rotterdam,Vitesse,2,0,2,W
75431,12,HOL1,2013-04-21,NEC Nijmegen,Zwolle,1,3,-2,L
75432,12,HOL1,2013-04-21,Utrecht,NAC Breda,3,0,3,W
75433,12,HOL1,2013-04-21,VVV Venlo,Twente Enschede,2,2,0,D
75434,12,HOL1,2013-04-26,Heerenveen,AZ Alkmaar,0,4,-4,L
75435,12,HOL1,2013-04-27,ADO Den Haag,VVV Venlo,1,1,0,D
75436,12,HOL1,2013-04-27,NAC Breda,Ajax Amsterdam,0,2,-2,L
75437,12,HOL1,2013-04-27,PSV Eindhoven,Groningen,5,2,3,W
75438,12,HOL1,2013-04-27,Roda,Waalwijk,3,1,2,W
75439,12,HOL1,2013-04-28,Feyenoord Rotterdam,Heracles,6,0,6,W
75440,12,HOL1,2013-04-28,Twente Enschede,NEC Nijmegen,5,2,3,W
75441,12,HOL1,2013-04-28,Vitesse,Willem II,3,1,2,W
75442,12,HOL1,2013-04-28,Zwolle,Utrecht,1,2,-1,L
75443,12,HOL1,2013-05-05,Ajax Amsterdam,Willem II,5,0,5,W
75444,12,HOL1,2013-05-05,AZ Alkmaar,Zwolle,4,0,4,W
75445,12,HOL1,2013-05-05,ADO Den Haag,Feyenoord Rotterdam,2,0,2,W
75446,12,HOL1,2013-05-05,Heerenveen,Utrecht,2,4,-2,L
75447,12,HOL1,2013-05-05,Heracles,Twente Enschede,1,1,0,D
75448,12,HOL1,2013-05-05,NAC Breda,Roda,5,3,2,W
75449,12,HOL1,2013-05-05,PSV Eindhoven,NEC Nijmegen,4,2,2,W
75450,12,HOL1,2013-05-05,VVV Venlo,Groningen,0,0,0,D
75451,12,HOL1,2013-05-05,Waalwijk,Vitesse,3,2,1,W
75452,12,HOL1,2013-05-12,Feyenoord Rotterdam,NAC Breda,1,0,1,W
75453,12,HOL1,2013-05-12,Groningen,Ajax Amsterdam,0,2,-2,L
75454,12,HOL1,2013-05-12,NEC Nijmegen,Waalwijk,1,2,-1,L
75455,12,HOL1,2013-05-12,Roda,Heerenveen,1,0,1,W
75456,12,HOL1,2013-05-12,Twente Enschede,PSV Eindhoven,3,1,2,W
75457,12,HOL1,2013-05-12,Utrecht,Heracles,3,0,3,W
75458,12,HOL1,2013-05-12,Vitesse,VVV Venlo,0,1,-1,L
75459,12,HOL1,2013-05-12,Willem II,AZ Alkmaar,2,0,2,W
75460,12,HOL1,2013-05-12,Zwolle,ADO Den Haag,4,2,2,W
75461,13,HOL1,2013-08-02,Ajax Amsterdam,Roda,3,0,3,W
75462,13,HOL1,2013-08-03,ADO Den Haag,PSV Eindhoven,2,3,-1,L
75463,13,HOL1,2013-08-03,Heerenveen,AZ Alkmaar,4,2,2,W
75464,13,HOL1,2013-08-03,NEC Nijmegen,Groningen,1,4,-3,L
75465,13,HOL1,2013-08-03,Twente Enschede,Waalwijk,0,0,0,D
75466,13,HOL1,2013-08-04,Cambuur,NAC Breda,0,0,0,D
75467,13,HOL1,2013-08-04,Utrecht,Go Ahead Eagles,1,1,0,D
75468,13,HOL1,2013-08-04,Vitesse,Heracles,3,1,2,W
75469,13,HOL1,2013-08-04,Zwolle,Feyenoord Rotterdam,2,1,1,W
75470,13,HOL1,2013-08-09,Roda,Cambuur,2,0,2,W
75471,13,HOL1,2013-08-10,Go Ahead Eagles,ADO Den Haag,2,1,1,W
75472,13,HOL1,2013-08-10,Heracles,Zwolle,1,3,-2,L
75473,13,HOL1,2013-08-10,NAC Breda,Heerenveen,0,2,-2,L
75474,13,HOL1,2013-08-10,PSV Eindhoven,NEC Nijmegen,5,0,5,W
75475,13,HOL1,2013-08-11,AZ Alkmaar,Ajax Amsterdam,3,2,1,W
75476,13,HOL1,2013-08-11,Feyenoord Rotterdam,Twente Enschede,1,4,-3,L
75477,13,HOL1,2013-08-11,Groningen,Utrecht,2,0,2,W
75478,13,HOL1,2013-08-11,Waalwijk,Vitesse,4,2,2,W
75479,13,HOL1,2013-08-17,Cambuur,Groningen,4,1,3,W
75480,13,HOL1,2013-08-17,NEC Nijmegen,Zwolle,1,5,-4,L
75481,13,HOL1,2013-08-17,PSV Eindhoven,Go Ahead Eagles,3,0,3,W
75482,13,HOL1,2013-08-17,Roda,Vitesse,1,1,0,D
75483,13,HOL1,2013-08-17,Waalwijk,AZ Alkmaar,1,2,-1,L
75484,13,HOL1,2013-08-18,Ajax Amsterdam,Feyenoord Rotterdam,2,1,1,W
75485,13,HOL1,2013-08-18,Heerenveen,Heracles,2,4,-2,L
75486,13,HOL1,2013-08-18,NAC Breda,ADO Den Haag,1,2,-1,L
75487,13,HOL1,2013-08-18,Twente Enschede,Utrecht,6,0,6,W
75488,13,HOL1,2013-08-23,Heerenveen,Ajax Amsterdam,3,3,0,D
75489,13,HOL1,2013-08-24,ADO Den Haag,Roda,0,4,-4,L
75490,13,HOL1,2013-08-24,Heracles,PSV Eindhoven,1,1,0,D
75491,13,HOL1,2013-08-24,NEC Nijmegen,Waalwijk,2,2,0,D
75492,13,HOL1,2013-08-24,Zwolle,Cambuur,2,0,2,W
75493,13,HOL1,2013-08-25,Feyenoord Rotterdam,NAC Breda,3,1,2,W
75494,13,HOL1,2013-08-25,Go Ahead Eagles,Groningen,3,3,0,D
75495,13,HOL1,2013-08-25,Utrecht,AZ Alkmaar,2,0,2,W
75496,13,HOL1,2013-08-25,Vitesse,Twente Enschede,1,0,1,W
75497,13,HOL1,2013-08-30,NAC Breda,NEC Nijmegen,1,1,0,D
75498,13,HOL1,2013-08-31,Heracles,ADO Den Haag,1,0,1,W
75499,13,HOL1,2013-08-31,PSV Eindhoven,Cambuur,0,0,0,D
75500,13,HOL1,2013-08-31,Twente Enschede,Heerenveen,1,1,0,D
75501,13,HOL1,2013-08-31,Waalwijk,Go Ahead Eagles,1,4,-3,L
75502,13,HOL1,2013-09-01,AZ Alkmaar,Vitesse,1,1,0,D
75503,13,HOL1,2013-09-01,Feyenoord Rotterdam,Roda,4,0,4,W
75504,13,HOL1,2013-09-01,Groningen,Ajax Amsterdam,1,1,0,D
75505,13,HOL1,2013-09-01,Zwolle,Utrecht,1,1,0,D
75506,13,HOL1,2013-09-14,Ajax Amsterdam,Zwolle,2,1,1,W
75507,13,HOL1,2013-09-14,Cambuur,Heracles,2,0,2,W
75508,13,HOL1,2013-09-14,Twente Enschede,PSV Eindhoven,2,2,0,D
75509,13,HOL1,2013-09-15,AZ Alkmaar,Go Ahead Eagles,3,0,3,W
75510,13,HOL1,2013-09-15,Heerenveen,Groningen,4,2,2,W
75511,13,HOL1,2013-09-15,NEC Nijmegen,Feyenoord Rotterdam,3,3,0,D
75512,13,HOL1,2013-09-15,Roda,NAC Breda,1,5,-4,L
75513,13,HOL1,2013-09-15,Utrecht,Waalwijk,2,1,1,W
75514,13,HOL1,2013-09-20,Go Ahead Eagles,Cambuur,0,0,0,D
75515,13,HOL1,2013-09-21,ADO Den Haag,NEC Nijmegen,1,1,0,D
75516,13,HOL1,2013-09-21,Groningen,Waalwijk,4,1,3,W
75517,13,HOL1,2013-09-21,Heracles,Twente Enschede,0,3,-3,L
75518,13,HOL1,2013-09-21,Roda,Heerenveen,3,3,0,D
75519,13,HOL1,2013-09-22,Feyenoord Rotterdam,Utrecht,1,0,1,W
75520,13,HOL1,2013-09-22,NAC Breda,AZ Alkmaar,3,0,3,W
75521,13,HOL1,2013-09-22,PSV Eindhoven,Ajax Amsterdam,4,0,4,W
75522,13,HOL1,2013-09-22,Vitesse,Zwolle,3,0,3,W
75523,13,HOL1,2013-09-28,Ajax Amsterdam,Go Ahead Eagles,6,0,6,W
75524,13,HOL1,2013-09-28,AZ Alkmaar,PSV Eindhoven,2,1,1,W
75525,13,HOL1,2013-09-28,Utrecht,Roda,3,3,0,D
75526,13,HOL1,2013-09-28,Waalwijk,Heracles,1,4,-3,L
75527,13,HOL1,2013-09-28,Zwolle,NAC Breda,0,0,0,D
75528,13,HOL1,2013-09-29,Feyenoord Rotterdam,ADO Den Haag,4,2,2,W
75529,13,HOL1,2013-09-29,Heerenveen,Cambuur,2,1,1,W
75530,13,HOL1,2013-09-29,NEC Nijmegen,Vitesse,2,3,-1,L
75531,13,HOL1,2013-09-29,Twente Enschede,Groningen,5,0,5,W
75532,13,HOL1,2013-10-02,ADO Den Haag,Vitesse,2,1,1,W
75533,13,HOL1,2013-10-04,Cambuur,Twente Enschede,0,1,-1,L
75534,13,HOL1,2013-10-05,Go Ahead Eagles,NEC Nijmegen,4,3,1,W
75535,13,HOL1,2013-10-05,NAC Breda,Heracles,2,1,1,W
75536,13,HOL1,2013-10-05,Roda,Zwolle,0,0,0,D
75537,13,HOL1,2013-10-06,Ajax Amsterdam,Utrecht,3,0,3,W
75538,13,HOL1,2013-10-06,Groningen,AZ Alkmaar,2,1,1,W
75539,13,HOL1,2013-10-06,PSV Eindhoven,Waalwijk,2,1,1,W
75540,13,HOL1,2013-10-06,Vitesse,Feyenoord Rotterdam,1,2,-1,L
75541,13,HOL1,2013-10-19,Go Ahead Eagles,Feyenoord Rotterdam,2,2,0,D
75542,13,HOL1,2013-10-19,Heerenveen,Vitesse,2,3,-1,L
75543,13,HOL1,2013-10-19,Twente Enschede,Ajax Amsterdam,1,1,0,D
75544,13,HOL1,2013-10-19,Utrecht,NAC Breda,4,2,2,W
75545,13,HOL1,2013-10-19,Waalwijk,Roda,1,2,-1,L
75546,13,HOL1,2013-10-20,AZ Alkmaar,Cambuur,3,1,2,W
75547,13,HOL1,2013-10-20,Groningen,PSV Eindhoven,1,0,1,W
75548,13,HOL1,2013-10-20,Heracles,NEC Nijmegen,1,1,0,D
75549,13,HOL1,2013-10-20,Zwolle,ADO Den Haag,6,1,5,W
75550,13,HOL1,2013-10-25,NEC Nijmegen,Heerenveen,2,1,1,W
75551,13,HOL1,2013-10-26,Ajax Amsterdam,Waalwijk,0,0,0,D
75552,13,HOL1,2013-10-26,Cambuur,Utrecht,3,1,2,W
75553,13,HOL1,2013-10-26,ADO Den Haag,Twente Enschede,3,2,1,W
75554,13,HOL1,2013-10-26,NAC Breda,Go Ahead Eagles,5,0,5,W
75555,13,HOL1,2013-10-27,Feyenoord Rotterdam,Heracles,1,2,-1,L
75556,13,HOL1,2013-10-27,Roda,PSV Eindhoven,2,1,1,W
75557,13,HOL1,2013-10-27,Vitesse,Groningen,2,2,0,D
75558,13,HOL1,2013-10-27,Zwolle,AZ Alkmaar,0,2,-2,L
75559,13,HOL1,2013-11-01,Waalwijk,NAC Breda,3,0,3,W
75560,13,HOL1,2013-11-02,Ajax Amsterdam,Vitesse,0,1,-1,L
75561,13,HOL1,2013-11-02,AZ Alkmaar,ADO Den Haag,2,0,2,W
75562,13,HOL1,2013-11-02,PSV Eindhoven,Zwolle,1,1,0,D
75563,13,HOL1,2013-11-02,Twente Enschede,NEC Nijmegen,2,2,0,D
75564,13,HOL1,2013-11-03,Cambuur,Feyenoord Rotterdam,0,2,-2,L
75565,13,HOL1,2013-11-03,Groningen,Roda,3,3,0,D
75566,13,HOL1,2013-11-03,Utrecht,Heerenveen,2,0,2,W
75567,13,HOL1,2013-11-08,Heerenveen,Waalwijk,5,2,3,W
75568,13,HOL1,2013-11-09,ADO Den Haag,Cambuur,3,0,3,W
75569,13,HOL1,2013-11-09,Heracles,Groningen,0,3,-3,L
75570,13,HOL1,2013-11-09,Roda,Go Ahead Eagles,1,4,-3,L
75571,13,HOL1,2013-11-09,Vitesse,Utrecht,3,1,2,W
75572,13,HOL1,2013-11-10,Feyenoord Rotterdam,AZ Alkmaar,2,2,0,D
75573,13,HOL1,2013-11-10,NAC Breda,PSV Eindhoven,2,1,1,W
75574,13,HOL1,2013-11-10,NEC Nijmegen,Ajax Amsterdam,0,3,-3,L
75575,13,HOL1,2013-11-10,Zwolle,Twente Enschede,1,1,0,D
75576,13,HOL1,2013-11-23,Ajax Amsterdam,Heracles,3,0,3,W
75577,13,HOL1,2013-11-23,AZ Alkmaar,Roda,2,2,0,D
75578,13,HOL1,2013-11-23,Cambuur,NEC Nijmegen,2,1,1,W
75579,13,HOL1,2013-11-23,PSV Eindhoven,Heerenveen,1,1,0,D
75580,13,HOL1,2013-11-24,Go Ahead Eagles,Vitesse,0,3,-3,L
75581,13,HOL1,2013-11-24,Groningen,Zwolle,0,0,0,D
75582,13,HOL1,2013-11-24,Twente Enschede,NAC Breda,5,2,3,W
75583,13,HOL1,2013-11-24,Utrecht,ADO Den Haag,3,0,3,W
75584,13,HOL1,2013-11-24,Waalwijk,Feyenoord Rotterdam,1,0,1,W
75585,13,HOL1,2013-11-29,Roda,Twente Enschede,1,2,-1,L
75586,13,HOL1,2013-11-30,Heerenveen,Go Ahead Eagles,3,1,2,W
75587,13,HOL1,2013-11-30,Heracles,Utrecht,1,2,-1,L
75588,13,HOL1,2013-11-30,NAC Breda,Groningen,2,2,0,D
75589,13,HOL1,2013-11-30,Zwolle,Waalwijk,1,1,0,D
75590,13,HOL1,2013-12-01,ADO Den Haag,Ajax Amsterdam,0,4,-4,L
75591,13,HOL1,2013-12-01,Feyenoord Rotterdam,PSV Eindhoven,3,1,2,W
75592,13,HOL1,2013-12-01,NEC Nijmegen,AZ Alkmaar,3,2,1,W
75593,13,HOL1,2013-12-01,Vitesse,Cambuur,3,0,3,W
75594,13,HOL1,2013-12-04,ADO Den Haag,Heerenveen,1,1,0,D
75595,13,HOL1,2013-12-04,Go Ahead Eagles,Heracles,1,1,0,D
75596,13,HOL1,2013-12-06,Utrecht,NEC Nijmegen,2,0,2,W
75597,13,HOL1,2013-12-07,Ajax Amsterdam,NAC Breda,4,0,4,W
75598,13,HOL1,2013-12-07,AZ Alkmaar,Twente Enschede,1,2,-1,L
75599,13,HOL1,2013-12-07,PSV Eindhoven,Vitesse,2,6,-4,L
75600,13,HOL1,2013-12-07,Waalwijk,Cambuur,2,2,0,D
75601,13,HOL1,2013-12-08,Go Ahead Eagles,Zwolle,4,1,3,W
75602,13,HOL1,2013-12-08,Groningen,ADO Den Haag,1,2,-1,L
75603,13,HOL1,2013-12-08,Heerenveen,Feyenoord Rotterdam,1,2,-1,L
75604,13,HOL1,2013-12-08,Roda,Heracles,1,3,-2,L
75605,13,HOL1,2013-12-13,Zwolle,Heerenveen,1,2,-1,L
75606,13,HOL1,2013-12-14,ADO Den Haag,Waalwijk,1,2,-1,L
75607,13,HOL1,2013-12-14,NEC Nijmegen,Roda,4,3,1,W
75608,13,HOL1,2013-12-14,Twente Enschede,Go Ahead Eagles,3,1,2,W
75609,13,HOL1,2013-12-15,Cambuur,Ajax Amsterdam,1,2,-1,L
75610,13,HOL1,2013-12-15,Feyenoord Rotterdam,Groningen,1,0,1,W
75611,13,HOL1,2013-12-15,Heracles,AZ Alkmaar,2,0,2,W
75612,13,HOL1,2013-12-15,Utrecht,PSV Eindhoven,1,5,-4,L
75613,13,HOL1,2013-12-15,Vitesse,NAC Breda,3,2,1,W
75614,13,HOL1,2013-12-20,Waalwijk,Twente Enschede,1,1,0,D
75615,13,HOL1,2013-12-21,AZ Alkmaar,Heerenveen,1,5,-4,L
75616,13,HOL1,2013-12-21,Feyenoord Rotterdam,Zwolle,3,0,3,W
75617,13,HOL1,2013-12-21,Heracles,Vitesse,2,2,0,D
75618,13,HOL1,2013-12-21,NAC Breda,Cambuur,1,0,1,W
75619,13,HOL1,2013-12-22,Go Ahead Eagles,Utrecht,2,1,1,W
75620,13,HOL1,2013-12-22,Groningen,NEC Nijmegen,5,2,3,W
75621,13,HOL1,2013-12-22,PSV Eindhoven,ADO Den Haag,2,0,2,W
75622,13,HOL1,2013-12-22,Roda,Ajax Amsterdam,1,2,-1,L
75623,13,HOL1,2014-01-17,Twente Enschede,Heracles,3,1,2,W
75624,13,HOL1,2014-01-18,AZ Alkmaar,NAC Breda,3,0,3,W
75625,13,HOL1,2014-01-18,Heerenveen,Roda,2,2,0,D
75626,13,HOL1,2014-01-18,Waalwijk,Groningen,1,1,0,D
75627,13,HOL1,2014-01-18,Zwolle,Vitesse,1,2,-1,L
75628,13,HOL1,2014-01-19,Ajax Amsterdam,PSV Eindhoven,1,0,1,W
75629,13,HOL1,2014-01-19,Cambuur,Go Ahead Eagles,2,0,2,W
75630,13,HOL1,2014-01-19,NEC Nijmegen,ADO Den Haag,3,1,2,W
75631,13,HOL1,2014-01-19,Utrecht,Feyenoord Rotterdam,2,5,-3,L
75632,13,HOL1,2014-01-24,Heracles,Waalwijk,2,1,1,W
75633,13,HOL1,2014-01-25,ADO Den Haag,Feyenoord Rotterdam,3,2,1,W
75634,13,HOL1,2014-01-25,NAC Breda,Zwolle,1,2,-1,L
75635,13,HOL1,2014-01-25,PSV Eindhoven,AZ Alkmaar,1,0,1,W
75636,13,HOL1,2014-01-25,Roda,Utrecht,1,0,1,W
75637,13,HOL1,2014-01-26,Cambuur,Heerenveen,3,1,2,W
75638,13,HOL1,2014-01-26,Go Ahead Eagles,Ajax Amsterdam,0,1,-1,L
75639,13,HOL1,2014-01-26,Vitesse,NEC Nijmegen,1,1,0,D
75640,13,HOL1,2014-01-31,Feyenoord Rotterdam,Vitesse,1,1,0,D
75641,13,HOL1,2014-02-01,AZ Alkmaar,Groningen,2,0,2,W
75642,13,HOL1,2014-02-01,Heerenveen,ADO Den Haag,3,0,3,W
75643,13,HOL1,2014-02-01,Heracles,NAC Breda,1,2,-1,L
75644,13,HOL1,2014-02-01,Zwolle,Roda,3,1,2,W
75645,13,HOL1,2014-02-02,NEC Nijmegen,Go Ahead Eagles,1,1,0,D
75646,13,HOL1,2014-02-02,Twente Enschede,Cambuur,3,1,2,W
75647,13,HOL1,2014-02-02,Utrecht,Ajax Amsterdam,1,1,0,D
75648,13,HOL1,2014-02-02,Waalwijk,PSV Eindhoven,2,0,2,W
75649,13,HOL1,2014-02-04,ADO Den Haag,Heracles,0,3,-3,L
75650,13,HOL1,2014-02-04,Roda,Feyenoord Rotterdam,1,2,-1,L
75651,13,HOL1,2014-02-04,Vitesse,AZ Alkmaar,0,2,-2,L
75652,13,HOL1,2014-02-05,Cambuur,PSV Eindhoven,1,2,-1,L
75653,13,HOL1,2014-02-05,Go Ahead Eagles,Waalwijk,2,2,0,D
75654,13,HOL1,2014-02-05,Heerenveen,Twente Enschede,0,2,-2,L
75655,13,HOL1,2014-02-05,NEC Nijmegen,NAC Breda,1,1,0,D
75656,13,HOL1,2014-02-06,Ajax Amsterdam,Groningen,2,1,1,W
75657,13,HOL1,2014-02-06,Utrecht,Zwolle,1,2,-1,L
75658,13,HOL1,2014-02-07,Vitesse,ADO Den Haag,0,0,0,D
75659,13,HOL1,2014-02-08,Feyenoord Rotterdam,NEC Nijmegen,5,1,4,W
75660,13,HOL1,2014-02-08,Go Ahead Eagles,AZ Alkmaar,2,1,1,W
75661,13,HOL1,2014-02-08,NAC Breda,Roda,2,0,2,W
75662,13,HOL1,2014-02-08,PSV Eindhoven,Twente Enschede,3,2,1,W
75663,13,HOL1,2014-02-09,Groningen,Heerenveen,1,3,-2,L
75664,13,HOL1,2014-02-09,Heracles,Cambuur,1,1,0,D
75665,13,HOL1,2014-02-09,Waalwijk,Utrecht,5,2,3,W
75666,13,HOL1,2014-02-09,Zwolle,Ajax Amsterdam,1,1,0,D
75667,13,HOL1,2014-02-12,Groningen,Twente Enschede,1,1,0,D
75668,13,HOL1,2014-02-14,PSV Eindhoven,Heracles,2,1,1,W
75669,13,HOL1,2014-02-15,AZ Alkmaar,Utrecht,1,1,0,D
75670,13,HOL1,2014-02-15,Roda,ADO Den Haag,0,1,-1,L
75671,13,HOL1,2014-02-15,Twente Enschede,Vitesse,2,0,2,W
75672,13,HOL1,2014-02-15,Waalwijk,NEC Nijmegen,1,3,-2,L
75673,13,HOL1,2014-02-16,Ajax Amsterdam,Heerenveen,3,0,3,W
75674,13,HOL1,2014-02-16,Cambuur,Zwolle,3,1,2,W
75675,13,HOL1,2014-02-16,Groningen,Go Ahead Eagles,1,0,1,W
75676,13,HOL1,2014-02-16,NAC Breda,Feyenoord Rotterdam,1,1,0,D
75677,13,HOL1,2014-02-21,ADO Den Haag,Go Ahead Eagles,3,2,1,W
75678,13,HOL1,2014-02-22,Cambuur,Roda,1,0,1,W
75679,13,HOL1,2014-02-22,Heerenveen,NAC Breda,0,0,0,D
75680,13,HOL1,2014-02-22,NEC Nijmegen,PSV Eindhoven,0,2,-2,L
75681,13,HOL1,2014-02-22,Zwolle,Heracles,1,1,0,D
75682,13,HOL1,2014-02-23,Ajax Amsterdam,AZ Alkmaar,4,0,4,W
75683,13,HOL1,2014-02-23,Twente Enschede,Feyenoord Rotterdam,2,2,0,D
75684,13,HOL1,2014-02-23,Utrecht,Groningen,1,0,1,W
75685,13,HOL1,2014-02-23,Vitesse,Waalwijk,3,1,2,W
75686,13,HOL1,2014-02-28,Heracles,Heerenveen,1,2,-1,L
75687,13,HOL1,2014-03-01,ADO Den Haag,NAC Breda,1,1,0,D
75688,13,HOL1,2014-03-01,Go Ahead Eagles,PSV Eindhoven,2,3,-1,L
75689,13,HOL1,2014-03-01,Vitesse,Roda,3,0,3,W
75690,13,HOL1,2014-03-01,Zwolle,NEC Nijmegen,3,3,0,D
75691,13,HOL1,2014-03-02,AZ Alkmaar,Waalwijk,4,0,4,W
75692,13,HOL1,2014-03-02,Feyenoord Rotterdam,Ajax Amsterdam,1,2,-1,L
75693,13,HOL1,2014-03-02,Groningen,Cambuur,1,1,0,D
75694,13,HOL1,2014-03-02,Utrecht,Twente Enschede,1,1,0,D
75695,13,HOL1,2014-03-08,AZ Alkmaar,Heracles,4,0,4,W
75696,13,HOL1,2014-03-08,Heerenveen,Zwolle,3,0,3,W
75697,13,HOL1,2014-03-08,NAC Breda,Vitesse,1,2,-1,L
75698,13,HOL1,2014-03-08,PSV Eindhoven,Utrecht,1,0,1,W
75699,13,HOL1,2014-03-08,Roda,NEC Nijmegen,3,1,2,W
75700,13,HOL1,2014-03-09,Ajax Amsterdam,Cambuur,1,1,0,D
75701,13,HOL1,2014-03-09,Go Ahead Eagles,Twente Enschede,1,0,1,W
75702,13,HOL1,2014-03-09,Groningen,Feyenoord Rotterdam,0,2,-2,L
75703,13,HOL1,2014-03-09,Waalwijk,ADO Den Haag,1,1,0,D
75704,13,HOL1,2014-03-14,Cambuur,Waalwijk,3,2,1,W
75705,13,HOL1,2014-03-15,ADO Den Haag,Groningen,2,1,1,W
75706,13,HOL1,2014-03-15,Heracles,Roda,2,1,1,W
75707,13,HOL1,2014-03-15,Vitesse,PSV Eindhoven,1,2,-1,L
75708,13,HOL1,2014-03-16,Feyenoord Rotterdam,Heerenveen,2,0,2,W
75709,13,HOL1,2014-03-16,NAC Breda,Ajax Amsterdam,0,0,0,D
75710,13,HOL1,2014-03-16,NEC Nijmegen,Utrecht,2,2,0,D
75711,13,HOL1,2014-03-16,Twente Enschede,AZ Alkmaar,2,1,1,W
75712,13,HOL1,2014-03-16,Zwolle,Go Ahead Eagles,2,0,2,W
75713,13,HOL1,2014-03-22,Groningen,Vitesse,3,1,2,W
75714,13,HOL1,2014-03-22,Heerenveen,NEC Nijmegen,2,2,0,D
75715,13,HOL1,2014-03-22,PSV Eindhoven,Roda,3,1,2,W
75716,13,HOL1,2014-03-23,AZ Alkmaar,Zwolle,2,1,1,W
75717,13,HOL1,2014-03-28,NAC Breda,Utrecht,2,2,0,D
75718,13,HOL1,2014-03-29,NEC Nijmegen,Heracles,1,2,-1,L
75719,13,HOL1,2014-03-29,PSV Eindhoven,Groningen,2,3,-1,L
75720,13,HOL1,2014-03-29,Vitesse,Heerenveen,2,2,0,D
75721,13,HOL1,2014-03-30,Ajax Amsterdam,Twente Enschede,3,0,3,W
75722,13,HOL1,2014-03-30,Cambuur,AZ Alkmaar,0,0,0,D
75723,13,HOL1,2014-03-30,ADO Den Haag,Zwolle,1,1,0,D
75724,13,HOL1,2014-03-30,Feyenoord Rotterdam,Go Ahead Eagles,5,0,5,W
75725,13,HOL1,2014-03-30,Roda,Waalwijk,0,1,-1,L
75726,13,HOL1,2014-04-02,Go Ahead Eagles,NAC Breda,2,1,1,W
75727,13,HOL1,2014-04-02,Heracles,Feyenoord Rotterdam,1,2,-1,L
75728,13,HOL1,2014-04-02,Twente Enschede,ADO Den Haag,1,1,0,D
75729,13,HOL1,2014-04-02,Utrecht,Cambuur,1,0,1,W
75730,13,HOL1,2014-04-02,Waalwijk,Ajax Amsterdam,0,2,-2,L
75731,13,HOL1,2014-04-04,Zwolle,Groningen,0,1,-1,L
75732,13,HOL1,2014-04-05,Heerenveen,PSV Eindhoven,3,0,3,W
75733,13,HOL1,2014-04-05,Heracles,Go Ahead Eagles,1,2,-1,L
75734,13,HOL1,2014-04-05,NAC Breda,Twente Enschede,0,2,-2,L
75735,13,HOL1,2014-04-05,NEC Nijmegen,Cambuur,1,1,0,D
75736,13,HOL1,2014-04-06,ADO Den Haag,Utrecht,4,1,3,W
75737,13,HOL1,2014-04-06,Feyenoord Rotterdam,Waalwijk,2,0,2,W
75738,13,HOL1,2014-04-06,Roda,AZ Alkmaar,2,2,0,D
75739,13,HOL1,2014-04-06,Vitesse,Ajax Amsterdam,1,1,0,D
75740,13,HOL1,2014-04-11,Groningen,NAC Breda,2,1,1,W
75741,13,HOL1,2014-04-12,Cambuur,Vitesse,4,3,1,W
75742,13,HOL1,2014-04-12,Go Ahead Eagles,Heerenveen,0,2,-2,L
75743,13,HOL1,2014-04-12,Twente Enschede,Roda,3,0,3,W
75744,13,HOL1,2014-04-13,Ajax Amsterdam,ADO Den Haag,3,2,1,W
75745,13,HOL1,2014-04-13,AZ Alkmaar,NEC Nijmegen,1,1,0,D
75746,13,HOL1,2014-04-13,PSV Eindhoven,Feyenoord Rotterdam,0,2,-2,L
75747,13,HOL1,2014-04-13,Utrecht,Heracles,2,1,1,W
75748,13,HOL1,2014-04-13,Waalwijk,Zwolle,1,1,0,D
75749,13,HOL1,2014-04-27,ADO Den Haag,AZ Alkmaar,2,1,1,W
75750,13,HOL1,2014-04-27,Feyenoord Rotterdam,Cambuur,5,1,4,W
75751,13,HOL1,2014-04-27,Heerenveen,Utrecht,4,1,3,W
75752,13,HOL1,2014-04-27,Heracles,Ajax Amsterdam,1,1,0,D
75753,13,HOL1,2014-04-27,NAC Breda,Waalwijk,1,1,0,D
75754,13,HOL1,2014-04-27,NEC Nijmegen,Twente Enschede,2,5,-3,L
75755,13,HOL1,2014-04-27,Roda,Groningen,1,2,-1,L
75756,13,HOL1,2014-04-27,Vitesse,Go Ahead Eagles,2,2,0,D
75757,13,HOL1,2014-04-27,Zwolle,PSV Eindhoven,1,2,-1,L
75758,13,HOL1,2014-05-03,Ajax Amsterdam,NEC Nijmegen,2,2,0,D
75759,13,HOL1,2014-05-03,AZ Alkmaar,Feyenoord Rotterdam,1,1,0,D
75760,13,HOL1,2014-05-03,Cambuur,ADO Den Haag,1,2,-1,L
75761,13,HOL1,2014-05-03,Go Ahead Eagles,Roda,0,1,-1,L
75762,13,HOL1,2014-05-03,Groningen,Heracles,3,1,2,W
75763,13,HOL1,2014-05-03,PSV Eindhoven,NAC Breda,2,0,2,W
75764,13,HOL1,2014-05-03,Twente Enschede,Zwolle,2,2,0,D
75765,13,HOL1,2014-05-03,Utrecht,Vitesse,2,1,1,W
75766,13,HOL1,2014-05-03,Waalwijk,Heerenveen,0,3,-3,L
75767,14,HOL1,2014-08-08,Zwolle,Utrecht,2,0,2,W
75768,14,HOL1,2014-08-09,Cambuur,Twente Enschede,1,1,0,D
75769,14,HOL1,2014-08-09,Heerenveen,Dordrecht,1,2,-1,L
75770,14,HOL1,2014-08-09,Heracles,AZ Alkmaar,0,3,-3,L
75771,14,HOL1,2014-08-09,NAC Breda,Excelsior,1,1,0,D
75772,14,HOL1,2014-08-10,Ajax Amsterdam,Vitesse,4,1,3,W
75773,14,HOL1,2014-08-10,ADO Den Haag,Feyenoord Rotterdam,0,1,-1,L
75774,14,HOL1,2014-08-10,Go Ahead Eagles,Groningen,2,3,-1,L
75775,14,HOL1,2014-08-10,Willem II,PSV Eindhoven,1,3,-2,L
75776,14,HOL1,2014-08-15,Feyenoord Rotterdam,Heerenveen,1,1,0,D
75777,14,HOL1,2014-08-16,Dordrecht,Zwolle,1,2,-1,L
75778,14,HOL1,2014-08-16,PSV Eindhoven,NAC Breda,6,1,5,W
75779,14,HOL1,2014-08-16,Twente Enschede,ADO Den Haag,2,2,0,D
75780,14,HOL1,2014-08-16,Vitesse,Cambuur,2,2,0,D
75781,14,HOL1,2014-08-17,AZ Alkmaar,Ajax Amsterdam,1,3,-2,L
75782,14,HOL1,2014-08-17,Excelsior,Go Ahead Eagles,3,2,1,W
75783,14,HOL1,2014-08-17,Groningen,Heracles,3,1,2,W
75784,14,HOL1,2014-08-17,Utrecht,Willem II,2,1,1,W
75785,14,HOL1,2014-08-22,Heracles,Cambuur,0,1,-1,L
75786,14,HOL1,2014-08-23,Go Ahead Eagles,Dordrecht,0,0,0,D
75787,14,HOL1,2014-08-23,Heerenveen,Excelsior,2,0,2,W
75788,14,HOL1,2014-08-23,Willem II,AZ Alkmaar,3,0,3,W
75789,14,HOL1,2014-08-24,Ajax Amsterdam,PSV Eindhoven,1,3,-2,L
75790,14,HOL1,2014-08-24,ADO Den Haag,Groningen,3,0,3,W
75791,14,HOL1,2014-08-24,Feyenoord Rotterdam,Utrecht,1,2,-1,L
75792,14,HOL1,2014-08-24,NAC Breda,Twente Enschede,1,1,0,D
75793,14,HOL1,2014-08-24,Zwolle,Vitesse,2,1,1,W
75794,14,HOL1,2014-08-29,Go Ahead Eagles,Willem II,1,0,1,W
75795,14,HOL1,2014-08-30,Cambuur,ADO Den Haag,3,2,1,W
75796,14,HOL1,2014-08-30,Dordrecht,AZ Alkmaar,1,3,-2,L
75797,14,HOL1,2014-08-30,Excelsior,Heracles,3,1,2,W
75798,14,HOL1,2014-08-30,Heerenveen,Utrecht,3,1,2,W
75799,14,HOL1,2014-08-31,Groningen,Ajax Amsterdam,2,0,2,W
75800,14,HOL1,2014-08-31,NAC Breda,Zwolle,3,1,2,W
75801,14,HOL1,2014-08-31,PSV Eindhoven,Vitesse,2,0,2,W
75802,14,HOL1,2014-08-31,Twente Enschede,Feyenoord Rotterdam,0,0,0,D
75803,14,HOL1,2014-09-13,Ajax Amsterdam,Heracles,2,1,1,W
75804,14,HOL1,2014-09-13,AZ Alkmaar,Heerenveen,0,1,-1,L
75805,14,HOL1,2014-09-13,Feyenoord Rotterdam,Willem II,1,2,-1,L
75806,14,HOL1,2014-09-13,Twente Enschede,Go Ahead Eagles,2,1,1,W
75807,14,HOL1,2014-09-13,Zwolle,PSV Eindhoven,3,1,2,W
75808,14,HOL1,2014-09-14,Cambuur,Groningen,3,0,3,W
75809,14,HOL1,2014-09-14,Dordrecht,NAC Breda,0,1,-1,L
75810,14,HOL1,2014-09-14,Utrecht,ADO Den Haag,0,0,0,D
75811,14,HOL1,2014-09-14,Vitesse,Excelsior,3,1,2,W
75812,14,HOL1,2014-09-19,Willem II,NAC Breda,2,1,1,W
75813,14,HOL1,2014-09-20,ADO Den Haag,Go Ahead Eagles,1,1,0,D
75814,14,HOL1,2014-09-20,Excelsior,Dordrecht,1,1,0,D
75815,14,HOL1,2014-09-20,Vitesse,Heerenveen,1,1,0,D
75816,14,HOL1,2014-09-21,AZ Alkmaar,Zwolle,1,0,1,W
75817,14,HOL1,2014-09-21,Feyenoord Rotterdam,Ajax Amsterdam,0,1,-1,L
75818,14,HOL1,2014-09-21,Heracles,Twente Enschede,1,4,-3,L
75819,14,HOL1,2014-09-21,PSV Eindhoven,Cambuur,4,0,4,W
75820,14,HOL1,2014-09-21,Utrecht,Groningen,1,0,1,W
75821,14,HOL1,2014-09-27,ADO Den Haag,AZ Alkmaar,2,3,-1,L
75822,14,HOL1,2014-09-27,Dordrecht,Vitesse,2,6,-4,L
75823,14,HOL1,2014-09-27,Go Ahead Eagles,Feyenoord Rotterdam,0,4,-4,L
75824,14,HOL1,2014-09-27,NAC Breda,Ajax Amsterdam,2,5,-3,L
75825,14,HOL1,2014-09-27,Zwolle,Heracles,4,2,2,W
75826,14,HOL1,2014-09-28,Excelsior,Cambuur,1,1,0,D
75827,14,HOL1,2014-09-28,Groningen,Willem II,1,0,1,W
75828,14,HOL1,2014-09-28,Heerenveen,PSV Eindhoven,1,0,1,W
75829,14,HOL1,2014-09-28,Twente Enschede,Utrecht,3,1,2,W
75830,14,HOL1,2014-10-03,Vitesse,ADO Den Haag,6,1,5,W
75831,14,HOL1,2014-10-04,Cambuur,Dordrecht,4,1,3,W
75832,14,HOL1,2014-10-04,Heracles,NAC Breda,6,1,5,W
75833,14,HOL1,2014-10-04,Utrecht,Go Ahead Eagles,2,3,-1,L
75834,14,HOL1,2014-10-04,Willem II,Heerenveen,2,1,1,W
75835,14,HOL1,2014-10-05,Ajax Amsterdam,Zwolle,0,0,0,D
75836,14,HOL1,2014-10-05,AZ Alkmaar,Twente Enschede,2,2,0,D
75837,14,HOL1,2014-10-05,Feyenoord Rotterdam,Groningen,4,0,4,W
75838,14,HOL1,2014-10-05,PSV Eindhoven,Excelsior,3,0,3,W
75839,14,HOL1,2014-10-18,Feyenoord Rotterdam,Heracles,2,1,1,W
75840,14,HOL1,2014-10-18,NAC Breda,ADO Den Haag,1,1,0,D
75841,14,HOL1,2014-10-18,PSV Eindhoven,AZ Alkmaar,3,0,3,W
75842,14,HOL1,2014-10-18,Twente Enschede,Ajax Amsterdam,1,1,0,D
75843,14,HOL1,2014-10-18,Willem II,Vitesse,1,4,-3,L
75844,14,HOL1,2014-10-19,Dordrecht,Utrecht,1,3,-2,L
75845,14,HOL1,2014-10-19,Go Ahead Eagles,Zwolle,3,2,1,W
75846,14,HOL1,2014-10-19,Groningen,Excelsior,1,1,0,D
75847,14,HOL1,2014-10-19,Heerenveen,Cambuur,2,2,0,D
75848,14,HOL1,2014-10-24,ADO Den Haag,Dordrecht,2,0,2,W
75849,14,HOL1,2014-10-25,Ajax Amsterdam,Go Ahead Eagles,3,1,2,W
75850,14,HOL1,2014-10-25,AZ Alkmaar,Groningen,2,2,0,D
75851,14,HOL1,2014-10-25,Heracles,Willem II,1,3,-2,L
75852,14,HOL1,2014-10-25,Vitesse,NAC Breda,2,2,0,D
75853,14,HOL1,2014-10-26,Cambuur,Feyenoord Rotterdam,0,1,-1,L
75854,14,HOL1,2014-10-26,Excelsior,Twente Enschede,2,1,1,W
75855,14,HOL1,2014-10-26,Utrecht,PSV Eindhoven,1,5,-4,L
75856,14,HOL1,2014-10-26,Zwolle,Heerenveen,2,2,0,D
75857,14,HOL1,2014-11-01,Ajax Amsterdam,Dordrecht,4,0,4,W
75858,14,HOL1,2014-11-01,Feyenoord Rotterdam,Zwolle,2,0,2,W
75859,14,HOL1,2014-11-01,PSV Eindhoven,ADO Den Haag,1,0,1,W
75860,14,HOL1,2014-11-01,Twente Enschede,Heerenveen,2,0,2,W
75861,14,HOL1,2014-11-02,AZ Alkmaar,Excelsior,3,3,0,D
75862,14,HOL1,2014-11-02,Go Ahead Eagles,Heracles,1,3,-2,L
75863,14,HOL1,2014-11-02,Groningen,NAC Breda,1,0,1,W
75864,14,HOL1,2014-11-02,Utrecht,Vitesse,3,1,2,W
75865,14,HOL1,2014-11-02,Willem II,Cambuur,1,1,0,D
75866,14,HOL1,2014-11-07,Excelsior,Utrecht,2,2,0,D
75867,14,HOL1,2014-11-08,ADO Den Haag,Willem II,3,2,1,W
75868,14,HOL1,2014-11-08,Heerenveen,Go Ahead Eagles,2,2,0,D
75869,14,HOL1,2014-11-08,NAC Breda,AZ Alkmaar,0,1,-1,L
75870,14,HOL1,2014-11-08,Zwolle,Groningen,2,0,2,W
75871,14,HOL1,2014-11-09,Cambuur,Ajax Amsterdam,2,4,-2,L
75872,14,HOL1,2014-11-09,Dordrecht,Twente Enschede,0,4,-4,L
75873,14,HOL1,2014-11-09,Heracles,PSV Eindhoven,1,2,-1,L
75874,14,HOL1,2014-11-09,Vitesse,Feyenoord Rotterdam,0,0,0,D
75875,14,HOL1,2014-11-22,Ajax Amsterdam,Heerenveen,4,1,3,W
75876,14,HOL1,2014-11-22,AZ Alkmaar,Vitesse,1,0,1,W
75877,14,HOL1,2014-11-22,Feyenoord Rotterdam,Dordrecht,2,0,2,W
75878,14,HOL1,2014-11-22,Go Ahead Eagles,NAC Breda,2,0,2,W
75879,14,HOL1,2014-11-22,Willem II,Excelsior,1,1,0,D
75880,14,HOL1,2014-11-23,Groningen,PSV Eindhoven,1,1,0,D
75881,14,HOL1,2014-11-23,Heracles,ADO Den Haag,3,1,2,W
75882,14,HOL1,2014-11-23,Utrecht,Cambuur,1,3,-2,L
75883,14,HOL1,2014-11-23,Zwolle,Twente Enschede,1,2,-1,L
75884,14,HOL1,2014-11-28,Dordrecht,Willem II,0,4,-4,L
75885,14,HOL1,2014-11-29,Cambuur,AZ Alkmaar,0,2,-2,L
75886,14,HOL1,2014-11-29,Heerenveen,Heracles,0,1,-1,L
75887,14,HOL1,2014-11-29,NAC Breda,Utrecht,1,5,-4,L
75888,14,HOL1,2014-11-29,Vitesse,Go Ahead Eagles,2,2,0,D
75889,14,HOL1,2014-11-30,ADO Den Haag,Ajax Amsterdam,1,1,0,D
75890,14,HOL1,2014-11-30,Excelsior,Zwolle,0,5,-5,L
75891,14,HOL1,2014-11-30,Twente Enschede,Groningen,1,2,-1,L
75892,14,HOL1,2014-12-06,Ajax Amsterdam,Willem II,5,0,5,W
75893,14,HOL1,2014-12-06,AZ Alkmaar,Go Ahead Eagles,2,0,2,W
75894,14,HOL1,2014-12-06,Cambuur,NAC Breda,0,1,-1,L
75895,14,HOL1,2014-12-06,Dordrecht,PSV Eindhoven,1,3,-2,L
75896,14,HOL1,2014-12-06,Excelsior,Feyenoord Rotterdam,2,5,-3,L
75897,14,HOL1,2014-12-07,Groningen,Heerenveen,1,1,0,D
75898,14,HOL1,2014-12-07,Utrecht,Heracles,2,4,-2,L
75899,14,HOL1,2014-12-07,Vitesse,Twente Enschede,2,2,0,D
75900,14,HOL1,2014-12-07,Zwolle,ADO Den Haag,3,1,2,W
75901,14,HOL1,2014-12-12,Heracles,Dordrecht,1,1,0,D
75902,14,HOL1,2014-12-13,ADO Den Haag,Excelsior,2,2,0,D
75903,14,HOL1,2014-12-13,Go Ahead Eagles,Cambuur,1,2,-1,L
75904,14,HOL1,2014-12-13,NAC Breda,Heerenveen,0,2,-2,L
75905,14,HOL1,2014-12-13,Willem II,Zwolle,0,1,-1,L
75906,14,HOL1,2014-12-14,Ajax Amsterdam,Utrecht,3,1,2,W
75907,14,HOL1,2014-12-14,Feyenoord Rotterdam,AZ Alkmaar,2,2,0,D
75908,14,HOL1,2014-12-14,Groningen,Vitesse,1,1,0,D
75909,14,HOL1,2014-12-14,PSV Eindhoven,Twente Enschede,2,0,2,W
75910,14,HOL1,2014-12-17,PSV Eindhoven,Feyenoord Rotterdam,4,3,1,W
75911,14,HOL1,2014-12-19,Heerenveen,ADO Den Haag,0,0,0,D
75912,14,HOL1,2014-12-20,AZ Alkmaar,Utrecht,0,3,-3,L
75913,14,HOL1,2014-12-20,Cambuur,Zwolle,2,1,1,W
75914,14,HOL1,2014-12-20,Dordrecht,Groningen,1,1,0,D
75915,14,HOL1,2014-12-20,PSV Eindhoven,Go Ahead Eagles,5,0,5,W
75916,14,HOL1,2014-12-21,Excelsior,Ajax Amsterdam,0,2,-2,L
75917,14,HOL1,2014-12-21,NAC Breda,Feyenoord Rotterdam,0,1,-1,L
75918,14,HOL1,2014-12-21,Twente Enschede,Willem II,3,2,1,W
75919,14,HOL1,2014-12-21,Vitesse,Heracles,3,0,3,W
75920,14,HOL1,2015-01-16,Ajax Amsterdam,Groningen,2,0,2,W
75921,14,HOL1,2015-01-17,AZ Alkmaar,Dordrecht,2,0,2,W
75922,14,HOL1,2015-01-17,ADO Den Haag,Cambuur,2,2,0,D
75923,14,HOL1,2015-01-17,Vitesse,PSV Eindhoven,0,1,-1,L
75924,14,HOL1,2015-01-17,Zwolle,NAC Breda,4,1,3,W
75925,14,HOL1,2015-01-18,Feyenoord Rotterdam,Twente Enschede,3,1,2,W
75926,14,HOL1,2015-01-18,Heracles,Excelsior,0,3,-3,L
75927,14,HOL1,2015-01-18,Utrecht,Heerenveen,1,2,-1,L
75928,14,HOL1,2015-01-18,Willem II,Go Ahead Eagles,1,0,1,W
75929,14,HOL1,2015-01-23,Twente Enschede,Heracles,2,0,2,W
75930,14,HOL1,2015-01-24,Cambuur,PSV Eindhoven,1,2,-1,L
75931,14,HOL1,2015-01-24,Dordrecht,Excelsior,1,0,1,W
75932,14,HOL1,2015-01-24,Heerenveen,Vitesse,4,1,3,W
75933,14,HOL1,2015-01-24,Zwolle,AZ Alkmaar,1,1,0,D
75934,14,HOL1,2015-01-25,Ajax Amsterdam,Feyenoord Rotterdam,0,0,0,D
75935,14,HOL1,2015-01-25,Go Ahead Eagles,ADO Den Haag,1,0,1,W
75936,14,HOL1,2015-01-25,Groningen,Utrecht,2,2,0,D
75937,14,HOL1,2015-01-25,NAC Breda,Willem II,0,0,0,D
75938,14,HOL1,2015-01-30,Dordrecht,Heerenveen,0,0,0,D
75939,14,HOL1,2015-01-31,Excelsior,NAC Breda,0,0,0,D
75940,14,HOL1,2015-01-31,Groningen,Go Ahead Eagles,2,0,2,W
75941,14,HOL1,2015-01-31,PSV Eindhoven,Willem II,2,1,1,W
75942,14,HOL1,2015-01-31,Twente Enschede,Cambuur,2,1,1,W
75943,14,HOL1,2015-02-01,AZ Alkmaar,Heracles,3,1,2,W
75944,14,HOL1,2015-02-01,Feyenoord Rotterdam,ADO Den Haag,2,1,1,W
75945,14,HOL1,2015-02-01,Utrecht,Zwolle,0,2,-2,L
75946,14,HOL1,2015-02-01,Vitesse,Ajax Amsterdam,1,0,1,W
75947,14,HOL1,2015-02-03,Go Ahead Eagles,Excelsior,0,0,0,D
75948,14,HOL1,2015-02-03,NAC Breda,PSV Eindhoven,0,2,-2,L
75949,14,HOL1,2015-02-04,Cambuur,Vitesse,0,2,-2,L
75950,14,HOL1,2015-02-04,ADO Den Haag,Twente Enschede,2,0,2,W
75951,14,HOL1,2015-02-04,Heerenveen,Feyenoord Rotterdam,3,1,2,W
75952,14,HOL1,2015-02-04,Willem II,Utrecht,1,0,1,W
75953,14,HOL1,2015-02-04,Zwolle,Dordrecht,4,0,4,W
75954,14,HOL1,2015-02-05,Ajax Amsterdam,AZ Alkmaar,0,1,-1,L
75955,14,HOL1,2015-02-05,Heracles,Groningen,2,2,0,D
75956,14,HOL1,2015-02-07,Dordrecht,ADO Den Haag,0,0,0,D
75957,14,HOL1,2015-02-07,Heerenveen,Zwolle,4,0,4,W
75958,14,HOL1,2015-02-07,NAC Breda,Vitesse,0,1,-1,L
75959,14,HOL1,2015-02-07,PSV Eindhoven,Utrecht,3,1,2,W
75960,14,HOL1,2015-02-07,Twente Enschede,Excelsior,1,3,-2,L
75961,14,HOL1,2015-02-08,Feyenoord Rotterdam,Cambuur,2,1,1,W
75962,14,HOL1,2015-02-08,Go Ahead Eagles,Ajax Amsterdam,1,2,-1,L
75963,14,HOL1,2015-02-08,Groningen,AZ Alkmaar,2,4,-2,L
75964,14,HOL1,2015-02-08,Willem II,Heracles,3,0,3,W
75965,14,HOL1,2015-02-13,AZ Alkmaar,PSV Eindhoven,2,4,-2,L
75966,14,HOL1,2015-02-14,ADO Den Haag,NAC Breda,3,2,1,W
75967,14,HOL1,2015-02-14,Excelsior,Groningen,1,1,0,D
75968,14,HOL1,2015-02-14,Heracles,Feyenoord Rotterdam,2,0,2,W
75969,14,HOL1,2015-02-14,Vitesse,Willem II,2,0,2,W
75970,14,HOL1,2015-02-15,Ajax Amsterdam,Twente Enschede,4,2,2,W
75971,14,HOL1,2015-02-15,Cambuur,Heerenveen,2,1,1,W
75972,14,HOL1,2015-02-15,Utrecht,Dordrecht,6,1,5,W
75973,14,HOL1,2015-02-15,Zwolle,Go Ahead Eagles,0,1,-1,L
75974,14,HOL1,2015-02-20,NAC Breda,Cambuur,2,1,1,W
75975,14,HOL1,2015-02-21,ADO Den Haag,Zwolle,3,2,1,W
75976,14,HOL1,2015-02-21,Go Ahead Eagles,AZ Alkmaar,0,2,-2,L
75977,14,HOL1,2015-02-21,Heracles,Utrecht,1,1,0,D
75978,14,HOL1,2015-02-22,Feyenoord Rotterdam,Excelsior,3,2,1,W
75979,14,HOL1,2015-02-22,Heerenveen,Groningen,3,1,2,W
75980,14,HOL1,2015-02-22,PSV Eindhoven,Dordrecht,3,0,3,W
75981,14,HOL1,2015-02-22,Twente Enschede,Vitesse,1,2,-1,L
75982,14,HOL1,2015-02-22,Willem II,Ajax Amsterdam,1,1,0,D
75983,14,HOL1,2015-02-27,Dordrecht,Go Ahead Eagles,2,1,1,W
75984,14,HOL1,2015-02-28,AZ Alkmaar,Willem II,2,0,2,W
75985,14,HOL1,2015-02-28,Cambuur,Heracles,1,0,1,W
75986,14,HOL1,2015-02-28,Twente Enschede,NAC Breda,1,1,0,D
75987,14,HOL1,2015-02-28,Vitesse,Zwolle,2,1,1,W
75988,14,HOL1,2015-03-01,Excelsior,Heerenveen,3,0,3,W
75989,14,HOL1,2015-03-01,Groningen,ADO Den Haag,1,1,0,D
75990,14,HOL1,2015-03-01,PSV Eindhoven,Ajax Amsterdam,1,3,-2,L
75991,14,HOL1,2015-03-01,Utrecht,Feyenoord Rotterdam,0,0,0,D
75992,14,HOL1,2015-03-06,Willem II,Twente Enschede,2,2,0,D
75993,14,HOL1,2015-03-07,ADO Den Haag,Heerenveen,0,1,-1,L
75994,14,HOL1,2015-03-07,Go Ahead Eagles,PSV Eindhoven,0,3,-3,L
75995,14,HOL1,2015-03-07,Heracles,Vitesse,1,1,0,D
75996,14,HOL1,2015-03-07,Zwolle,Cambuur,6,1,5,W
75997,14,HOL1,2015-03-08,Ajax Amsterdam,Excelsior,1,0,1,W
75998,14,HOL1,2015-03-08,Feyenoord Rotterdam,NAC Breda,3,0,3,W
75999,14,HOL1,2015-03-08,Groningen,Dordrecht,2,0,2,W
76000,14,HOL1,2015-03-08,Utrecht,AZ Alkmaar,6,2,4,W
76001,14,HOL1,2015-03-13,Vitesse,AZ Alkmaar,3,1,2,W
76002,14,HOL1,2015-03-14,Cambuur,Utrecht,3,1,2,W
76003,14,HOL1,2015-03-14,Excelsior,Willem II,2,3,-1,L
76004,14,HOL1,2015-03-14,NAC Breda,Go Ahead Eagles,1,0,1,W
76005,14,HOL1,2015-03-14,Twente Enschede,Zwolle,2,0,2,W
76006,14,HOL1,2015-03-15,ADO Den Haag,Heracles,1,3,-2,L
76007,14,HOL1,2015-03-15,Dordrecht,Feyenoord Rotterdam,1,2,-1,L
76008,14,HOL1,2015-03-15,Heerenveen,Ajax Amsterdam,1,4,-3,L
76009,14,HOL1,2015-03-15,PSV Eindhoven,Groningen,2,1,1,W
76010,14,HOL1,2015-03-20,Utrecht,NAC Breda,3,4,-1,L
76011,14,HOL1,2015-03-21,AZ Alkmaar,Cambuur,2,1,1,W
76012,14,HOL1,2015-03-21,Go Ahead Eagles,Vitesse,0,2,-2,L
76013,14,HOL1,2015-03-21,Heracles,Heerenveen,1,4,-3,L
76014,14,HOL1,2015-03-21,Willem II,Dordrecht,2,1,1,W
76015,14,HOL1,2015-03-22,Ajax Amsterdam,ADO Den Haag,1,0,1,W
76016,14,HOL1,2015-03-22,Feyenoord Rotterdam,PSV Eindhoven,2,1,1,W
76017,14,HOL1,2015-03-22,Groningen,Twente Enschede,2,2,0,D
76018,14,HOL1,2015-03-22,Zwolle,Excelsior,1,1,0,D
76019,14,HOL1,2015-04-04,Dordrecht,Heracles,2,3,-1,L
76020,14,HOL1,2015-04-04,Heerenveen,NAC Breda,0,0,0,D
76021,14,HOL1,2015-04-04,Twente Enschede,PSV Eindhoven,0,5,-5,L
76022,14,HOL1,2015-04-04,Vitesse,Groningen,1,1,0,D
76023,14,HOL1,2015-04-04,Zwolle,Willem II,1,0,1,W
76024,14,HOL1,2015-04-05,AZ Alkmaar,Feyenoord Rotterdam,1,4,-3,L
76025,14,HOL1,2015-04-05,Cambuur,Go Ahead Eagles,1,0,1,W
76026,14,HOL1,2015-04-05,Excelsior,ADO Den Haag,2,3,-1,L
76027,14,HOL1,2015-04-05,Utrecht,Ajax Amsterdam,1,1,0,D
76028,14,HOL1,2015-04-10,PSV Eindhoven,Zwolle,3,1,2,W
76029,14,HOL1,2015-04-11,Excelsior,Vitesse,1,3,-2,L
76030,14,HOL1,2015-04-11,Heerenveen,AZ Alkmaar,5,2,3,W
76031,14,HOL1,2015-04-11,Heracles,Ajax Amsterdam,0,2,-2,L
76032,14,HOL1,2015-04-11,NAC Breda,Dordrecht,2,2,0,D
76033,14,HOL1,2015-04-12,ADO Den Haag,Utrecht,2,0,2,W
76034,14,HOL1,2015-04-12,Go Ahead Eagles,Twente Enschede,1,3,-2,L
76035,14,HOL1,2015-04-12,Groningen,Cambuur,3,2,1,W
76036,14,HOL1,2015-04-12,Willem II,Feyenoord Rotterdam,2,2,0,D
76037,14,HOL1,2015-04-17,Cambuur,Excelsior,1,1,0,D
76038,14,HOL1,2015-04-18,AZ Alkmaar,ADO Den Haag,3,1,2,W
76039,14,HOL1,2015-04-18,PSV Eindhoven,Heerenveen,4,1,3,W
76040,14,HOL1,2015-04-18,Vitesse,Dordrecht,3,0,3,W
76041,14,HOL1,2015-04-18,Willem II,Groningen,1,4,-3,L
76042,14,HOL1,2015-04-19,Ajax Amsterdam,NAC Breda,0,0,0,D
76043,14,HOL1,2015-04-19,Feyenoord Rotterdam,Go Ahead Eagles,0,1,-1,L
76044,14,HOL1,2015-04-19,Heracles,Zwolle,2,0,2,W
76045,14,HOL1,2015-04-19,Utrecht,Twente Enschede,1,0,1,W
76046,14,HOL1,2015-04-24,ADO Den Haag,Vitesse,1,0,1,W
76047,14,HOL1,2015-04-25,Excelsior,PSV Eindhoven,2,3,-1,L
76048,14,HOL1,2015-04-25,Go Ahead Eagles,Utrecht,0,2,-2,L
76049,14,HOL1,2015-04-25,Heerenveen,Willem II,1,1,0,D
76050,14,HOL1,2015-04-25,NAC Breda,Heracles,1,3,-2,L
76051,14,HOL1,2015-04-26,Dordrecht,Cambuur,0,0,0,D
76052,14,HOL1,2015-04-26,Groningen,Feyenoord Rotterdam,1,1,0,D
76053,14,HOL1,2015-04-26,Twente Enschede,AZ Alkmaar,0,2,-2,L
76054,14,HOL1,2015-04-26,Zwolle,Ajax Amsterdam,1,1,0,D
76055,14,HOL1,2015-05-10,Ajax Amsterdam,Cambuur,3,0,3,W
76056,14,HOL1,2015-05-10,AZ Alkmaar,NAC Breda,3,2,1,W
76057,14,HOL1,2015-05-10,Go Ahead Eagles,Heerenveen,1,1,0,D
76058,14,HOL1,2015-05-10,Groningen,Zwolle,0,1,-1,L
76059,14,HOL1,2015-05-10,PSV Eindhoven,Heracles,2,0,2,W
76060,14,HOL1,2015-05-10,Twente Enschede,Dordrecht,3,0,3,W
76061,14,HOL1,2015-05-10,Utrecht,Excelsior,2,2,0,D
76062,14,HOL1,2015-05-10,Willem II,ADO Den Haag,1,0,1,W
76063,14,HOL1,2015-05-11,Feyenoord Rotterdam,Vitesse,1,4,-3,L
76064,14,HOL1,2015-05-17,Cambuur,Willem II,1,2,-1,L
76065,14,HOL1,2015-05-17,ADO Den Haag,PSV Eindhoven,2,3,-1,L
76066,14,HOL1,2015-05-17,Dordrecht,Ajax Amsterdam,2,1,1,W
76067,14,HOL1,2015-05-17,Excelsior,AZ Alkmaar,1,4,-3,L
76068,14,HOL1,2015-05-17,Heerenveen,Twente Enschede,1,3,-2,L
76069,14,HOL1,2015-05-17,Heracles,Go Ahead Eagles,1,0,1,W
76070,14,HOL1,2015-05-17,NAC Breda,Groningen,4,5,-1,L
76071,14,HOL1,2015-05-17,Vitesse,Utrecht,3,3,0,D
76072,14,HOL1,2015-05-17,Zwolle,Feyenoord Rotterdam,3,0,3,W
76073,15,HOL1,2015-08-08,Feyenoord Rotterdam,Utrecht,3,2,1,W
76074,15,HOL1,2015-08-08,Roda,Heracles,3,1,2,W
76075,15,HOL1,2015-08-09,AZ Alkmaar,Ajax Amsterdam,0,3,-3,L
76076,15,HOL1,2015-08-09,Willem II,Vitesse,1,1,0,D
76077,15,HOL1,2015-08-11,ADO Den Haag,PSV Eindhoven,2,2,0,D
76078,15,HOL1,2015-08-11,Heerenveen,De Graafschap,3,1,2,W
76079,15,HOL1,2015-08-12,Groningen,Twente Enschede,1,1,0,D
76080,15,HOL1,2015-08-12,NEC Nijmegen,Excelsior,1,0,1,W
76081,15,HOL1,2015-08-12,Zwolle,Cambuur,2,2,0,D
76082,15,HOL1,2015-08-14,Vitesse,Roda,3,0,3,W
76083,15,HOL1,2015-08-15,Ajax Amsterdam,Willem II,3,0,3,W
76084,15,HOL1,2015-08-15,Excelsior,AZ Alkmaar,2,2,0,D
76085,15,HOL1,2015-08-15,De Graafschap,Zwolle,0,3,-3,L
76086,15,HOL1,2015-08-15,Twente Enschede,ADO Den Haag,1,4,-3,L
76087,15,HOL1,2015-08-16,Cambuur,Feyenoord Rotterdam,0,2,-2,L
76088,15,HOL1,2015-08-16,Heracles,NEC Nijmegen,3,0,3,W
76089,15,HOL1,2015-08-16,PSV Eindhoven,Groningen,2,0,2,W
76090,15,HOL1,2015-08-16,Utrecht,Heerenveen,1,1,0,D
76091,15,HOL1,2015-08-21,Groningen,Excelsior,2,0,2,W
76092,15,HOL1,2015-08-22,Cambuur,Heracles,1,6,-5,L
76093,15,HOL1,2015-08-22,Heerenveen,PSV Eindhoven,1,1,0,D
76094,15,HOL1,2015-08-22,Roda,De Graafschap,1,0,1,W
76095,15,HOL1,2015-08-23,AZ Alkmaar,Willem II,0,0,0,D
76096,15,HOL1,2015-08-23,ADO Den Haag,Utrecht,1,1,0,D
76097,15,HOL1,2015-08-23,Feyenoord Rotterdam,Vitesse,2,0,2,W
76098,15,HOL1,2015-08-23,NEC Nijmegen,Ajax Amsterdam,0,2,-2,L
76099,15,HOL1,2015-08-23,Zwolle,Twente Enschede,2,1,1,W
76100,15,HOL1,2015-08-28,Willem II,NEC Nijmegen,0,1,-1,L
76101,15,HOL1,2015-08-29,Excelsior,De Graafschap,3,0,3,W
76102,15,HOL1,2015-08-29,Heerenveen,Zwolle,1,1,0,D
76103,15,HOL1,2015-08-29,Heracles,Twente Enschede,2,0,2,W
76104,15,HOL1,2015-08-29,Utrecht,Groningen,2,0,2,W
76105,15,HOL1,2015-08-30,Ajax Amsterdam,ADO Den Haag,4,0,4,W
76106,15,HOL1,2015-08-30,AZ Alkmaar,Roda,0,1,-1,L
76107,15,HOL1,2015-08-30,PSV Eindhoven,Feyenoord Rotterdam,3,1,2,W
76108,15,HOL1,2015-08-30,Vitesse,Cambuur,4,1,3,W
76109,15,HOL1,2015-09-12,Cambuur,PSV Eindhoven,0,6,-6,L
76110,15,HOL1,2015-09-12,De Graafschap,AZ Alkmaar,1,3,-2,L
76111,15,HOL1,2015-09-12,Roda,NEC Nijmegen,0,0,0,D
76112,15,HOL1,2015-09-12,Twente Enschede,Ajax Amsterdam,2,2,0,D
76113,15,HOL1,2015-09-12,Zwolle,Excelsior,3,0,3,W
76114,15,HOL1,2015-09-13,ADO Den Haag,Heracles,0,1,-1,L
76115,15,HOL1,2015-09-13,Feyenoord Rotterdam,Willem II,1,0,1,W
76116,15,HOL1,2015-09-13,Groningen,Heerenveen,3,1,2,W
76117,15,HOL1,2015-09-13,Utrecht,Vitesse,2,1,1,W
76118,15,HOL1,2015-09-18,NEC Nijmegen,Heerenveen,2,0,2,W
76119,15,HOL1,2015-09-19,Cambuur,Twente Enschede,0,0,0,D
76120,15,HOL1,2015-09-19,Heracles,PSV Eindhoven,2,1,1,W
76121,15,HOL1,2015-09-19,Willem II,Utrecht,3,1,2,W
76122,15,HOL1,2015-09-19,Zwolle,ADO Den Haag,2,1,1,W
76123,15,HOL1,2015-09-20,Excelsior,Ajax Amsterdam,0,2,-2,L
76124,15,HOL1,2015-09-20,Groningen,AZ Alkmaar,2,0,2,W
76125,15,HOL1,2015-09-20,Roda,Feyenoord Rotterdam,1,1,0,D
76126,15,HOL1,2015-09-20,Vitesse,De Graafschap,3,0,3,W
76127,15,HOL1,2015-09-26,Ajax Amsterdam,Groningen,2,0,2,W
76128,15,HOL1,2015-09-26,AZ Alkmaar,Heracles,3,1,2,W
76129,15,HOL1,2015-09-26,Heerenveen,Vitesse,0,0,0,D
76130,15,HOL1,2015-09-26,PSV Eindhoven,NEC Nijmegen,2,1,1,W
76131,15,HOL1,2015-09-26,Utrecht,Cambuur,3,3,0,D
76132,15,HOL1,2015-09-27,ADO Den Haag,Excelsior,3,3,0,D
76133,15,HOL1,2015-09-27,Feyenoord Rotterdam,Zwolle,2,0,2,W
76134,15,HOL1,2015-09-27,De Graafschap,Willem II,2,2,0,D
76135,15,HOL1,2015-09-27,Twente Enschede,Roda,2,1,1,W
76136,15,HOL1,2015-10-02,Heracles,Heerenveen,2,0,2,W
76137,15,HOL1,2015-10-03,Excelsior,Utrecht,1,0,1,W
76138,15,HOL1,2015-10-03,NEC Nijmegen,ADO Den Haag,4,1,3,W
76139,15,HOL1,2015-10-03,Roda,Cambuur,1,1,0,D
76140,15,HOL1,2015-10-03,Willem II,Zwolle,0,1,-1,L
76141,15,HOL1,2015-10-04,Ajax Amsterdam,PSV Eindhoven,1,2,-1,L
76142,15,HOL1,2015-10-04,AZ Alkmaar,Twente Enschede,3,1,2,W
76143,15,HOL1,2015-10-04,De Graafschap,Feyenoord Rotterdam,1,2,-1,L
76144,15,HOL1,2015-10-04,Vitesse,Groningen,5,0,5,W
76145,15,HOL1,2015-10-17,Cambuur,AZ Alkmaar,1,1,0,D
76146,15,HOL1,2015-10-17,Groningen,Willem II,2,1,1,W
76147,15,HOL1,2015-10-17,Heracles,Ajax Amsterdam,0,2,-2,L
76148,15,HOL1,2015-10-17,PSV Eindhoven,Excelsior,1,1,0,D
76149,15,HOL1,2015-10-17,Utrecht,Roda,1,1,0,D
76150,15,HOL1,2015-10-18,ADO Den Haag,De Graafschap,1,1,0,D
76151,15,HOL1,2015-10-18,Heerenveen,Feyenoord Rotterdam,2,5,-3,L
76152,15,HOL1,2015-10-18,Twente Enschede,NEC Nijmegen,1,0,1,W
76153,15,HOL1,2015-10-18,Zwolle,Vitesse,1,5,-4,L
76154,15,HOL1,2015-10-23,Zwolle,Utrecht,1,2,-1,L
76155,15,HOL1,2015-10-24,De Graafschap,Heracles,0,1,-1,L
76156,15,HOL1,2015-10-24,Roda,Excelsior,1,2,-1,L
76157,15,HOL1,2015-10-24,Twente Enschede,PSV Eindhoven,1,3,-2,L
76158,15,HOL1,2015-10-24,Willem II,Heerenveen,2,2,0,D
76159,15,HOL1,2015-10-25,Cambuur,ADO Den Haag,1,1,0,D
76160,15,HOL1,2015-10-25,Feyenoord Rotterdam,AZ Alkmaar,3,1,2,W
76161,15,HOL1,2015-10-25,NEC Nijmegen,Groningen,1,1,0,D
76162,15,HOL1,2015-10-25,Vitesse,Ajax Amsterdam,1,3,-2,L
76163,15,HOL1,2015-10-30,Heracles,Willem II,2,1,1,W
76164,15,HOL1,2015-10-31,Ajax Amsterdam,Roda,6,0,6,W
76165,15,HOL1,2015-10-31,Excelsior,Vitesse,0,3,-3,L
76166,15,HOL1,2015-10-31,De Graafschap,PSV Eindhoven,3,6,-3,L
76167,15,HOL1,2015-10-31,Groningen,Zwolle,2,0,2,W
76168,15,HOL1,2015-11-01,AZ Alkmaar,NEC Nijmegen,2,4,-2,L
76169,15,HOL1,2015-11-01,ADO Den Haag,Feyenoord Rotterdam,1,0,1,W
76170,15,HOL1,2015-11-01,Heerenveen,Cambuur,2,0,2,W
76171,15,HOL1,2015-11-01,Utrecht,Twente Enschede,4,2,2,W
76172,15,HOL1,2015-11-06,Roda,ADO Den Haag,1,1,0,D
76173,15,HOL1,2015-11-07,NEC Nijmegen,De Graafschap,2,0,2,W
76174,15,HOL1,2015-11-07,Twente Enschede,Heerenveen,1,4,-3,L
76175,15,HOL1,2015-11-07,Willem II,Excelsior,2,3,-1,L
76176,15,HOL1,2015-11-07,Zwolle,Heracles,1,1,0,D
76177,15,HOL1,2015-11-08,Cambuur,Groningen,2,2,0,D
76178,15,HOL1,2015-11-08,Feyenoord Rotterdam,Ajax Amsterdam,1,1,0,D
76179,15,HOL1,2015-11-08,PSV Eindhoven,Utrecht,3,1,2,W
76180,15,HOL1,2015-11-08,Vitesse,AZ Alkmaar,0,2,-2,L
76181,15,HOL1,2015-11-21,Ajax Amsterdam,Cambuur,5,1,4,W
76182,15,HOL1,2015-11-21,AZ Alkmaar,Heerenveen,3,1,2,W
76183,15,HOL1,2015-11-21,De Graafschap,Groningen,1,2,-1,L
76184,15,HOL1,2015-11-21,Roda,Zwolle,0,5,-5,L
76185,15,HOL1,2015-11-21,Willem II,PSV Eindhoven,2,2,0,D
76186,15,HOL1,2015-11-22,ADO Den Haag,Vitesse,2,2,0,D
76187,15,HOL1,2015-11-22,Feyenoord Rotterdam,Twente Enschede,5,0,5,W
76188,15,HOL1,2015-11-22,Heracles,Excelsior,0,0,0,D
76189,15,HOL1,2015-11-22,NEC Nijmegen,Utrecht,1,0,1,W
76190,15,HOL1,2015-11-27,Cambuur,De Graafschap,2,3,-1,L
76191,15,HOL1,2015-11-28,Excelsior,Feyenoord Rotterdam,2,4,-2,L
76192,15,HOL1,2015-11-28,Heerenveen,Roda,3,0,3,W
76193,15,HOL1,2015-11-28,Twente Enschede,Willem II,1,3,-2,L
76194,15,HOL1,2015-11-29,Groningen,ADO Den Haag,2,1,1,W
76195,15,HOL1,2015-11-29,PSV Eindhoven,AZ Alkmaar,3,0,3,W
76196,15,HOL1,2015-11-29,Utrecht,Heracles,4,2,2,W
76197,15,HOL1,2015-11-29,Vitesse,NEC Nijmegen,1,0,1,W
76198,15,HOL1,2015-11-29,Zwolle,Ajax Amsterdam,0,2,-2,L
76199,15,HOL1,2015-12-04,AZ Alkmaar,ADO Den Haag,0,1,-1,L
76200,15,HOL1,2015-12-05,Ajax Amsterdam,Heerenveen,5,2,3,W
76201,15,HOL1,2015-12-05,Excelsior,Twente Enschede,1,1,0,D
76202,15,HOL1,2015-12-05,De Graafschap,Utrecht,0,1,-1,L
76203,15,HOL1,2015-12-05,Vitesse,PSV Eindhoven,0,1,-1,L
76204,15,HOL1,2015-12-06,Feyenoord Rotterdam,Heracles,3,0,3,W
76205,15,HOL1,2015-12-06,NEC Nijmegen,Zwolle,2,2,0,D
76206,15,HOL1,2015-12-06,Roda,Groningen,0,0,0,D
76207,15,HOL1,2015-12-06,Willem II,Cambuur,3,0,3,W
76208,15,HOL1,2015-12-11,Heerenveen,Excelsior,2,1,1,W
76209,15,HOL1,2015-12-12,Cambuur,NEC Nijmegen,3,1,2,W
76210,15,HOL1,2015-12-12,ADO Den Haag,Willem II,1,1,0,D
76211,15,HOL1,2015-12-12,PSV Eindhoven,Roda,1,1,0,D
76212,15,HOL1,2015-12-12,Twente Enschede,De Graafschap,2,1,1,W
76213,15,HOL1,2015-12-13,Groningen,Feyenoord Rotterdam,1,1,0,D
76214,15,HOL1,2015-12-13,Heracles,Vitesse,1,1,0,D
76215,15,HOL1,2015-12-13,Utrecht,Ajax Amsterdam,1,0,1,W
76216,15,HOL1,2015-12-13,Zwolle,AZ Alkmaar,2,1,1,W
76217,15,HOL1,2015-12-18,Vitesse,Twente Enschede,5,1,4,W
76218,15,HOL1,2015-12-19,AZ Alkmaar,Utrecht,2,2,0,D
76219,15,HOL1,2015-12-19,Heracles,Groningen,2,1,1,W
76220,15,HOL1,2015-12-19,PSV Eindhoven,Zwolle,3,2,1,W
76221,15,HOL1,2015-12-20,Ajax Amsterdam,De Graafschap,2,1,1,W
76222,15,HOL1,2015-12-20,Excelsior,Cambuur,1,4,-3,L
76223,15,HOL1,2015-12-20,Heerenveen,ADO Den Haag,0,4,-4,L
76224,15,HOL1,2015-12-20,NEC Nijmegen,Feyenoord Rotterdam,3,1,2,W
76225,15,HOL1,2015-12-20,Willem II,Roda,3,2,1,W
76226,15,HOL1,2016-01-15,Twente Enschede,Heracles,4,0,4,W
76227,15,HOL1,2016-01-16,Cambuur,Vitesse,0,2,-2,L
76228,15,HOL1,2016-01-16,De Graafschap,Excelsior,2,0,2,W
76229,15,HOL1,2016-01-16,Roda,AZ Alkmaar,0,1,-1,L
76230,15,HOL1,2016-01-16,Zwolle,Heerenveen,5,2,3,W
76231,15,HOL1,2016-01-17,ADO Den Haag,Ajax Amsterdam,0,1,-1,L
76232,15,HOL1,2016-01-17,Feyenoord Rotterdam,PSV Eindhoven,0,2,-2,L
76233,15,HOL1,2016-01-17,Groningen,Utrecht,1,4,-3,L
76234,15,HOL1,2016-01-17,NEC Nijmegen,Willem II,1,0,1,W
76235,15,HOL1,2016-01-22,Groningen,NEC Nijmegen,0,0,0,D
76236,15,HOL1,2016-01-23,Ajax Amsterdam,Vitesse,1,0,1,W
76237,15,HOL1,2016-01-23,Excelsior,Roda,0,1,-1,L
76238,15,HOL1,2016-01-23,Heerenveen,Willem II,3,1,2,W
76239,15,HOL1,2016-01-23,Heracles,De Graafschap,2,1,1,W
76240,15,HOL1,2016-01-24,AZ Alkmaar,Feyenoord Rotterdam,4,2,2,W
76241,15,HOL1,2016-01-24,ADO Den Haag,Cambuur,2,1,1,W
76242,15,HOL1,2016-01-24,PSV Eindhoven,Twente Enschede,4,2,2,W
76243,15,HOL1,2016-01-24,Utrecht,Zwolle,1,0,1,W
76244,15,HOL1,2016-01-26,Ajax Amsterdam,Heracles,0,0,0,D
76245,15,HOL1,2016-01-26,Willem II,Groningen,1,1,0,D
76246,15,HOL1,2016-01-27,AZ Alkmaar,Cambuur,3,1,2,W
76247,15,HOL1,2016-01-27,Excelsior,PSV Eindhoven,1,3,-2,L
76248,15,HOL1,2016-01-27,De Graafschap,ADO Den Haag,3,1,2,W
76249,15,HOL1,2016-01-27,NEC Nijmegen,Twente Enschede,2,0,2,W
76250,15,HOL1,2016-01-27,Vitesse,Zwolle,1,1,0,D
76251,15,HOL1,2016-01-28,Feyenoord Rotterdam,Heerenveen,1,2,-1,L
76252,15,HOL1,2016-01-28,Roda,Utrecht,1,0,1,W
76253,15,HOL1,2016-01-29,Willem II,Heracles,0,0,0,D
76254,15,HOL1,2016-01-30,NEC Nijmegen,AZ Alkmaar,0,3,-3,L
76255,15,HOL1,2016-01-30,PSV Eindhoven,De Graafschap,4,2,2,W
76256,15,HOL1,2016-01-30,Vitesse,Excelsior,0,0,0,D
76257,15,HOL1,2016-01-30,Zwolle,Groningen,1,3,-2,L
76258,15,HOL1,2016-01-31,Cambuur,Heerenveen,0,1,-1,L
76259,15,HOL1,2016-01-31,Feyenoord Rotterdam,ADO Den Haag,0,2,-2,L
76260,15,HOL1,2016-01-31,Roda,Ajax Amsterdam,2,2,0,D
76261,15,HOL1,2016-01-31,Twente Enschede,Utrecht,3,1,2,W
76262,15,HOL1,2016-02-05,Excelsior,Willem II,0,0,0,D
76263,15,HOL1,2016-02-06,AZ Alkmaar,Vitesse,1,0,1,W
76264,15,HOL1,2016-02-06,ADO Den Haag,Roda,2,2,0,D
76265,15,HOL1,2016-02-06,Heerenveen,Twente Enschede,1,3,-2,L
76266,15,HOL1,2016-02-06,Heracles,Zwolle,2,0,2,W
76267,15,HOL1,2016-02-07,Ajax Amsterdam,Feyenoord Rotterdam,2,1,1,W
76268,15,HOL1,2016-02-07,De Graafschap,NEC Nijmegen,1,1,0,D
76269,15,HOL1,2016-02-07,Groningen,Cambuur,2,0,2,W
76270,15,HOL1,2016-02-07,Utrecht,PSV Eindhoven,0,2,-2,L
76271,15,HOL1,2016-02-12,Cambuur,Utrecht,0,2,-2,L
76272,15,HOL1,2016-02-13,Heracles,AZ Alkmaar,3,6,-3,L
76273,15,HOL1,2016-02-13,Roda,Twente Enschede,0,1,-1,L
76274,15,HOL1,2016-02-13,Vitesse,Heerenveen,3,0,3,W
76275,15,HOL1,2016-02-13,Willem II,De Graafschap,0,0,0,D
76276,15,HOL1,2016-02-14,Excelsior,ADO Den Haag,2,4,-2,L
76277,15,HOL1,2016-02-14,Groningen,Ajax Amsterdam,1,2,-1,L
76278,15,HOL1,2016-02-14,NEC Nijmegen,PSV Eindhoven,0,3,-3,L
76279,15,HOL1,2016-02-14,Zwolle,Feyenoord Rotterdam,3,1,2,W
76280,15,HOL1,2016-02-19,ADO Den Haag,Zwolle,0,2,-2,L
76281,15,HOL1,2016-02-20,AZ Alkmaar,Groningen,4,1,3,W
76282,15,HOL1,2016-02-20,Heerenveen,NEC Nijmegen,1,1,0,D
76283,15,HOL1,2016-02-20,PSV Eindhoven,Heracles,2,0,2,W
76284,15,HOL1,2016-02-20,Twente Enschede,Cambuur,3,0,3,W
76285,15,HOL1,2016-02-21,Ajax Amsterdam,Excelsior,3,0,3,W
76286,15,HOL1,2016-02-21,Feyenoord Rotterdam,Roda,1,1,0,D
76287,15,HOL1,2016-02-21,De Graafschap,Vitesse,2,2,0,D
76288,15,HOL1,2016-02-21,Utrecht,Willem II,2,1,1,W
76289,15,HOL1,2016-02-26,Excelsior,NEC Nijmegen,2,0,2,W
76290,15,HOL1,2016-02-27,Cambuur,Zwolle,1,0,1,W
76291,15,HOL1,2016-02-27,PSV Eindhoven,ADO Den Haag,2,0,2,W
76292,15,HOL1,2016-02-27,Twente Enschede,Groningen,2,0,2,W
76293,15,HOL1,2016-02-27,Vitesse,Willem II,0,1,-1,L
76294,15,HOL1,2016-02-28,Ajax Amsterdam,AZ Alkmaar,4,1,3,W
76295,15,HOL1,2016-02-28,De Graafschap,Heerenveen,0,1,-1,L
76296,15,HOL1,2016-02-28,Heracles,Roda,0,5,-5,L
76297,15,HOL1,2016-02-28,Utrecht,Feyenoord Rotterdam,1,2,-1,L
76298,15,HOL1,2016-03-04,ADO Den Haag,Twente Enschede,2,1,1,W
76299,15,HOL1,2016-03-05,Groningen,PSV Eindhoven,0,3,-3,L
76300,15,HOL1,2016-03-05,Heerenveen,Utrecht,0,4,-4,L
76301,15,HOL1,2016-03-05,Zwolle,De Graafschap,2,1,1,W
76302,15,HOL1,2016-03-06,AZ Alkmaar,Excelsior,2,0,2,W
76303,15,HOL1,2016-03-06,Feyenoord Rotterdam,Cambuur,3,1,2,W
76304,15,HOL1,2016-03-06,NEC Nijmegen,Heracles,1,0,1,W
76305,15,HOL1,2016-03-06,Roda,Vitesse,1,2,-1,L
76306,15,HOL1,2016-03-06,Willem II,Ajax Amsterdam,0,4,-4,L
76307,15,HOL1,2016-03-11,De Graafschap,Roda,3,0,3,W
76308,15,HOL1,2016-03-12,Excelsior,Groningen,2,1,1,W
76309,15,HOL1,2016-03-12,PSV Eindhoven,Heerenveen,1,1,0,D
76310,15,HOL1,2016-03-12,Twente Enschede,Zwolle,2,1,1,W
76311,15,HOL1,2016-03-12,Willem II,AZ Alkmaar,0,2,-2,L
76312,15,HOL1,2016-03-13,Ajax Amsterdam,NEC Nijmegen,2,2,0,D
76313,15,HOL1,2016-03-13,Heracles,Cambuur,3,1,2,W
76314,15,HOL1,2016-03-13,Utrecht,ADO Den Haag,2,2,0,D
76315,15,HOL1,2016-03-13,Vitesse,Feyenoord Rotterdam,0,2,-2,L
76316,15,HOL1,2016-03-18,Utrecht,Excelsior,2,1,1,W
76317,15,HOL1,2016-03-19,Cambuur,Roda,0,1,-1,L
76318,15,HOL1,2016-03-19,Feyenoord Rotterdam,De Graafschap,3,1,2,W
76319,15,HOL1,2016-03-19,Heerenveen,Heracles,0,1,-1,L
76320,15,HOL1,2016-03-19,Zwolle,Willem II,4,1,3,W
76321,15,HOL1,2016-03-20,ADO Den Haag,NEC Nijmegen,1,0,1,W
76322,15,HOL1,2016-03-20,Groningen,Vitesse,0,3,-3,L
76323,15,HOL1,2016-03-20,PSV Eindhoven,Ajax Amsterdam,0,2,-2,L
76324,15,HOL1,2016-03-20,Twente Enschede,AZ Alkmaar,2,2,0,D
76325,15,HOL1,2016-04-02,AZ Alkmaar,PSV Eindhoven,2,4,-2,L
76326,15,HOL1,2016-04-02,Feyenoord Rotterdam,Excelsior,3,0,3,W
76327,15,HOL1,2016-04-02,De Graafschap,Cambuur,2,2,0,D
76328,15,HOL1,2016-04-02,Heracles,Utrecht,1,1,0,D
76329,15,HOL1,2016-04-02,Willem II,Twente Enschede,2,3,-1,L
76330,15,HOL1,2016-04-03,Ajax Amsterdam,Zwolle,3,0,3,W
76331,15,HOL1,2016-04-03,ADO Den Haag,Groningen,0,1,-1,L
76332,15,HOL1,2016-04-03,NEC Nijmegen,Vitesse,2,1,1,W
76333,15,HOL1,2016-04-03,Roda,Heerenveen,1,2,-1,L
76334,15,HOL1,2016-04-08,Zwolle,Roda,3,1,2,W
76335,15,HOL1,2016-04-09,Cambuur,Ajax Amsterdam,0,1,-1,L
76336,15,HOL1,2016-04-09,Excelsior,Heracles,1,3,-2,L
76337,15,HOL1,2016-04-09,PSV Eindhoven,Willem II,2,0,2,W
76338,15,HOL1,2016-04-09,Vitesse,ADO Den Haag,2,2,0,D
76339,15,HOL1,2016-04-10,Groningen,De Graafschap,3,1,2,W
76340,15,HOL1,2016-04-10,Heerenveen,AZ Alkmaar,4,2,2,W
76341,15,HOL1,2016-04-10,Twente Enschede,Feyenoord Rotterdam,0,1,-1,L
76342,15,HOL1,2016-04-10,Utrecht,NEC Nijmegen,3,1,2,W
76343,15,HOL1,2016-04-15,De Graafschap,Twente Enschede,1,1,0,D
76344,15,HOL1,2016-04-16,AZ Alkmaar,Zwolle,5,1,4,W
76345,15,HOL1,2016-04-16,Feyenoord Rotterdam,Groningen,1,1,0,D
76346,15,HOL1,2016-04-16,Roda,PSV Eindhoven,0,3,-3,L
76347,15,HOL1,2016-04-16,Vitesse,Heracles,1,1,0,D
76348,15,HOL1,2016-04-17,Ajax Amsterdam,Utrecht,2,2,0,D
76349,15,HOL1,2016-04-17,Excelsior,Heerenveen,1,1,0,D
76350,15,HOL1,2016-04-17,NEC Nijmegen,Cambuur,2,1,1,W
76351,15,HOL1,2016-04-17,Willem II,ADO Den Haag,0,2,-2,L
76352,15,HOL1,2016-04-19,Groningen,Roda,1,0,1,W
76353,15,HOL1,2016-04-19,PSV Eindhoven,Vitesse,2,0,2,W
76354,15,HOL1,2016-04-20,Heerenveen,Ajax Amsterdam,0,2,-2,L
76355,15,HOL1,2016-04-20,Heracles,Feyenoord Rotterdam,2,2,0,D
76356,15,HOL1,2016-04-20,Twente Enschede,Excelsior,2,0,2,W
76357,15,HOL1,2016-04-20,Utrecht,De Graafschap,0,2,-2,L
76358,15,HOL1,2016-04-20,Zwolle,NEC Nijmegen,2,0,2,W
76359,15,HOL1,2016-04-21,Cambuur,Willem II,1,1,0,D
76360,15,HOL1,2016-04-21,ADO Den Haag,AZ Alkmaar,1,2,-1,L
76361,15,HOL1,2016-05-01,Ajax Amsterdam,Twente Enschede,4,0,4,W
76362,15,HOL1,2016-05-01,AZ Alkmaar,De Graafschap,4,1,3,W
76363,15,HOL1,2016-05-01,Excelsior,Zwolle,2,2,0,D
76364,15,HOL1,2016-05-01,Heerenveen,Groningen,1,2,-1,L
76365,15,HOL1,2016-05-01,Heracles,ADO Den Haag,1,1,0,D
76366,15,HOL1,2016-05-01,NEC Nijmegen,Roda,1,2,-1,L
76367,15,HOL1,2016-05-01,PSV Eindhoven,Cambuur,6,2,4,W
76368,15,HOL1,2016-05-01,Vitesse,Utrecht,1,3,-2,L
76369,15,HOL1,2016-05-01,Willem II,Feyenoord Rotterdam,0,1,-1,L
76370,15,HOL1,2016-05-08,Cambuur,Excelsior,0,2,-2,L
76371,15,HOL1,2016-05-08,ADO Den Haag,Heerenveen,1,1,0,D
76372,15,HOL1,2016-05-08,Feyenoord Rotterdam,NEC Nijmegen,1,0,1,W
76373,15,HOL1,2016-05-08,De Graafschap,Ajax Amsterdam,1,1,0,D
76374,15,HOL1,2016-05-08,Groningen,Heracles,2,1,1,W
76375,15,HOL1,2016-05-08,Roda,Willem II,2,3,-1,L
76376,15,HOL1,2016-05-08,Twente Enschede,Vitesse,2,2,0,D
76377,15,HOL1,2016-05-08,Utrecht,AZ Alkmaar,1,3,-2,L
76378,15,HOL1,2016-05-08,Zwolle,PSV Eindhoven,1,3,-2,L
76379,16,HOL1,2016-08-05,NEC Nijmegen,Zwolle,1,1,0,D
76380,16,HOL1,2016-08-06,ADO Den Haag,Go Ahead Eagles,3,0,3,W
76381,16,HOL1,2016-08-06,Utrecht,PSV Eindhoven,1,2,-1,L
76382,16,HOL1,2016-08-06,Twente Enschede,Excelsior,1,2,-1,L
76383,16,HOL1,2016-08-06,Willem II,Vitesse,1,4,-3,L
76384,16,HOL1,2016-08-07,Groningen,Feyenoord Rotterdam,0,5,-5,L
76385,16,HOL1,2016-08-07,AZ Alkmaar,Heerenveen,2,2,0,D
76386,16,HOL1,2016-08-07,Sparta Rotterdam,Ajax Amsterdam,1,3,-2,L
76387,16,HOL1,2016-08-07,Roda,Heracles,1,1,0,D
76388,16,HOL1,2016-08-12,Heerenveen,Utrecht,2,2,0,D
76389,16,HOL1,2016-08-13,Excelsior,Groningen,2,0,2,W
76390,16,HOL1,2016-08-13,Ajax Amsterdam,Roda,2,2,0,D
76391,16,HOL1,2016-08-13,Vitesse,ADO Den Haag,1,2,-1,L
76392,16,HOL1,2016-08-13,Zwolle,Sparta Rotterdam,0,3,-3,L
76393,16,HOL1,2016-08-14,Heracles,Willem II,3,1,2,W
76394,16,HOL1,2016-08-14,Go Ahead Eagles,NEC Nijmegen,2,2,0,D
76395,16,HOL1,2016-08-14,Feyenoord Rotterdam,Twente Enschede,2,0,2,W
76396,16,HOL1,2016-08-14,PSV Eindhoven,AZ Alkmaar,1,0,1,W
76397,16,HOL1,2016-08-19,Excelsior,ADO Den Haag,1,2,-1,L
76398,16,HOL1,2016-08-20,Roda,Vitesse,0,1,-1,L
76399,16,HOL1,2016-08-20,Ajax Amsterdam,Willem II,1,2,-1,L
76400,16,HOL1,2016-08-20,Zwolle,PSV Eindhoven,0,4,-4,L
76401,16,HOL1,2016-08-20,NEC Nijmegen,Heerenveen,2,1,1,W
76402,16,HOL1,2016-08-21,Groningen,Twente Enschede,3,4,-1,L
76403,16,HOL1,2016-08-21,Utrecht,AZ Alkmaar,1,2,-1,L
76404,16,HOL1,2016-08-21,Sparta Rotterdam,Go Ahead Eagles,1,0,1,W
76405,16,HOL1,2016-08-21,Heracles,Feyenoord Rotterdam,0,1,-1,L
76406,16,HOL1,2016-08-26,Vitesse,Utrecht,1,1,0,D
76407,16,HOL1,2016-08-27,Willem II,Roda,0,0,0,D
76408,16,HOL1,2016-08-27,Heerenveen,Zwolle,1,0,1,W
76409,16,HOL1,2016-08-27,Feyenoord Rotterdam,Excelsior,4,1,3,W
76410,16,HOL1,2016-08-27,Twente Enschede,Sparta Rotterdam,3,1,2,W
76411,16,HOL1,2016-08-28,PSV Eindhoven,Groningen,0,0,0,D
76412,16,HOL1,2016-08-28,ADO Den Haag,Heracles,1,1,0,D
76413,16,HOL1,2016-08-28,Go Ahead Eagles,Ajax Amsterdam,0,3,-3,L
76414,16,HOL1,2016-08-28,AZ Alkmaar,NEC Nijmegen,2,0,2,W
76415,16,HOL1,2016-09-10,AZ Alkmaar,Willem II,2,0,2,W
76416,16,HOL1,2016-09-10,Zwolle,Utrecht,1,1,0,D
76417,16,HOL1,2016-09-10,NEC Nijmegen,PSV Eindhoven,0,4,-4,L
76418,16,HOL1,2016-09-10,Heerenveen,Twente Enschede,3,1,2,W
76419,16,HOL1,2016-09-10,Excelsior,Heracles,3,1,2,W
76420,16,HOL1,2016-09-11,Feyenoord Rotterdam,ADO Den Haag,3,1,2,W
76421,16,HOL1,2016-09-11,Groningen,Sparta Rotterdam,1,1,0,D
76422,16,HOL1,2016-09-11,Go Ahead Eagles,Roda,2,0,2,W
76423,16,HOL1,2016-09-11,Ajax Amsterdam,Vitesse,1,0,1,W
76424,16,HOL1,2016-09-16,Utrecht,Groningen,1,5,-4,L
76425,16,HOL1,2016-09-17,Twente Enschede,ADO Den Haag,4,1,3,W
76426,16,HOL1,2016-09-17,Vitesse,Go Ahead Eagles,2,0,2,W
76427,16,HOL1,2016-09-17,Roda,Heerenveen,0,3,-3,L
76428,16,HOL1,2016-09-17,Willem II,Excelsior,1,1,0,D
76429,16,HOL1,2016-09-18,Sparta Rotterdam,NEC Nijmegen,2,0,2,W
76430,16,HOL1,2016-09-18,Zwolle,AZ Alkmaar,0,2,-2,L
76431,16,HOL1,2016-09-18,PSV Eindhoven,Feyenoord Rotterdam,0,1,-1,L
76432,16,HOL1,2016-09-18,Heracles,Ajax Amsterdam,0,2,-2,L
76433,16,HOL1,2016-09-24,ADO Den Haag,Heerenveen,0,3,-3,L
76434,16,HOL1,2016-09-24,Groningen,Heracles,0,0,0,D
76435,16,HOL1,2016-09-24,Ajax Amsterdam,Zwolle,5,1,4,W
76436,16,HOL1,2016-09-24,AZ Alkmaar,Go Ahead Eagles,2,2,0,D
76437,16,HOL1,2016-09-24,Excelsior,PSV Eindhoven,1,3,-2,L
76438,16,HOL1,2016-09-25,NEC Nijmegen,Willem II,0,0,0,D
76439,16,HOL1,2016-09-25,Twente Enschede,Vitesse,2,1,1,W
76440,16,HOL1,2016-09-25,Utrecht,Sparta Rotterdam,2,0,2,W
76441,16,HOL1,2016-09-25,Feyenoord Rotterdam,Roda,5,0,5,W
76442,16,HOL1,2016-09-30,Zwolle,ADO Den Haag,2,1,1,W
76443,16,HOL1,2016-10-01,Vitesse,Groningen,2,1,1,W
76444,16,HOL1,2016-10-01,Heerenveen,PSV Eindhoven,1,1,0,D
76445,16,HOL1,2016-10-01,Roda,NEC Nijmegen,0,1,-1,L
76446,16,HOL1,2016-10-01,Go Ahead Eagles,Excelsior,3,0,3,W
76447,16,HOL1,2016-10-02,Ajax Amsterdam,Utrecht,3,2,1,W
76448,16,HOL1,2016-10-02,Willem II,Feyenoord Rotterdam,0,2,-2,L
76449,16,HOL1,2016-10-02,Heracles,Twente Enschede,1,1,0,D
76450,16,HOL1,2016-10-02,Sparta Rotterdam,AZ Alkmaar,1,1,0,D
76451,16,HOL1,2016-10-15,Sparta Rotterdam,Willem II,2,2,0,D
76452,16,HOL1,2016-10-15,Utrecht,Go Ahead Eagles,3,0,3,W
76453,16,HOL1,2016-10-15,PSV Eindhoven,Heracles,1,1,0,D
76454,16,HOL1,2016-10-15,AZ Alkmaar,Vitesse,2,2,0,D
76455,16,HOL1,2016-10-15,Groningen,Heerenveen,0,3,-3,L
76456,16,HOL1,2016-10-16,Twente Enschede,Zwolle,2,2,0,D
76457,16,HOL1,2016-10-16,Excelsior,Roda,0,1,-1,L
76458,16,HOL1,2016-10-16,NEC Nijmegen,Feyenoord Rotterdam,1,2,-1,L
76459,16,HOL1,2016-10-16,ADO Den Haag,Ajax Amsterdam,0,2,-2,L
76460,16,HOL1,2016-10-21,Excelsior,Zwolle,0,2,-2,L
76461,16,HOL1,2016-10-22,Go Ahead Eagles,Twente Enschede,0,2,-2,L
76462,16,HOL1,2016-10-22,PSV Eindhoven,Sparta Rotterdam,1,0,1,W
76463,16,HOL1,2016-10-22,Roda,ADO Den Haag,1,1,0,D
76464,16,HOL1,2016-10-22,Willem II,Utrecht,0,1,-1,L
76465,16,HOL1,2016-10-23,NEC Nijmegen,Vitesse,1,1,0,D
76466,16,HOL1,2016-10-23,Feyenoord Rotterdam,Ajax Amsterdam,1,1,0,D
76467,16,HOL1,2016-10-23,Groningen,AZ Alkmaar,2,0,2,W
76468,16,HOL1,2016-10-23,Heerenveen,Heracles,3,1,2,W
76469,16,HOL1,2016-10-28,Twente Enschede,Roda,0,0,0,D
76470,16,HOL1,2016-10-29,Willem II,Groningen,2,1,1,W
76471,16,HOL1,2016-10-29,Heracles,Sparta Rotterdam,2,2,0,D
76472,16,HOL1,2016-10-29,Vitesse,PSV Eindhoven,0,2,-2,L
76473,16,HOL1,2016-10-29,Ajax Amsterdam,Excelsior,1,0,1,W
76474,16,HOL1,2016-10-30,Zwolle,Go Ahead Eagles,3,1,2,W
76475,16,HOL1,2016-10-30,Feyenoord Rotterdam,Heerenveen,2,2,0,D
76476,16,HOL1,2016-10-30,Utrecht,NEC Nijmegen,1,1,0,D
76477,16,HOL1,2016-10-30,ADO Den Haag,AZ Alkmaar,0,1,-1,L
76478,16,HOL1,2016-11-04,Sparta Rotterdam,Heerenveen,3,1,2,W
76479,16,HOL1,2016-11-05,ADO Den Haag,Willem II,1,0,1,W
76480,16,HOL1,2016-11-05,PSV Eindhoven,Twente Enschede,1,1,0,D
76481,16,HOL1,2016-11-05,NEC Nijmegen,Groningen,1,1,0,D
76482,16,HOL1,2016-11-05,Zwolle,Roda,0,0,0,D
76483,16,HOL1,2016-11-06,Utrecht,Excelsior,2,1,1,W
76484,16,HOL1,2016-11-06,AZ Alkmaar,Ajax Amsterdam,2,2,0,D
76485,16,HOL1,2016-11-06,Vitesse,Heracles,1,2,-1,L
76486,16,HOL1,2016-11-06,Go Ahead Eagles,Feyenoord Rotterdam,1,0,1,W
76487,16,HOL1,2016-11-19,Heerenveen,Vitesse,1,1,0,D
76488,16,HOL1,2016-11-19,Heracles,Go Ahead Eagles,2,1,1,W
76489,16,HOL1,2016-11-19,Willem II,PSV Eindhoven,0,0,0,D
76490,16,HOL1,2016-11-19,Excelsior,Sparta Rotterdam,3,2,1,W
76491,16,HOL1,2016-11-19,Groningen,ADO Den Haag,2,1,1,W
76492,16,HOL1,2016-11-20,Roda,AZ Alkmaar,1,1,0,D
76493,16,HOL1,2016-11-20,Ajax Amsterdam,NEC Nijmegen,5,0,5,W
76494,16,HOL1,2016-11-20,Twente Enschede,Utrecht,1,1,0,D
76495,16,HOL1,2016-11-20,Feyenoord Rotterdam,Zwolle,3,0,3,W
76496,16,HOL1,2016-11-25,Go Ahead Eagles,Willem II,0,1,-1,L
76497,16,HOL1,2016-11-26,Vitesse,Excelsior,2,2,0,D
76498,16,HOL1,2016-11-26,PSV Eindhoven,ADO Den Haag,3,1,2,W
76499,16,HOL1,2016-11-26,Zwolle,Groningen,0,4,-4,L
76500,16,HOL1,2016-11-26,NEC Nijmegen,Twente Enschede,3,2,1,W
76501,16,HOL1,2016-11-27,Sparta Rotterdam,Roda,2,2,0,D
76502,16,HOL1,2016-11-27,AZ Alkmaar,Heracles,5,1,4,W
76503,16,HOL1,2016-11-27,Heerenveen,Ajax Amsterdam,0,1,-1,L
76504,16,HOL1,2016-11-27,Utrecht,Feyenoord Rotterdam,3,3,0,D
76505,16,HOL1,2016-12-02,Heracles,NEC Nijmegen,2,0,2,W
76506,16,HOL1,2016-12-03,Go Ahead Eagles,Heerenveen,1,3,-2,L
76507,16,HOL1,2016-12-03,Excelsior,AZ Alkmaar,3,3,0,D
76508,16,HOL1,2016-12-03,Roda,PSV Eindhoven,0,0,0,D
76509,16,HOL1,2016-12-03,Vitesse,Zwolle,3,1,2,W
76510,16,HOL1,2016-12-04,ADO Den Haag,Utrecht,0,2,-2,L
76511,16,HOL1,2016-12-04,Feyenoord Rotterdam,Sparta Rotterdam,6,1,5,W
76512,16,HOL1,2016-12-04,Willem II,Twente Enschede,0,0,0,D
76513,16,HOL1,2016-12-04,Ajax Amsterdam,Groningen,2,0,2,W
76514,16,HOL1,2016-12-09,Groningen,Roda,2,0,2,W
76515,16,HOL1,2016-12-10,NEC Nijmegen,ADO Den Haag,3,0,3,W
76516,16,HOL1,2016-12-10,PSV Eindhoven,Go Ahead Eagles,1,0,1,W
76517,16,HOL1,2016-12-10,Heerenveen,Excelsior,2,1,1,W
76518,16,HOL1,2016-12-10,Zwolle,Willem II,0,0,0,D
76519,16,HOL1,2016-12-11,Sparta Rotterdam,Vitesse,0,1,-1,L
76520,16,HOL1,2016-12-11,AZ Alkmaar,Feyenoord Rotterdam,0,4,-4,L
76521,16,HOL1,2016-12-11,Utrecht,Heracles,2,0,2,W
76522,16,HOL1,2016-12-11,Twente Enschede,Ajax Amsterdam,1,0,1,W
76523,16,HOL1,2016-12-16,Willem II,Heerenveen,2,1,1,W
76524,16,HOL1,2016-12-17,Roda,Utrecht,0,0,0,D
76525,16,HOL1,2016-12-17,Feyenoord Rotterdam,Vitesse,3,1,2,W
76526,16,HOL1,2016-12-17,Twente Enschede,AZ Alkmaar,1,2,-1,L
76527,16,HOL1,2016-12-18,Excelsior,NEC Nijmegen,2,2,0,D
76528,16,HOL1,2016-12-18,ADO Den Haag,Sparta Rotterdam,1,0,1,W
76529,16,HOL1,2016-12-18,Heracles,Zwolle,3,0,3,W
76530,16,HOL1,2016-12-18,Groningen,Go Ahead Eagles,1,1,0,D
76531,16,HOL1,2016-12-18,Ajax Amsterdam,PSV Eindhoven,1,1,0,D
76532,16,HOL1,2017-01-13,Go Ahead Eagles,AZ Alkmaar,1,3,-2,L
76533,16,HOL1,2017-01-14,Heerenveen,ADO Den Haag,2,0,2,W
76534,16,HOL1,2017-01-14,Heracles,Groningen,1,4,-3,L
76535,16,HOL1,2017-01-14,PSV Eindhoven,Excelsior,2,0,2,W
76536,16,HOL1,2017-01-14,Sparta Rotterdam,Utrecht,1,2,-1,L
76537,16,HOL1,2017-01-15,Roda,Feyenoord Rotterdam,0,2,-2,L
76538,16,HOL1,2017-01-15,Zwolle,Ajax Amsterdam,1,3,-2,L
76539,16,HOL1,2017-01-15,Vitesse,Twente Enschede,3,1,2,W
76540,16,HOL1,2017-01-15,Willem II,NEC Nijmegen,0,1,-1,L
76541,16,HOL1,2017-01-20,Twente Enschede,Heracles,1,0,1,W
76542,16,HOL1,2017-01-21,AZ Alkmaar,Sparta Rotterdam,1,1,0,D
76543,16,HOL1,2017-01-21,ADO Den Haag,Zwolle,1,2,-1,L
76544,16,HOL1,2017-01-21,Feyenoord Rotterdam,Willem II,1,0,1,W
76545,16,HOL1,2017-01-21,Groningen,Vitesse,1,1,0,D
76546,16,HOL1,2017-01-22,Utrecht,Ajax Amsterdam,0,1,-1,L
76547,16,HOL1,2017-01-22,Excelsior,Go Ahead Eagles,1,1,0,D
76548,16,HOL1,2017-01-22,NEC Nijmegen,Roda,2,0,2,W
76549,16,HOL1,2017-01-22,PSV Eindhoven,Heerenveen,4,3,1,W
76550,16,HOL1,2017-01-27,Willem II,Sparta Rotterdam,3,2,1,W
76551,16,HOL1,2017-01-28,Go Ahead Eagles,Utrecht,0,1,-1,L
76552,16,HOL1,2017-01-28,Heracles,PSV Eindhoven,1,2,-1,L
76553,16,HOL1,2017-01-28,Roda,Excelsior,4,0,4,W
76554,16,HOL1,2017-01-29,Heerenveen,Groningen,0,0,0,D
76555,16,HOL1,2017-01-29,Vitesse,AZ Alkmaar,2,1,1,W
76556,16,HOL1,2017-01-29,Ajax Amsterdam,ADO Den Haag,3,0,3,W
76557,16,HOL1,2017-01-29,Zwolle,Twente Enschede,1,2,-1,L
76558,16,HOL1,2017-01-29,Feyenoord Rotterdam,NEC Nijmegen,4,0,4,W
76559,16,HOL1,2017-02-03,ADO Den Haag,Vitesse,0,2,-2,L
76560,16,HOL1,2017-02-04,NEC Nijmegen,Go Ahead Eagles,1,2,-1,L
76561,16,HOL1,2017-02-04,AZ Alkmaar,PSV Eindhoven,2,4,-2,L
76562,16,HOL1,2017-02-04,Willem II,Heracles,1,3,-2,L
76563,16,HOL1,2017-02-04,Groningen,Excelsior,1,1,0,D
76564,16,HOL1,2017-02-05,Roda,Ajax Amsterdam,0,2,-2,L
76565,16,HOL1,2017-02-05,Twente Enschede,Feyenoord Rotterdam,0,2,-2,L
76566,16,HOL1,2017-02-05,Sparta Rotterdam,Zwolle,2,3,-1,L
76567,16,HOL1,2017-02-05,Utrecht,Heerenveen,1,0,1,W
76568,16,HOL1,2017-02-10,Zwolle,NEC Nijmegen,2,0,2,W
76569,16,HOL1,2017-02-11,Heracles,Roda,2,2,0,D
76570,16,HOL1,2017-02-11,Go Ahead Eagles,ADO Den Haag,3,1,2,W
76571,16,HOL1,2017-02-11,Feyenoord Rotterdam,Groningen,2,0,2,W
76572,16,HOL1,2017-02-11,Vitesse,Willem II,0,2,-2,L
76573,16,HOL1,2017-02-12,Excelsior,Twente Enschede,1,1,0,D
76574,16,HOL1,2017-02-12,Ajax Amsterdam,Sparta Rotterdam,2,0,2,W
76575,16,HOL1,2017-02-12,Heerenveen,AZ Alkmaar,1,2,-1,L
76576,16,HOL1,2017-02-12,PSV Eindhoven,Utrecht,3,0,3,W
76577,16,HOL1,2017-02-17,Roda,Go Ahead Eagles,1,0,1,W
76578,16,HOL1,2017-02-18,Twente Enschede,Heerenveen,1,0,1,W
76579,16,HOL1,2017-02-18,PSV Eindhoven,NEC Nijmegen,3,1,2,W
76580,16,HOL1,2017-02-18,Heracles,Excelsior,4,0,4,W
76581,16,HOL1,2017-02-18,Utrecht,Zwolle,3,1,2,W
76582,16,HOL1,2017-02-19,Willem II,AZ Alkmaar,1,1,0,D
76583,16,HOL1,2017-02-19,Vitesse,Ajax Amsterdam,0,1,-1,L
76584,16,HOL1,2017-02-19,Sparta Rotterdam,Groningen,2,2,0,D
76585,16,HOL1,2017-02-19,ADO Den Haag,Feyenoord Rotterdam,0,1,-1,L
76586,16,HOL1,2017-02-24,ADO Den Haag,Twente Enschede,1,1,0,D
76587,16,HOL1,2017-02-25,Groningen,Utrecht,2,3,-1,L
76588,16,HOL1,2017-02-25,Excelsior,Willem II,0,2,-2,L
76589,16,HOL1,2017-02-25,NEC Nijmegen,Sparta Rotterdam,0,1,-1,L
76590,16,HOL1,2017-02-25,Heerenveen,Roda,3,0,3,W
76591,16,HOL1,2017-02-26,Go Ahead Eagles,Vitesse,1,3,-2,L
76592,16,HOL1,2017-02-26,AZ Alkmaar,Zwolle,1,1,0,D
76593,16,HOL1,2017-02-26,Feyenoord Rotterdam,PSV Eindhoven,2,1,1,W
76594,16,HOL1,2017-02-26,Ajax Amsterdam,Heracles,4,1,3,W
76595,16,HOL1,2017-03-03,Heerenveen,Go Ahead Eagles,2,2,0,D
76596,16,HOL1,2017-03-04,Twente Enschede,Willem II,2,1,1,W
76597,16,HOL1,2017-03-04,PSV Eindhoven,Roda,4,0,4,W
76598,16,HOL1,2017-03-04,Zwolle,Vitesse,3,1,2,W
76599,16,HOL1,2017-03-05,AZ Alkmaar,Excelsior,1,1,0,D
76600,16,HOL1,2017-03-05,Sparta Rotterdam,Feyenoord Rotterdam,1,0,1,W
76601,16,HOL1,2017-03-05,Groningen,Ajax Amsterdam,1,1,0,D
76602,16,HOL1,2017-03-05,Utrecht,ADO Den Haag,1,1,0,D
76603,16,HOL1,2017-03-05,NEC Nijmegen,Heracles,3,1,2,W
76604,16,HOL1,2017-03-10,Vitesse,Sparta Rotterdam,5,0,5,W
76605,16,HOL1,2017-03-11,ADO Den Haag,NEC Nijmegen,1,0,1,W
76606,16,HOL1,2017-03-11,Go Ahead Eagles,PSV Eindhoven,1,3,-2,L
76607,16,HOL1,2017-03-11,Heracles,Utrecht,2,1,1,W
76608,16,HOL1,2017-03-11,Excelsior,Heerenveen,4,1,3,W
76609,16,HOL1,2017-03-12,Willem II,Zwolle,2,0,2,W
76610,16,HOL1,2017-03-12,Feyenoord Rotterdam,AZ Alkmaar,5,2,3,W
76611,16,HOL1,2017-03-12,Roda,Groningen,3,1,2,W
76612,16,HOL1,2017-03-12,Ajax Amsterdam,Twente Enschede,3,0,3,W
76613,16,HOL1,2017-03-17,Roda,Twente Enschede,0,3,-3,L
76614,16,HOL1,2017-03-18,Groningen,Willem II,1,1,0,D
76615,16,HOL1,2017-03-18,NEC Nijmegen,Utrecht,0,3,-3,L
76616,16,HOL1,2017-03-18,PSV Eindhoven,Vitesse,1,0,1,W
76617,16,HOL1,2017-03-18,Sparta Rotterdam,Heracles,3,1,2,W
76618,16,HOL1,2017-03-19,Heerenveen,Feyenoord Rotterdam,1,2,-1,L
76619,16,HOL1,2017-03-19,Go Ahead Eagles,Zwolle,1,3,-2,L
76620,16,HOL1,2017-03-19,Excelsior,Ajax Amsterdam,1,1,0,D
76621,16,HOL1,2017-03-19,AZ Alkmaar,ADO Den Haag,4,0,4,W
76622,16,HOL1,2017-04-01,AZ Alkmaar,Groningen,0,0,0,D
76623,16,HOL1,2017-04-01,Zwolle,Excelsior,1,1,0,D
76624,16,HOL1,2017-04-01,Sparta Rotterdam,PSV Eindhoven,0,2,-2,L
76625,16,HOL1,2017-04-01,Heracles,Heerenveen,4,1,3,W
76626,16,HOL1,2017-04-01,Utrecht,Willem II,2,0,2,W
76627,16,HOL1,2017-04-02,Vitesse,NEC Nijmegen,2,1,1,W
76628,16,HOL1,2017-04-02,ADO Den Haag,Roda,4,1,3,W
76629,16,HOL1,2017-04-02,Ajax Amsterdam,Feyenoord Rotterdam,2,1,1,W
76630,16,HOL1,2017-04-02,Twente Enschede,Go Ahead Eagles,1,2,-1,L
76631,16,HOL1,2017-04-04,Excelsior,Utrecht,1,3,-2,L
76632,16,HOL1,2017-04-04,Heerenveen,Sparta Rotterdam,3,0,3,W
76633,16,HOL1,2017-04-05,Heracles,Vitesse,0,1,-1,L
76634,16,HOL1,2017-04-05,Groningen,NEC Nijmegen,2,0,2,W
76635,16,HOL1,2017-04-05,Ajax Amsterdam,AZ Alkmaar,4,1,3,W
76636,16,HOL1,2017-04-05,Feyenoord Rotterdam,Go Ahead Eagles,8,0,8,W
76637,16,HOL1,2017-04-05,Willem II,ADO Den Haag,1,2,-1,L
76638,16,HOL1,2017-04-06,Roda,Zwolle,2,1,1,W
76639,16,HOL1,2017-04-06,Twente Enschede,PSV Eindhoven,2,2,0,D
76640,16,HOL1,2017-04-07,Sparta Rotterdam,Excelsior,2,3,-1,L
76641,16,HOL1,2017-04-08,Vitesse,Heerenveen,4,2,2,W
76642,16,HOL1,2017-04-08,ADO Den Haag,Groningen,4,3,1,W
76643,16,HOL1,2017-04-08,NEC Nijmegen,Ajax Amsterdam,1,5,-4,L
76644,16,HOL1,2017-04-08,Go Ahead Eagles,Heracles,1,4,-3,L
76645,16,HOL1,2017-04-09,AZ Alkmaar,Roda,1,1,0,D
76646,16,HOL1,2017-04-09,Zwolle,Feyenoord Rotterdam,2,2,0,D
76647,16,HOL1,2017-04-09,Utrecht,Twente Enschede,3,0,3,W
76648,16,HOL1,2017-04-09,PSV Eindhoven,Willem II,5,0,5,W
76649,16,HOL1,2017-04-14,Heracles,AZ Alkmaar,1,2,-1,L
76650,16,HOL1,2017-04-15,Roda,Sparta Rotterdam,3,1,2,W
76651,16,HOL1,2017-04-15,ADO Den Haag,PSV Eindhoven,1,1,0,D
76652,16,HOL1,2017-04-15,Excelsior,Vitesse,1,0,1,W
76653,16,HOL1,2017-04-15,Twente Enschede,NEC Nijmegen,3,0,3,W
76654,16,HOL1,2017-04-16,Willem II,Go Ahead Eagles,2,0,2,W
76655,16,HOL1,2017-04-16,Feyenoord Rotterdam,Utrecht,2,0,2,W
76656,16,HOL1,2017-04-16,Groningen,Zwolle,5,1,4,W
76657,16,HOL1,2017-04-16,Ajax Amsterdam,Heerenveen,5,1,4,W
76658,16,HOL1,2017-04-21,Heerenveen,Willem II,1,0,1,W
76659,16,HOL1,2017-04-22,NEC Nijmegen,Excelsior,0,1,-1,L
76660,16,HOL1,2017-04-22,Zwolle,Heracles,1,2,-1,L
76661,16,HOL1,2017-04-22,AZ Alkmaar,Twente Enschede,2,1,1,W
76662,16,HOL1,2017-04-22,Go Ahead Eagles,Groningen,2,3,-1,L
76663,16,HOL1,2017-04-23,Utrecht,Roda,1,0,1,W
76664,16,HOL1,2017-04-23,Sparta Rotterdam,ADO Den Haag,0,1,-1,L
76665,16,HOL1,2017-04-23,Vitesse,Feyenoord Rotterdam,0,2,-2,L
76666,16,HOL1,2017-04-23,PSV Eindhoven,Ajax Amsterdam,1,0,1,W
76667,16,HOL1,2017-05-07,Ajax Amsterdam,Go Ahead Eagles,4,0,4,W
76668,16,HOL1,2017-05-07,Excelsior,Feyenoord Rotterdam,3,0,3,W
76669,16,HOL1,2017-05-07,Groningen,PSV Eindhoven,1,1,0,D
76670,16,HOL1,2017-05-07,Roda,Willem II,1,0,1,W
76671,16,HOL1,2017-05-07,Utrecht,Vitesse,1,0,1,W
76672,16,HOL1,2017-05-07,Heracles,ADO Den Haag,4,0,4,W
76673,16,HOL1,2017-05-07,NEC Nijmegen,AZ Alkmaar,2,1,1,W
76674,16,HOL1,2017-05-07,Sparta Rotterdam,Twente Enschede,1,0,1,W
76675,16,HOL1,2017-05-07,Zwolle,Heerenveen,2,1,1,W
76676,16,HOL1,2017-05-14,ADO Den Haag,Excelsior,4,1,3,W
76677,16,HOL1,2017-05-14,AZ Alkmaar,Utrecht,2,3,-1,L
76678,16,HOL1,2017-05-14,Feyenoord Rotterdam,Heracles,3,1,2,W
76679,16,HOL1,2017-05-14,Go Ahead Eagles,Sparta Rotterdam,1,3,-2,L
76680,16,HOL1,2017-05-14,Twente Enschede,Groningen,3,5,-2,L
76681,16,HOL1,2017-05-14,Heerenveen,NEC Nijmegen,0,2,-2,L
76682,16,HOL1,2017-05-14,Willem II,Ajax Amsterdam,1,3,-2,L
76683,16,HOL1,2017-05-14,PSV Eindhoven,Zwolle,4,1,3,W
76684,16,HOL1,2017-05-14,Vitesse,Roda,3,0,3,W
76685,17,HOL1,2017-08-11,ADO Den Haag,Utrecht,0,3,-3,L
76686,17,HOL1,2017-08-12,VVV Venlo,Sparta Rotterdam,3,0,3,W
76687,17,HOL1,2017-08-12,PSV Eindhoven,AZ Alkmaar,3,2,1,W
76688,17,HOL1,2017-08-12,Heracles,Ajax Amsterdam,2,1,1,W
76689,17,HOL1,2017-08-12,Vitesse,NAC Breda,4,1,3,W
76690,17,HOL1,2017-08-13,Zwolle,Roda,4,2,2,W
76691,17,HOL1,2017-08-13,Feyenoord Rotterdam,Twente Enschede,2,1,1,W
76692,17,HOL1,2017-08-13,Willem II,Excelsior,1,2,-1,L
76693,17,HOL1,2017-08-13,Groningen,Heerenveen,3,3,0,D
76694,17,HOL1,2017-08-18,Roda,Vitesse,1,3,-2,L
76695,17,HOL1,2017-08-19,Twente Enschede,VVV Venlo,1,2,-1,L
76696,17,HOL1,2017-08-19,AZ Alkmaar,ADO Den Haag,2,0,2,W
76697,17,HOL1,2017-08-19,Heerenveen,Heracles,1,1,0,D
76698,17,HOL1,2017-08-20,Excelsior,Feyenoord Rotterdam,0,1,-1,L
76699,17,HOL1,2017-08-20,Ajax Amsterdam,Groningen,3,1,2,W
76700,17,HOL1,2017-08-20,Utrecht,Willem II,2,0,2,W
76701,17,HOL1,2017-08-20,Sparta Rotterdam,Zwolle,1,1,0,D
76702,17,HOL1,2017-08-20,NAC Breda,PSV Eindhoven,1,4,-3,L
76703,17,HOL1,2017-08-25,NAC Breda,Sparta Rotterdam,2,2,0,D
76704,17,HOL1,2017-08-26,Vitesse,AZ Alkmaar,1,2,-1,L
76705,17,HOL1,2017-08-26,ADO Den Haag,Heerenveen,1,2,-1,L
76706,17,HOL1,2017-08-26,Zwolle,Twente Enschede,2,0,2,W
76707,17,HOL1,2017-08-26,Heracles,Excelsior,2,2,0,D
76708,17,HOL1,2017-08-27,Feyenoord Rotterdam,Willem II,5,0,5,W
76709,17,HOL1,2017-08-27,VVV Venlo,Ajax Amsterdam,0,2,-2,L
76710,17,HOL1,2017-08-27,Groningen,Utrecht,2,1,1,W
76711,17,HOL1,2017-08-27,PSV Eindhoven,Roda,2,0,2,W
76712,17,HOL1,2017-09-09,Willem II,ADO Den Haag,1,2,-1,L
76713,17,HOL1,2017-09-09,Heracles,Feyenoord Rotterdam,2,4,-2,L
76714,17,HOL1,2017-09-09,Ajax Amsterdam,Zwolle,3,0,3,W
76715,17,HOL1,2017-09-09,Excelsior,Vitesse,0,3,-3,L
76716,17,HOL1,2017-09-10,Heerenveen,PSV Eindhoven,2,0,2,W
76717,17,HOL1,2017-09-10,Utrecht,Roda,2,0,2,W
76718,17,HOL1,2017-09-10,Sparta Rotterdam,Twente Enschede,1,0,1,W
76719,17,HOL1,2017-09-10,AZ Alkmaar,NAC Breda,2,1,1,W
76720,17,HOL1,2017-09-10,Groningen,VVV Venlo,1,1,0,D
76721,17,HOL1,2017-09-15,Sparta Rotterdam,AZ Alkmaar,0,2,-2,L
76722,17,HOL1,2017-09-16,Excelsior,Heerenveen,1,2,-1,L
76723,17,HOL1,2017-09-16,Roda,Willem II,1,3,-2,L
76724,17,HOL1,2017-09-16,NAC Breda,Groningen,2,1,1,W
76725,17,HOL1,2017-09-16,Zwolle,Heracles,2,1,1,W
76726,17,HOL1,2017-09-17,ADO Den Haag,Ajax Amsterdam,1,1,0,D
76727,17,HOL1,2017-09-17,Twente Enschede,Utrecht,4,0,4,W
76728,17,HOL1,2017-09-17,Vitesse,VVV Venlo,1,1,0,D
76729,17,HOL1,2017-09-17,PSV Eindhoven,Feyenoord Rotterdam,1,0,1,W
76730,17,HOL1,2017-09-23,Willem II,Heerenveen,1,2,-1,L
76731,17,HOL1,2017-09-23,Feyenoord Rotterdam,NAC Breda,0,2,-2,L
76732,17,HOL1,2017-09-23,Heracles,Roda,2,1,1,W
76733,17,HOL1,2017-09-23,ADO Den Haag,Sparta Rotterdam,1,0,1,W
76734,17,HOL1,2017-09-24,Utrecht,PSV Eindhoven,1,7,-6,L
76735,17,HOL1,2017-09-24,Ajax Amsterdam,Vitesse,1,2,-1,L
76736,17,HOL1,2017-09-24,VVV Venlo,Zwolle,1,1,0,D
76737,17,HOL1,2017-09-24,Groningen,Twente Enschede,1,0,1,W
76738,17,HOL1,2017-09-24,AZ Alkmaar,Excelsior,0,2,-2,L
76739,17,HOL1,2017-09-29,Twente Enschede,Heracles,2,1,1,W
76740,17,HOL1,2017-09-30,NAC Breda,ADO Den Haag,0,1,-1,L
76741,17,HOL1,2017-09-30,Zwolle,Groningen,3,2,1,W
76742,17,HOL1,2017-09-30,PSV Eindhoven,Willem II,4,0,4,W
76743,17,HOL1,2017-09-30,Excelsior,VVV Venlo,0,2,-2,L
76744,17,HOL1,2017-10-01,AZ Alkmaar,Feyenoord Rotterdam,0,4,-4,L
76745,17,HOL1,2017-10-01,Heerenveen,Ajax Amsterdam,0,4,-4,L
76746,17,HOL1,2017-10-01,Vitesse,Utrecht,1,1,0,D
76747,17,HOL1,2017-10-01,Sparta Rotterdam,Roda,1,2,-1,L
76748,17,HOL1,2017-10-14,Roda,NAC Breda,1,0,1,W
76749,17,HOL1,2017-10-14,Ajax Amsterdam,Sparta Rotterdam,4,0,4,W
76750,17,HOL1,2017-10-14,Feyenoord Rotterdam,Zwolle,0,0,0,D
76751,17,HOL1,2017-10-14,Utrecht,Heerenveen,3,1,2,W
76752,17,HOL1,2017-10-15,Heracles,Vitesse,1,1,0,D
76753,17,HOL1,2017-10-15,Willem II,Twente Enschede,3,1,2,W
76754,17,HOL1,2017-10-15,VVV Venlo,PSV Eindhoven,2,5,-3,L
76755,17,HOL1,2017-10-15,Groningen,AZ Alkmaar,1,1,0,D
76756,17,HOL1,2017-10-15,ADO Den Haag,Excelsior,1,2,-1,L
76757,17,HOL1,2017-10-20,Groningen,Willem II,0,1,-1,L
76758,17,HOL1,2017-10-21,NAC Breda,Zwolle,0,2,-2,L
76759,17,HOL1,2017-10-21,Excelsior,Sparta Rotterdam,1,1,0,D
76760,17,HOL1,2017-10-21,VVV Venlo,ADO Den Haag,0,2,-2,L
76761,17,HOL1,2017-10-21,Twente Enschede,Roda,3,0,3,W
76762,17,HOL1,2017-10-22,PSV Eindhoven,Heracles,3,0,3,W
76763,17,HOL1,2017-10-22,Feyenoord Rotterdam,Ajax Amsterdam,1,4,-3,L
76764,17,HOL1,2017-10-22,AZ Alkmaar,Utrecht,3,0,3,W
76765,17,HOL1,2017-10-22,Heerenveen,Vitesse,0,4,-4,L
76766,17,HOL1,2017-10-27,Twente Enschede,Excelsior,1,3,-2,L
76767,17,HOL1,2017-10-28,Heracles,VVV Venlo,3,0,3,W
76768,17,HOL1,2017-10-28,Roda,Feyenoord Rotterdam,1,1,0,D
76769,17,HOL1,2017-10-28,Willem II,Ajax Amsterdam,1,3,-2,L
76770,17,HOL1,2017-10-28,Zwolle,ADO Den Haag,2,0,2,W
76771,17,HOL1,2017-10-29,Vitesse,PSV Eindhoven,2,4,-2,L
76772,17,HOL1,2017-10-29,Utrecht,NAC Breda,2,2,0,D
76773,17,HOL1,2017-10-29,Sparta Rotterdam,Groningen,2,1,1,W
76774,17,HOL1,2017-10-29,Heerenveen,AZ Alkmaar,1,2,-1,L
76775,17,HOL1,2017-11-03,Sparta Rotterdam,Heerenveen,0,0,0,D
76776,17,HOL1,2017-11-04,AZ Alkmaar,Willem II,3,2,1,W
76777,17,HOL1,2017-11-04,Excelsior,Roda,1,0,1,W
76778,17,HOL1,2017-11-04,Heracles,Groningen,2,1,1,W
76779,17,HOL1,2017-11-04,VVV Venlo,NAC Breda,0,0,0,D
76780,17,HOL1,2017-11-05,ADO Den Haag,Feyenoord Rotterdam,2,2,0,D
76781,17,HOL1,2017-11-05,Ajax Amsterdam,Utrecht,1,2,-1,L
76782,17,HOL1,2017-11-05,Vitesse,Zwolle,0,0,0,D
76783,17,HOL1,2017-11-05,PSV Eindhoven,Twente Enschede,4,3,1,W
76784,17,HOL1,2017-11-18,Twente Enschede,Heerenveen,0,4,-4,L
76785,17,HOL1,2017-11-18,Feyenoord Rotterdam,VVV Venlo,1,1,0,D
76786,17,HOL1,2017-11-18,NAC Breda,Ajax Amsterdam,0,8,-8,L
76787,17,HOL1,2017-11-18,Willem II,Sparta Rotterdam,2,2,0,D
76788,17,HOL1,2017-11-19,ADO Den Haag,Heracles,4,1,3,W
76789,17,HOL1,2017-11-19,Zwolle,PSV Eindhoven,0,1,-1,L
76790,17,HOL1,2017-11-19,Utrecht,Excelsior,3,1,2,W
76791,17,HOL1,2017-11-19,Groningen,Vitesse,4,2,2,W
76792,17,HOL1,2017-11-19,Roda,AZ Alkmaar,0,1,-1,L
76793,17,HOL1,2017-11-24,AZ Alkmaar,Twente Enschede,2,0,2,W
76794,17,HOL1,2017-11-25,VVV Venlo,Willem II,3,3,0,D
76795,17,HOL1,2017-11-25,Heracles,NAC Breda,2,1,1,W
76796,17,HOL1,2017-11-25,Groningen,Feyenoord Rotterdam,0,2,-2,L
76797,17,HOL1,2017-11-25,Heerenveen,Zwolle,1,2,-1,L
76798,17,HOL1,2017-11-26,Ajax Amsterdam,Roda,5,1,4,W
76799,17,HOL1,2017-11-26,Excelsior,PSV Eindhoven,1,2,-1,L
76800,17,HOL1,2017-11-26,Sparta Rotterdam,Utrecht,1,3,-2,L
76801,17,HOL1,2017-11-26,Vitesse,ADO Den Haag,2,0,2,W
76802,17,HOL1,2017-12-01,Zwolle,Utrecht,1,1,0,D
76803,17,HOL1,2017-12-02,ADO Den Haag,Groningen,0,3,-3,L
76804,17,HOL1,2017-12-02,Twente Enschede,Ajax Amsterdam,3,3,0,D
76805,17,HOL1,2017-12-02,Feyenoord Rotterdam,Vitesse,1,0,1,W
76806,17,HOL1,2017-12-02,Willem II,Heracles,3,1,2,W
76807,17,HOL1,2017-12-03,VVV Venlo,AZ Alkmaar,0,2,-2,L
76808,17,HOL1,2017-12-03,PSV Eindhoven,Sparta Rotterdam,1,0,1,W
76809,17,HOL1,2017-12-03,Roda,Heerenveen,2,1,1,W
76810,17,HOL1,2017-12-03,NAC Breda,Excelsior,3,1,2,W
76811,17,HOL1,2017-12-08,Willem II,NAC Breda,1,1,0,D
76812,17,HOL1,2017-12-09,Heerenveen,VVV Venlo,2,2,0,D
76813,17,HOL1,2017-12-09,AZ Alkmaar,Heracles,5,0,5,W
76814,17,HOL1,2017-12-09,Excelsior,Zwolle,1,2,-1,L
76815,17,HOL1,2017-12-09,Twente Enschede,ADO Den Haag,2,3,-1,L
76816,17,HOL1,2017-12-10,Roda,Groningen,2,2,0,D
76817,17,HOL1,2017-12-10,Ajax Amsterdam,PSV Eindhoven,3,0,3,W
76818,17,HOL1,2017-12-12,NAC Breda,Twente Enschede,1,2,-1,L
76819,17,HOL1,2017-12-12,Zwolle,AZ Alkmaar,1,1,0,D
76820,17,HOL1,2017-12-13,Vitesse,Willem II,2,2,0,D
76821,17,HOL1,2017-12-13,Groningen,PSV Eindhoven,3,3,0,D
76822,17,HOL1,2017-12-13,VVV Venlo,Utrecht,0,1,-1,L
76823,17,HOL1,2017-12-13,Feyenoord Rotterdam,Heerenveen,1,1,0,D
76824,17,HOL1,2017-12-13,ADO Den Haag,Roda,3,2,1,W
76825,17,HOL1,2017-12-14,Heracles,Sparta Rotterdam,3,2,1,W
76826,17,HOL1,2017-12-14,Ajax Amsterdam,Excelsior,3,1,2,W
76827,17,HOL1,2017-12-16,Heerenveen,NAC Breda,1,0,1,W
76828,17,HOL1,2017-12-16,Willem II,Zwolle,2,3,-1,L
76829,17,HOL1,2017-12-16,PSV Eindhoven,ADO Den Haag,3,0,3,W
76830,17,HOL1,2017-12-16,Twente Enschede,Vitesse,1,1,0,D
76831,17,HOL1,2017-12-16,Roda,VVV Venlo,0,1,-1,L
76832,17,HOL1,2017-12-17,Sparta Rotterdam,Feyenoord Rotterdam,0,7,-7,L
76833,17,HOL1,2017-12-17,Utrecht,Heracles,1,1,0,D
76834,17,HOL1,2017-12-17,AZ Alkmaar,Ajax Amsterdam,1,2,-1,L
76835,17,HOL1,2017-12-17,Excelsior,Groningen,2,0,2,W
76836,17,HOL1,2017-12-22,ADO Den Haag,Zwolle,4,0,4,W
76837,17,HOL1,2017-12-23,NAC Breda,Utrecht,3,1,2,W
76838,17,HOL1,2017-12-23,AZ Alkmaar,Heerenveen,3,1,2,W
76839,17,HOL1,2017-12-23,PSV Eindhoven,Vitesse,2,1,1,W
76840,17,HOL1,2017-12-23,Excelsior,Twente Enschede,0,0,0,D
76841,17,HOL1,2017-12-24,Groningen,Sparta Rotterdam,4,0,4,W
76842,17,HOL1,2017-12-24,VVV Venlo,Heracles,3,1,2,W
76843,17,HOL1,2017-12-24,Ajax Amsterdam,Willem II,3,1,2,W
76844,17,HOL1,2017-12-24,Feyenoord Rotterdam,Roda,5,1,4,W
76845,17,HOL1,2018-01-16,Sparta Rotterdam,Vitesse,0,1,-1,L
76846,17,HOL1,2018-01-19,Utrecht,AZ Alkmaar,1,1,0,D
76847,17,HOL1,2018-01-20,Roda,Twente Enschede,1,1,0,D
76848,17,HOL1,2018-01-20,Zwolle,NAC Breda,1,0,1,W
76849,17,HOL1,2018-01-20,ADO Den Haag,VVV Venlo,1,1,0,D
76850,17,HOL1,2018-01-20,Vitesse,Heerenveen,1,1,0,D
76851,17,HOL1,2018-01-21,Sparta Rotterdam,Excelsior,2,3,-1,L
76852,17,HOL1,2018-01-21,Willem II,Groningen,1,1,0,D
76853,17,HOL1,2018-01-21,Ajax Amsterdam,Feyenoord Rotterdam,2,0,2,W
76854,17,HOL1,2018-01-21,Heracles,PSV Eindhoven,1,2,-1,L
76855,17,HOL1,2018-01-24,Utrecht,Feyenoord Rotterdam,1,1,0,D
76856,17,HOL1,2018-01-26,Heerenveen,Sparta Rotterdam,2,1,1,W
76857,17,HOL1,2018-01-27,Groningen,Heracles,3,3,0,D
76858,17,HOL1,2018-01-27,Twente Enschede,PSV Eindhoven,0,2,-2,L
76859,17,HOL1,2018-01-27,Zwolle,Vitesse,1,2,-1,L
76860,17,HOL1,2018-01-27,NAC Breda,VVV Venlo,0,1,-1,L
76861,17,HOL1,2018-01-28,Utrecht,Ajax Amsterdam,0,0,0,D
76862,17,HOL1,2018-01-28,Feyenoord Rotterdam,ADO Den Haag,3,1,2,W
76863,17,HOL1,2018-01-28,Roda,Excelsior,2,1,1,W
76864,17,HOL1,2018-01-28,Willem II,AZ Alkmaar,0,2,-2,L
76865,17,HOL1,2018-02-02,Vitesse,Groningen,2,0,2,W
76866,17,HOL1,2018-02-03,Heerenveen,Twente Enschede,1,0,1,W
76867,17,HOL1,2018-02-03,PSV Eindhoven,Zwolle,4,0,4,W
76868,17,HOL1,2018-02-03,Heracles,ADO Den Haag,1,1,0,D
76869,17,HOL1,2018-02-04,Excelsior,Utrecht,2,2,0,D
76870,17,HOL1,2018-02-04,AZ Alkmaar,Roda,2,2,0,D
76871,17,HOL1,2018-02-04,Sparta Rotterdam,Willem II,1,0,1,W
76872,17,HOL1,2018-02-04,VVV Venlo,Feyenoord Rotterdam,1,0,1,W
76873,17,HOL1,2018-02-04,Ajax Amsterdam,NAC Breda,3,1,2,W
76874,17,HOL1,2018-02-06,Zwolle,Heerenveen,3,2,1,W
76875,17,HOL1,2018-02-07,Twente Enschede,AZ Alkmaar,0,4,-4,L
76876,17,HOL1,2018-02-07,Utrecht,Sparta Rotterdam,1,0,1,W
76877,17,HOL1,2018-02-07,PSV Eindhoven,Excelsior,1,0,1,W
76878,17,HOL1,2018-02-07,Willem II,VVV Venlo,3,0,3,W
76879,17,HOL1,2018-02-07,NAC Breda,Heracles,6,1,5,W
76880,17,HOL1,2018-02-07,Roda,Ajax Amsterdam,2,4,-2,L
76881,17,HOL1,2018-02-08,ADO Den Haag,Vitesse,1,0,1,W
76882,17,HOL1,2018-02-08,Feyenoord Rotterdam,Groningen,3,0,3,W
76883,17,HOL1,2018-02-10,Heracles,Willem II,1,0,1,W
76884,17,HOL1,2018-02-10,Utrecht,Zwolle,2,1,1,W
76885,17,HOL1,2018-02-10,Sparta Rotterdam,PSV Eindhoven,1,2,-1,L
76886,17,HOL1,2018-02-10,Heerenveen,Roda,1,1,0,D
76887,17,HOL1,2018-02-10,AZ Alkmaar,VVV Venlo,0,0,0,D
76888,17,HOL1,2018-02-11,Ajax Amsterdam,Twente Enschede,2,1,1,W
76889,17,HOL1,2018-02-11,Vitesse,Feyenoord Rotterdam,3,1,2,W
76890,17,HOL1,2018-02-11,Excelsior,NAC Breda,0,0,0,D
76891,17,HOL1,2018-02-11,Groningen,ADO Den Haag,0,0,0,D
76892,17,HOL1,2018-02-16,VVV Venlo,Groningen,1,1,0,D
76893,17,HOL1,2018-02-17,Vitesse,Excelsior,1,2,-1,L
76894,17,HOL1,2018-02-17,NAC Breda,AZ Alkmaar,1,3,-2,L
76895,17,HOL1,2018-02-17,PSV Eindhoven,Heerenveen,2,2,0,D
76896,17,HOL1,2018-02-17,ADO Den Haag,Willem II,2,1,1,W
76897,17,HOL1,2018-02-18,Roda,Utrecht,1,4,-3,L
76898,17,HOL1,2018-02-18,Feyenoord Rotterdam,Heracles,1,0,1,W
76899,17,HOL1,2018-02-18,Twente Enschede,Sparta Rotterdam,1,1,0,D
76900,17,HOL1,2018-02-18,Zwolle,Ajax Amsterdam,0,1,-1,L
76901,17,HOL1,2018-02-23,Groningen,NAC Breda,1,1,0,D
76902,17,HOL1,2018-02-24,AZ Alkmaar,Sparta Rotterdam,2,1,1,W
76903,17,HOL1,2018-02-24,Heerenveen,Excelsior,0,1,-1,L
76904,17,HOL1,2018-02-24,Heracles,Zwolle,2,1,1,W
76905,17,HOL1,2018-02-24,VVV Venlo,Vitesse,2,2,0,D
76906,17,HOL1,2018-02-25,Ajax Amsterdam,ADO Den Haag,0,0,0,D
76907,17,HOL1,2018-02-25,Feyenoord Rotterdam,PSV Eindhoven,1,3,-2,L
76908,17,HOL1,2018-02-25,Willem II,Roda,1,0,1,W
76909,17,HOL1,2018-02-25,Utrecht,Twente Enschede,3,1,2,W
76910,17,HOL1,2018-03-02,Roda,Heracles,0,3,-3,L
76911,17,HOL1,2018-03-03,PSV Eindhoven,Utrecht,3,0,3,W
76912,17,HOL1,2018-03-03,Excelsior,AZ Alkmaar,1,2,-1,L
76913,17,HOL1,2018-03-03,Heerenveen,Willem II,2,0,2,W
76914,17,HOL1,2018-03-03,NAC Breda,Feyenoord Rotterdam,2,1,1,W
76915,17,HOL1,2018-03-04,Zwolle,VVV Venlo,1,1,0,D
76916,17,HOL1,2018-03-04,Sparta Rotterdam,ADO Den Haag,2,1,1,W
76917,17,HOL1,2018-03-04,Vitesse,Ajax Amsterdam,3,2,1,W
76918,17,HOL1,2018-03-04,Twente Enschede,Groningen,1,1,0,D
76919,17,HOL1,2018-03-09,Heracles,Twente Enschede,2,1,1,W
76920,17,HOL1,2018-03-10,ADO Den Haag,NAC Breda,0,2,-2,L
76921,17,HOL1,2018-03-10,VVV Venlo,Excelsior,2,3,-1,L
76922,17,HOL1,2018-03-10,Willem II,PSV Eindhoven,5,0,5,W
76923,17,HOL1,2018-03-10,Roda,Sparta Rotterdam,0,2,-2,L
76924,17,HOL1,2018-03-11,Groningen,Zwolle,2,0,2,W
76925,17,HOL1,2018-03-11,Utrecht,Vitesse,5,1,4,W
76926,17,HOL1,2018-03-11,Ajax Amsterdam,Heerenveen,4,1,3,W
76927,17,HOL1,2018-03-11,Feyenoord Rotterdam,AZ Alkmaar,2,1,1,W
76928,17,HOL1,2018-03-16,Excelsior,ADO Den Haag,1,2,-1,L
76929,17,HOL1,2018-03-17,Twente Enschede,Willem II,2,2,0,D
76930,17,HOL1,2018-03-17,PSV Eindhoven,VVV Venlo,3,0,3,W
76931,17,HOL1,2018-03-17,Vitesse,Heracles,0,0,0,D
76932,17,HOL1,2018-03-17,Heerenveen,Utrecht,2,2,0,D
76933,17,HOL1,2018-03-18,AZ Alkmaar,Groningen,3,2,1,W
76934,17,HOL1,2018-03-18,Sparta Rotterdam,Ajax Amsterdam,2,5,-3,L
76935,17,HOL1,2018-03-18,NAC Breda,Roda,0,1,-1,L
76936,17,HOL1,2018-03-18,Zwolle,Feyenoord Rotterdam,3,4,-1,L
76937,17,HOL1,2018-03-31,Zwolle,Sparta Rotterdam,2,0,2,W
76938,17,HOL1,2018-03-31,Vitesse,Roda,0,3,-3,L
76939,17,HOL1,2018-03-31,PSV Eindhoven,NAC Breda,5,1,4,W
76940,17,HOL1,2018-03-31,Willem II,Utrecht,3,2,1,W
76941,17,HOL1,2018-03-31,ADO Den Haag,AZ Alkmaar,0,3,-3,L
76942,17,HOL1,2018-04-01,VVV Venlo,Twente Enschede,0,0,0,D
76943,17,HOL1,2018-04-01,Heracles,Heerenveen,1,2,-1,L
76944,17,HOL1,2018-04-01,Groningen,Ajax Amsterdam,1,2,-1,L
76945,17,HOL1,2018-04-01,Feyenoord Rotterdam,Excelsior,5,0,5,W
76946,17,HOL1,2018-04-06,Excelsior,Willem II,2,1,1,W
76947,17,HOL1,2018-04-07,NAC Breda,Vitesse,1,0,1,W
76948,17,HOL1,2018-04-07,Roda,Zwolle,3,2,1,W
76949,17,HOL1,2018-04-07,AZ Alkmaar,PSV Eindhoven,2,3,-1,L
76950,17,HOL1,2018-04-07,Sparta Rotterdam,VVV Venlo,3,2,1,W
76951,17,HOL1,2018-04-08,Utrecht,ADO Den Haag,3,3,0,D
76952,17,HOL1,2018-04-08,Twente Enschede,Feyenoord Rotterdam,1,3,-2,L
76953,17,HOL1,2018-04-08,Heerenveen,Groningen,1,1,0,D
76954,17,HOL1,2018-04-08,Ajax Amsterdam,Heracles,1,0,1,W
76955,17,HOL1,2018-04-13,Heracles,AZ Alkmaar,0,3,-3,L
76956,17,HOL1,2018-04-14,ADO Den Haag,Twente Enschede,2,1,1,W
76957,17,HOL1,2018-04-14,Vitesse,Sparta Rotterdam,7,0,7,W
76958,17,HOL1,2018-04-14,VVV Venlo,Heerenveen,0,2,-2,L
76959,17,HOL1,2018-04-14,Zwolle,Excelsior,1,1,0,D
76960,17,HOL1,2018-04-15,NAC Breda,Willem II,1,2,-1,L
76961,17,HOL1,2018-04-15,Feyenoord Rotterdam,Utrecht,3,1,2,W
76962,17,HOL1,2018-04-15,Groningen,Roda,2,1,1,W
76963,17,HOL1,2018-04-15,PSV Eindhoven,Ajax Amsterdam,3,0,3,W
76964,17,HOL1,2018-04-17,Twente Enschede,Zwolle,2,0,2,W
76965,17,HOL1,2018-04-17,Heerenveen,ADO Den Haag,2,0,2,W
76966,17,HOL1,2018-04-18,AZ Alkmaar,Vitesse,4,3,1,W
76967,17,HOL1,2018-04-18,Roda,PSV Eindhoven,2,2,0,D
76968,17,HOL1,2018-04-18,Excelsior,Heracles,2,2,0,D
76969,17,HOL1,2018-04-18,Sparta Rotterdam,NAC Breda,2,1,1,W
76970,17,HOL1,2018-04-18,Willem II,Feyenoord Rotterdam,1,5,-4,L
76971,17,HOL1,2018-04-19,Utrecht,Groningen,1,1,0,D
76972,17,HOL1,2018-04-19,Ajax Amsterdam,VVV Venlo,4,1,3,W
76973,17,HOL1,2018-04-29,Feyenoord Rotterdam,Sparta Rotterdam,3,1,2,W
76974,17,HOL1,2018-04-29,NAC Breda,Heerenveen,3,0,3,W
76975,17,HOL1,2018-04-29,Zwolle,Willem II,0,1,-1,L
76976,17,HOL1,2018-04-29,Ajax Amsterdam,AZ Alkmaar,3,0,3,W
76977,17,HOL1,2018-04-29,Heracles,Utrecht,2,2,0,D
76978,17,HOL1,2018-04-29,Vitesse,Twente Enschede,5,0,5,W
76979,17,HOL1,2018-04-29,VVV Venlo,Roda,1,4,-3,L
76980,17,HOL1,2018-04-29,Groningen,Excelsior,4,0,4,W
76981,17,HOL1,2018-04-29,ADO Den Haag,PSV Eindhoven,3,3,0,D
76982,17,HOL1,2018-05-06,Heerenveen,Feyenoord Rotterdam,2,3,-1,L
76983,17,HOL1,2018-05-06,Utrecht,VVV Venlo,1,0,1,W
76984,17,HOL1,2018-05-06,Sparta Rotterdam,Heracles,2,5,-3,L
76985,17,HOL1,2018-05-06,AZ Alkmaar,Zwolle,6,0,6,W
76986,17,HOL1,2018-05-06,Willem II,Vitesse,2,2,0,D
76987,17,HOL1,2018-05-06,PSV Eindhoven,Groningen,0,0,0,D
76988,17,HOL1,2018-05-06,Excelsior,Ajax Amsterdam,1,2,-1,L
76989,17,HOL1,2018-05-06,Roda,ADO Den Haag,2,3,-1,L
76990,17,HOL1,2018-05-06,Twente Enschede,NAC Breda,1,1,0,D
76991,18,HOL1,2018-08-10,Zwolle,Heerenveen,2,3,-1,L
76992,18,HOL1,2018-08-11,Willem II,VVV Venlo,0,1,-1,L
76993,18,HOL1,2018-08-11,Ajax Amsterdam,Heracles,1,1,0,D
76994,18,HOL1,2018-08-11,PSV Eindhoven,Utrecht,4,0,4,W
76995,18,HOL1,2018-08-11,Excelsior,For Sittard,1,1,0,D
76996,18,HOL1,2018-08-12,ADO Den Haag,FC Emmen,1,2,-1,L
76997,18,HOL1,2018-08-12,De Graafschap,Feyenoord Rotterdam,2,0,2,W
76998,18,HOL1,2018-08-12,Vitesse,Groningen,5,1,4,W
76999,18,HOL1,2018-08-12,AZ Alkmaar,NAC Breda,5,0,5,W
77000,18,HOL1,2018-08-17,Groningen,Willem II,0,1,-1,L
77001,18,HOL1,2018-08-18,NAC Breda,De Graafschap,3,0,3,W
77002,18,HOL1,2018-08-18,VVV Venlo,Ajax Amsterdam,0,1,-1,L
77003,18,HOL1,2018-08-18,For Sittard,PSV Eindhoven,1,2,-1,L
77004,18,HOL1,2018-08-18,Heracles,ADO Den Haag,4,2,2,W
77005,18,HOL1,2018-08-19,Utrecht,Zwolle,2,0,2,W
77006,18,HOL1,2018-08-19,Feyenoord Rotterdam,Excelsior,3,0,3,W
77007,18,HOL1,2018-08-19,FC Emmen,AZ Alkmaar,1,4,-3,L
77008,18,HOL1,2018-08-19,Heerenveen,Vitesse,1,1,0,D
77009,18,HOL1,2018-08-24,ADO Den Haag,For Sittard,3,1,2,W
77010,18,HOL1,2018-08-25,Ajax Amsterdam,FC Emmen,5,0,5,W
77011,18,HOL1,2018-08-25,De Graafschap,Groningen,0,1,-1,L
77012,18,HOL1,2018-08-25,NAC Breda,Excelsior,0,2,-2,L
77013,18,HOL1,2018-08-25,Zwolle,PSV Eindhoven,1,2,-1,L
77014,18,HOL1,2018-08-26,Willem II,Heracles,5,0,5,W
77015,18,HOL1,2018-08-26,Heerenveen,Feyenoord Rotterdam,3,5,-2,L
77016,18,HOL1,2018-08-26,Utrecht,VVV Venlo,1,1,0,D
77017,18,HOL1,2018-08-26,AZ Alkmaar,Vitesse,0,0,0,D
77018,18,HOL1,2018-08-31,FC Emmen,De Graafschap,1,1,0,D
77019,18,HOL1,2018-09-01,VVV Venlo,Heerenveen,1,1,0,D
77020,18,HOL1,2018-09-01,PSV Eindhoven,Willem II,6,1,5,W
77021,18,HOL1,2018-09-01,Excelsior,ADO Den Haag,2,4,-2,L
77022,18,HOL1,2018-09-01,For Sittard,Utrecht,1,1,0,D
77023,18,HOL1,2018-09-02,Groningen,Zwolle,0,1,-1,L
77024,18,HOL1,2018-09-02,Heracles,AZ Alkmaar,3,2,1,W
77025,18,HOL1,2018-09-02,Vitesse,Ajax Amsterdam,0,4,-4,L
77026,18,HOL1,2018-09-02,Feyenoord Rotterdam,NAC Breda,4,2,2,W
77027,18,HOL1,2018-09-15,De Graafschap,VVV Venlo,1,2,-1,L
77028,18,HOL1,2018-09-15,ADO Den Haag,PSV Eindhoven,0,7,-7,L
77029,18,HOL1,2018-09-15,Willem II,Excelsior,2,2,0,D
77030,18,HOL1,2018-09-15,Ajax Amsterdam,Groningen,3,0,3,W
77031,18,HOL1,2018-09-16,AZ Alkmaar,Feyenoord Rotterdam,1,1,0,D
77032,18,HOL1,2018-09-16,Heerenveen,Heracles,3,5,-2,L
77033,18,HOL1,2018-09-16,Utrecht,FC Emmen,1,2,-1,L
77034,18,HOL1,2018-09-16,NAC Breda,For Sittard,2,3,-1,L
77035,18,HOL1,2018-09-16,Zwolle,Vitesse,0,2,-2,L
77036,18,HOL1,2018-09-21,Heracles,De Graafschap,4,0,4,W
77037,18,HOL1,2018-09-22,For Sittard,Willem II,4,4,0,D
77038,18,HOL1,2018-09-22,Excelsior,Heerenveen,3,3,0,D
77039,18,HOL1,2018-09-22,VVV Venlo,NAC Breda,3,0,3,W
77040,18,HOL1,2018-09-22,Vitesse,ADO Den Haag,1,1,0,D
77041,18,HOL1,2018-09-23,Feyenoord Rotterdam,Utrecht,1,0,1,W
77042,18,HOL1,2018-09-23,FC Emmen,Zwolle,0,1,-1,L
77043,18,HOL1,2018-09-23,Groningen,AZ Alkmaar,1,3,-2,L
77044,18,HOL1,2018-09-23,PSV Eindhoven,Ajax Amsterdam,3,0,3,W
77045,18,HOL1,2018-09-29,Heerenveen,ADO Den Haag,1,1,0,D
77046,18,HOL1,2018-09-29,NAC Breda,PSV Eindhoven,0,2,-2,L
77047,18,HOL1,2018-09-29,For Sittard,Ajax Amsterdam,0,2,-2,L
77048,18,HOL1,2018-09-29,Excelsior,VVV Venlo,1,0,1,W
77049,18,HOL1,2018-09-30,Heracles,FC Emmen,2,1,1,W
77050,18,HOL1,2018-09-30,De Graafschap,Willem II,2,1,1,W
77051,18,HOL1,2018-09-30,AZ Alkmaar,Zwolle,2,2,0,D
77052,18,HOL1,2018-09-30,Groningen,Utrecht,1,1,0,D
77053,18,HOL1,2018-09-30,Feyenoord Rotterdam,Vitesse,2,1,1,W
77054,18,HOL1,2018-10-05,Utrecht,NAC Breda,2,1,1,W
77055,18,HOL1,2018-10-06,ADO Den Haag,Groningen,1,0,1,W
77056,18,HOL1,2018-10-06,Zwolle,Excelsior,2,0,2,W
77057,18,HOL1,2018-10-06,PSV Eindhoven,VVV Venlo,4,0,4,W
77058,18,HOL1,2018-10-06,De Graafschap,Heerenveen,0,5,-5,L
77059,18,HOL1,2018-10-07,FC Emmen,For Sittard,3,3,0,D
77060,18,HOL1,2018-10-07,Willem II,Feyenoord Rotterdam,1,1,0,D
77061,18,HOL1,2018-10-07,Vitesse,Heracles,4,0,4,W
77062,18,HOL1,2018-10-07,Ajax Amsterdam,AZ Alkmaar,5,0,5,W
77063,18,HOL1,2018-10-20,PSV Eindhoven,FC Emmen,6,0,6,W
77064,18,HOL1,2018-10-20,Excelsior,Vitesse,2,0,2,W
77065,18,HOL1,2018-10-20,Heerenveen,Ajax Amsterdam,0,4,-4,L
77066,18,HOL1,2018-10-20,Utrecht,AZ Alkmaar,2,1,1,W
77067,18,HOL1,2018-10-21,NAC Breda,Willem II,2,2,0,D
77068,18,HOL1,2018-10-21,Heracles,Groningen,4,1,3,W
77069,18,HOL1,2018-10-21,Feyenoord Rotterdam,Zwolle,3,0,3,W
77070,18,HOL1,2018-10-21,VVV Venlo,ADO Den Haag,2,0,2,W
77071,18,HOL1,2018-10-21,For Sittard,De Graafschap,3,1,2,W
77072,18,HOL1,2018-10-26,FC Emmen,VVV Venlo,1,1,0,D
77073,18,HOL1,2018-10-27,ADO Den Haag,NAC Breda,1,1,0,D
77074,18,HOL1,2018-10-27,De Graafschap,Excelsior,4,1,3,W
77075,18,HOL1,2018-10-27,Groningen,PSV Eindhoven,1,2,-1,L
77076,18,HOL1,2018-10-27,Zwolle,Heracles,1,1,0,D
77077,18,HOL1,2018-10-28,Vitesse,For Sittard,2,1,1,W
77078,18,HOL1,2018-10-28,Willem II,Utrecht,0,1,-1,L
77079,18,HOL1,2018-10-28,Ajax Amsterdam,Feyenoord Rotterdam,3,0,3,W
77080,18,HOL1,2018-10-28,AZ Alkmaar,Heerenveen,2,3,-1,L
77081,18,HOL1,2018-11-02,Excelsior,Groningen,2,4,-2,L
77082,18,HOL1,2018-11-03,NAC Breda,Heracles,2,1,1,W
77083,18,HOL1,2018-11-03,PSV Eindhoven,Vitesse,1,0,1,W
77084,18,HOL1,2018-11-03,Ajax Amsterdam,Willem II,2,0,2,W
77085,18,HOL1,2018-11-03,AZ Alkmaar,De Graafschap,1,0,1,W
77086,18,HOL1,2018-11-04,Heerenveen,FC Emmen,1,1,0,D
77087,18,HOL1,2018-11-04,Utrecht,ADO Den Haag,3,0,3,W
77088,18,HOL1,2018-11-04,For Sittard,Zwolle,3,0,3,W
77089,18,HOL1,2018-11-09,Zwolle,Willem II,2,3,-1,L
77090,18,HOL1,2018-11-10,FC Emmen,NAC Breda,2,0,2,W
77091,18,HOL1,2018-11-10,De Graafschap,PSV Eindhoven,1,4,-3,L
77092,18,HOL1,2018-11-10,Vitesse,Utrecht,2,1,1,W
77093,18,HOL1,2018-11-10,VVV Venlo,For Sittard,3,2,1,W
77094,18,HOL1,2018-11-11,Groningen,Heerenveen,2,0,2,W
77095,18,HOL1,2018-11-11,Excelsior,Ajax Amsterdam,1,7,-6,L
77096,18,HOL1,2018-11-11,ADO Den Haag,AZ Alkmaar,0,1,-1,L
77097,18,HOL1,2018-11-11,Heracles,Feyenoord Rotterdam,0,2,-2,L
77098,18,HOL1,2018-11-24,Zwolle,ADO Den Haag,2,3,-1,L
77099,18,HOL1,2018-11-24,NAC Breda,Ajax Amsterdam,0,3,-3,L
77100,18,HOL1,2018-11-24,PSV Eindhoven,Heerenveen,3,0,3,W
77101,18,HOL1,2018-11-24,For Sittard,Heracles,3,0,3,W
77102,18,HOL1,2018-11-25,FC Emmen,Excelsior,1,2,-1,L
77103,18,HOL1,2018-11-25,Utrecht,De Graafschap,5,0,5,W
77104,18,HOL1,2018-11-25,Feyenoord Rotterdam,Groningen,1,0,1,W
77105,18,HOL1,2018-11-25,Willem II,Vitesse,1,3,-2,L
77106,18,HOL1,2018-11-25,VVV Venlo,AZ Alkmaar,2,2,0,D
77107,18,HOL1,2018-11-30,Excelsior,Utrecht,3,3,0,D
77108,18,HOL1,2018-12-01,Vitesse,FC Emmen,1,1,0,D
77109,18,HOL1,2018-12-01,AZ Alkmaar,Willem II,0,2,-2,L
77110,18,HOL1,2018-12-01,De Graafschap,Zwolle,0,2,-2,L
77111,18,HOL1,2018-12-01,Heerenveen,For Sittard,3,1,2,W
77112,18,HOL1,2018-12-02,Ajax Amsterdam,ADO Den Haag,5,1,4,W
77113,18,HOL1,2018-12-02,Feyenoord Rotterdam,PSV Eindhoven,2,1,1,W
77114,18,HOL1,2018-12-02,Heracles,VVV Venlo,4,1,3,W
77115,18,HOL1,2018-12-02,Groningen,NAC Breda,5,2,3,W
77116,18,HOL1,2018-12-06,Feyenoord Rotterdam,VVV Venlo,4,1,3,W
77117,18,HOL1,2018-12-07,For Sittard,AZ Alkmaar,0,3,-3,L
77118,18,HOL1,2018-12-07,PSV Eindhoven,Excelsior,6,0,6,W
77119,18,HOL1,2018-12-08,Willem II,Heerenveen,1,5,-4,L
77120,18,HOL1,2018-12-08,Zwolle,Ajax Amsterdam,1,4,-3,L
77121,18,HOL1,2018-12-08,ADO Den Haag,De Graafschap,0,0,0,D
77122,18,HOL1,2018-12-09,Utrecht,Heracles,3,1,2,W
77123,18,HOL1,2018-12-09,VVV Venlo,Groningen,0,0,0,D
77124,18,HOL1,2018-12-09,FC Emmen,Feyenoord Rotterdam,1,4,-3,L
77125,18,HOL1,2018-12-09,NAC Breda,Vitesse,2,1,1,W
77126,18,HOL1,2018-12-14,Willem II,ADO Den Haag,0,3,-3,L
77127,18,HOL1,2018-12-15,Zwolle,NAC Breda,0,0,0,D
77128,18,HOL1,2018-12-15,AZ Alkmaar,Excelsior,2,1,1,W
77129,18,HOL1,2018-12-15,Heracles,PSV Eindhoven,0,4,-4,L
77130,18,HOL1,2018-12-15,Vitesse,VVV Venlo,2,1,1,W
77131,18,HOL1,2018-12-16,Heerenveen,Utrecht,2,3,-1,L
77132,18,HOL1,2018-12-16,Ajax Amsterdam,De Graafschap,8,0,8,W
77133,18,HOL1,2018-12-16,Groningen,FC Emmen,1,2,-1,L
77134,18,HOL1,2018-12-16,Feyenoord Rotterdam,For Sittard,0,2,-2,L
77135,18,HOL1,2018-12-21,VVV Venlo,Zwolle,2,0,2,W
77136,18,HOL1,2018-12-22,For Sittard,Groningen,0,0,0,D
77137,18,HOL1,2018-12-22,NAC Breda,Heerenveen,4,2,2,W
77138,18,HOL1,2018-12-22,PSV Eindhoven,AZ Alkmaar,3,1,2,W
77139,18,HOL1,2018-12-22,Excelsior,Heracles,0,3,-3,L
77140,18,HOL1,2018-12-23,Utrecht,Ajax Amsterdam,1,3,-2,L
77141,18,HOL1,2018-12-23,De Graafschap,Vitesse,2,2,0,D
77142,18,HOL1,2018-12-23,ADO Den Haag,Feyenoord Rotterdam,2,2,0,D
77143,18,HOL1,2018-12-23,FC Emmen,Willem II,0,2,-2,L
77144,18,HOL1,2019-01-18,Vitesse,Excelsior,3,2,1,W
77145,18,HOL1,2019-01-19,AZ Alkmaar,Utrecht,3,0,3,W
77146,18,HOL1,2019-01-19,Zwolle,Feyenoord Rotterdam,3,1,2,W
77147,18,HOL1,2019-01-19,ADO Den Haag,VVV Venlo,2,4,-2,L
77148,18,HOL1,2019-01-19,Groningen,Heracles,3,0,3,W
77149,18,HOL1,2019-01-20,Willem II,NAC Breda,2,0,2,W
77150,18,HOL1,2019-01-20,De Graafschap,For Sittard,5,1,4,W
77151,18,HOL1,2019-01-20,FC Emmen,PSV Eindhoven,2,2,0,D
77152,18,HOL1,2019-01-20,Ajax Amsterdam,Heerenveen,4,4,0,D
77153,18,HOL1,2019-01-25,NAC Breda,ADO Den Haag,1,1,0,D
77154,18,HOL1,2019-01-26,Heracles,Zwolle,0,2,-2,L
77155,18,HOL1,2019-01-26,Excelsior,De Graafschap,2,0,2,W
77156,18,HOL1,2019-01-26,PSV Eindhoven,Groningen,2,1,1,W
77157,18,HOL1,2019-01-26,VVV Venlo,FC Emmen,2,3,-1,L
77158,18,HOL1,2019-01-27,For Sittard,Vitesse,2,1,1,W
77159,18,HOL1,2019-01-27,Utrecht,Willem II,0,1,-1,L
77160,18,HOL1,2019-01-27,Feyenoord Rotterdam,Ajax Amsterdam,6,2,4,W
77161,18,HOL1,2019-01-27,Heerenveen,AZ Alkmaar,0,2,-2,L
77162,18,HOL1,2019-02-01,De Graafschap,NAC Breda,3,0,3,W
77163,18,HOL1,2019-02-02,Vitesse,Heerenveen,2,2,0,D
77164,18,HOL1,2019-02-02,Willem II,Groningen,1,2,-1,L
77165,18,HOL1,2019-02-02,Ajax Amsterdam,VVV Venlo,6,0,6,W
77166,18,HOL1,2019-02-02,AZ Alkmaar,FC Emmen,5,0,5,W
77167,18,HOL1,2019-02-03,Excelsior,Feyenoord Rotterdam,2,1,1,W
77168,18,HOL1,2019-02-03,Zwolle,Utrecht,4,3,1,W
77169,18,HOL1,2019-02-03,PSV Eindhoven,For Sittard,5,0,5,W
77170,18,HOL1,2019-02-03,ADO Den Haag,Heracles,2,0,2,W
77171,18,HOL1,2019-02-08,NAC Breda,AZ Alkmaar,0,3,-3,L
77172,18,HOL1,2019-02-09,Heracles,Ajax Amsterdam,1,0,1,W
77173,18,HOL1,2019-02-09,Heerenveen,Zwolle,1,1,0,D
77174,18,HOL1,2019-02-09,VVV Venlo,Willem II,2,1,1,W
77175,18,HOL1,2019-02-09,Feyenoord Rotterdam,De Graafschap,4,0,4,W
77176,18,HOL1,2019-02-10,For Sittard,Excelsior,4,1,3,W
77177,18,HOL1,2019-02-10,Groningen,Vitesse,2,1,1,W
77178,18,HOL1,2019-02-10,FC Emmen,ADO Den Haag,3,2,1,W
77179,18,HOL1,2019-02-10,Utrecht,PSV Eindhoven,2,2,0,D
77180,18,HOL1,2019-02-15,ADO Den Haag,Zwolle,1,0,1,W
77181,18,HOL1,2019-02-16,AZ Alkmaar,VVV Venlo,3,0,3,W
77182,18,HOL1,2019-02-16,Heerenveen,PSV Eindhoven,2,2,0,D
77183,18,HOL1,2019-02-16,Heracles,For Sittard,6,0,6,W
77184,18,HOL1,2019-02-16,Vitesse,Willem II,3,2,1,W
77185,18,HOL1,2019-02-17,Ajax Amsterdam,NAC Breda,5,0,5,W
77186,18,HOL1,2019-02-17,Excelsior,FC Emmen,2,1,1,W
77187,18,HOL1,2019-02-17,Groningen,Feyenoord Rotterdam,1,0,1,W
77188,18,HOL1,2019-02-17,De Graafschap,Utrecht,0,1,-1,L
77189,18,HOL1,2019-02-22,VVV Venlo,Heracles,0,1,-1,L
77190,18,HOL1,2019-02-23,Utrecht,Excelsior,0,0,0,D
77191,18,HOL1,2019-02-23,Zwolle,De Graafschap,0,3,-3,L
77192,18,HOL1,2019-02-23,For Sittard,Heerenveen,2,4,-2,L
77193,18,HOL1,2019-02-23,NAC Breda,Groningen,0,0,0,D
77194,18,HOL1,2019-02-24,ADO Den Haag,Ajax Amsterdam,1,5,-4,L
77195,18,HOL1,2019-02-24,PSV Eindhoven,Feyenoord Rotterdam,1,1,0,D
77196,18,HOL1,2019-02-24,FC Emmen,Vitesse,0,3,-3,L
77197,18,HOL1,2019-02-24,Willem II,AZ Alkmaar,2,1,1,W
77198,18,HOL1,2019-03-01,De Graafschap,ADO Den Haag,1,1,0,D
77199,18,HOL1,2019-03-02,Heracles,Utrecht,1,5,-4,L
77200,18,HOL1,2019-03-02,Excelsior,PSV Eindhoven,0,2,-2,L
77201,18,HOL1,2019-03-02,Vitesse,NAC Breda,4,1,3,W
77202,18,HOL1,2019-03-03,Heerenveen,Willem II,4,2,2,W
77203,18,HOL1,2019-03-03,Groningen,VVV Venlo,3,2,1,W
77204,18,HOL1,2019-03-03,AZ Alkmaar,For Sittard,4,2,2,W
77205,18,HOL1,2019-03-03,Feyenoord Rotterdam,FC Emmen,4,0,4,W
77206,18,HOL1,2019-03-08,Utrecht,Groningen,0,0,0,D
77207,18,HOL1,2019-03-09,VVV Venlo,Excelsior,1,0,1,W
77208,18,HOL1,2019-03-09,PSV Eindhoven,NAC Breda,2,0,2,W
77209,18,HOL1,2019-03-09,ADO Den Haag,Heerenveen,2,3,-1,L
77210,18,HOL1,2019-03-09,Willem II,De Graafschap,3,2,1,W
77211,18,HOL1,2019-03-10,Zwolle,AZ Alkmaar,0,0,0,D
77212,18,HOL1,2019-03-10,Vitesse,Feyenoord Rotterdam,1,1,0,D
77213,18,HOL1,2019-03-10,FC Emmen,Heracles,1,1,0,D
77214,18,HOL1,2019-03-10,Ajax Amsterdam,For Sittard,4,0,4,W
77215,18,HOL1,2019-03-13,Ajax Amsterdam,Zwolle,2,1,1,W
77216,18,HOL1,2019-03-15,For Sittard,FC Emmen,3,1,2,W
77217,18,HOL1,2019-03-16,Heerenveen,De Graafschap,0,3,-3,L
77218,18,HOL1,2019-03-16,Feyenoord Rotterdam,Willem II,2,3,-1,L
77219,18,HOL1,2019-03-16,NAC Breda,Utrecht,0,4,-4,L
77220,18,HOL1,2019-03-16,Heracles,Vitesse,3,2,1,W
77221,18,HOL1,2019-03-17,VVV Venlo,PSV Eindhoven,0,1,-1,L
77222,18,HOL1,2019-03-17,AZ Alkmaar,Ajax Amsterdam,1,0,1,W
77223,18,HOL1,2019-03-17,Groningen,ADO Den Haag,1,0,1,W
77224,18,HOL1,2019-03-17,Excelsior,Zwolle,0,2,-2,L
77225,18,HOL1,2019-03-30,Willem II,For Sittard,3,2,1,W
77226,18,HOL1,2019-03-30,ADO Den Haag,Vitesse,3,3,0,D
77227,18,HOL1,2019-03-30,De Graafschap,Heracles,1,2,-1,L
77228,18,HOL1,2019-03-30,Heerenveen,Excelsior,1,0,1,W
77229,18,HOL1,2019-03-30,AZ Alkmaar,Groningen,1,0,1,W
77230,18,HOL1,2019-03-31,NAC Breda,VVV Venlo,1,1,0,D
77231,18,HOL1,2019-03-31,Utrecht,Feyenoord Rotterdam,3,2,1,W
77232,18,HOL1,2019-03-31,Zwolle,FC Emmen,3,0,3,W
77233,18,HOL1,2019-03-31,Ajax Amsterdam,PSV Eindhoven,3,1,2,W
77234,18,HOL1,2019-04-02,Vitesse,AZ Alkmaar,2,2,0,D
77235,18,HOL1,2019-04-02,Heracles,Willem II,3,4,-1,L
77236,18,HOL1,2019-04-02,Groningen,De Graafschap,1,0,1,W
77237,18,HOL1,2019-04-03,VVV Venlo,Utrecht,2,6,-4,L
77238,18,HOL1,2019-04-03,Excelsior,NAC Breda,1,2,-1,L
77239,18,HOL1,2019-04-03,For Sittard,ADO Den Haag,0,0,0,D
77240,18,HOL1,2019-04-03,FC Emmen,Ajax Amsterdam,2,5,-3,L
77241,18,HOL1,2019-04-04,PSV Eindhoven,Zwolle,4,0,4,W
77242,18,HOL1,2019-04-04,Feyenoord Rotterdam,Heerenveen,3,0,3,W
77243,18,HOL1,2019-04-06,Willem II,Ajax Amsterdam,1,4,-3,L
77244,18,HOL1,2019-04-06,ADO Den Haag,Utrecht,5,0,5,W
77245,18,HOL1,2019-04-06,Groningen,Excelsior,1,0,1,W
77246,18,HOL1,2019-04-06,De Graafschap,AZ Alkmaar,1,1,0,D
77247,18,HOL1,2019-04-06,Heracles,NAC Breda,1,0,1,W
77248,18,HOL1,2019-04-07,FC Emmen,Heerenveen,2,0,2,W
77249,18,HOL1,2019-04-07,Zwolle,For Sittard,5,0,5,W
77250,18,HOL1,2019-04-07,VVV Venlo,Feyenoord Rotterdam,0,3,-3,L
77251,18,HOL1,2019-04-07,Vitesse,PSV Eindhoven,3,3,0,D
77252,18,HOL1,2019-04-12,NAC Breda,FC Emmen,1,1,0,D
77253,18,HOL1,2019-04-13,AZ Alkmaar,ADO Den Haag,2,3,-1,L
77254,18,HOL1,2019-04-13,Ajax Amsterdam,Excelsior,6,2,4,W
77255,18,HOL1,2019-04-13,Feyenoord Rotterdam,Heracles,2,1,1,W
77256,18,HOL1,2019-04-13,For Sittard,VVV Venlo,1,1,0,D
77257,18,HOL1,2019-04-14,PSV Eindhoven,De Graafschap,2,1,1,W
77258,18,HOL1,2019-04-14,Willem II,Zwolle,2,0,2,W
77259,18,HOL1,2019-04-14,Heerenveen,Groningen,1,1,0,D
77260,18,HOL1,2019-04-14,Utrecht,Vitesse,0,0,0,D
77261,18,HOL1,2019-04-19,Heracles,Heerenveen,2,1,1,W
77262,18,HOL1,2019-04-20,FC Emmen,Utrecht,2,0,2,W
77263,18,HOL1,2019-04-20,Groningen,Ajax Amsterdam,0,1,-1,L
77264,18,HOL1,2019-04-20,Vitesse,Zwolle,4,1,3,W
77265,18,HOL1,2019-04-20,Feyenoord Rotterdam,AZ Alkmaar,2,1,1,W
77266,18,HOL1,2019-04-20,VVV Venlo,De Graafschap,4,1,3,W
77267,18,HOL1,2019-04-21,Excelsior,Willem II,1,1,0,D
77268,18,HOL1,2019-04-21,For Sittard,NAC Breda,2,1,1,W
77269,18,HOL1,2019-04-21,PSV Eindhoven,ADO Den Haag,3,1,2,W
77270,18,HOL1,2019-04-23,De Graafschap,FC Emmen,1,0,1,W
77271,18,HOL1,2019-04-23,Heerenveen,VVV Venlo,2,2,0,D
77272,18,HOL1,2019-04-23,AZ Alkmaar,Heracles,2,1,1,W
77273,18,HOL1,2019-04-23,Ajax Amsterdam,Vitesse,4,2,2,W
77274,18,HOL1,2019-04-24,Utrecht,For Sittard,2,1,1,W
77275,18,HOL1,2019-04-24,NAC Breda,Feyenoord Rotterdam,0,4,-4,L
77276,18,HOL1,2019-04-25,ADO Den Haag,Excelsior,3,1,2,W
77277,18,HOL1,2019-04-25,Willem II,PSV Eindhoven,0,3,-3,L
77278,18,HOL1,2019-04-29,Zwolle,Groningen,3,2,1,W
77279,18,HOL1,2019-05-12,Heerenveen,NAC Breda,2,1,1,W
77280,18,HOL1,2019-05-12,Feyenoord Rotterdam,ADO Den Haag,0,2,-2,L
77281,18,HOL1,2019-05-12,AZ Alkmaar,PSV Eindhoven,1,0,1,W
77282,18,HOL1,2019-05-12,Willem II,FC Emmen,2,3,-1,L
77283,18,HOL1,2019-05-12,Zwolle,VVV Venlo,2,4,-2,L
77284,18,HOL1,2019-05-12,Ajax Amsterdam,Utrecht,4,1,3,W
77285,18,HOL1,2019-05-12,Heracles,Excelsior,4,5,-1,L
77286,18,HOL1,2019-05-12,Vitesse,De Graafschap,6,1,5,W
77287,18,HOL1,2019-05-12,Groningen,For Sittard,3,0,3,W
77288,18,HOL1,2019-05-15,Utrecht,Heerenveen,3,1,2,W
77289,18,HOL1,2019-05-15,NAC Breda,Zwolle,0,0,0,D
77290,18,HOL1,2019-05-15,PSV Eindhoven,Heracles,3,1,2,W
77291,18,HOL1,2019-05-15,For Sittard,Feyenoord Rotterdam,1,4,-3,L
77292,18,HOL1,2019-05-15,Excelsior,AZ Alkmaar,4,2,2,W
77293,18,HOL1,2019-05-15,De Graafschap,Ajax Amsterdam,1,4,-3,L
77294,18,HOL1,2019-05-15,VVV Venlo,Vitesse,1,3,-2,L
77295,18,HOL1,2019-05-15,ADO Den Haag,Willem II,6,2,4,W
77296,18,HOL1,2019-05-15,FC Emmen,Groningen,1,0,1,W
77297,19,HOL1,2019-08-02,Zwolle,Willem II,1,3,-2,L
77298,19,HOL1,2019-08-03,Vitesse,Ajax Amsterdam,2,2,0,D
77299,19,HOL1,2019-08-03,FC Emmen,Groningen,0,1,-1,L
77300,19,HOL1,2019-08-03,VVV Venlo,Waalwijk,3,1,2,W
77301,19,HOL1,2019-08-03,Twente Enschede,PSV Eindhoven,1,1,0,D
77302,19,HOL1,2019-08-04,Heracles,Heerenveen,0,4,-4,L
77303,19,HOL1,2019-08-04,Feyenoord Rotterdam,Sparta Rotterdam,2,2,0,D
77304,19,HOL1,2019-08-04,ADO Den Haag,Utrecht,2,4,-2,L
77305,19,HOL1,2019-08-04,AZ Alkmaar,For Sittard,4,0,4,W
77306,19,HOL1,2019-08-09,Sparta Rotterdam,VVV Venlo,4,1,3,W
77307,19,HOL1,2019-08-10,Groningen,Twente Enschede,1,3,-2,L
77308,19,HOL1,2019-08-10,Ajax Amsterdam,FC Emmen,5,0,5,W
77309,19,HOL1,2019-08-10,Willem II,Vitesse,0,2,-2,L
77310,19,HOL1,2019-08-11,For Sittard,Heracles,1,1,0,D
77311,19,HOL1,2019-08-11,Heerenveen,Feyenoord Rotterdam,1,1,0,D
77312,19,HOL1,2019-08-11,Waalwijk,AZ Alkmaar,0,2,-2,L
77313,19,HOL1,2019-08-11,Utrecht,Zwolle,3,1,2,W
77314,19,HOL1,2019-08-11,PSV Eindhoven,ADO Den Haag,3,1,2,W
77315,19,HOL1,2019-08-16,Vitesse,Zwolle,3,0,3,W
77316,19,HOL1,2019-08-17,ADO Den Haag,Sparta Rotterdam,1,2,-1,L
77317,19,HOL1,2019-08-17,VVV Venlo,Ajax Amsterdam,1,4,-3,L
77318,19,HOL1,2019-08-17,FC Emmen,Heerenveen,2,0,2,W
77319,19,HOL1,2019-08-18,For Sittard,Willem II,2,3,-1,L
77320,19,HOL1,2019-08-18,Twente Enschede,Waalwijk,3,3,0,D
77321,19,HOL1,2019-08-18,Feyenoord Rotterdam,Utrecht,1,1,0,D
77322,19,HOL1,2019-08-18,AZ Alkmaar,Groningen,0,0,0,D
77323,19,HOL1,2019-08-18,Heracles,PSV Eindhoven,0,2,-2,L
77324,19,HOL1,2019-08-24,Willem II,FC Emmen,2,1,1,W
77325,19,HOL1,2019-08-24,Heracles,Vitesse,1,1,0,D
77326,19,HOL1,2019-08-24,Heerenveen,Twente Enschede,0,0,0,D
77327,19,HOL1,2019-08-25,Waalwijk,ADO Den Haag,0,3,-3,L
77328,19,HOL1,2019-08-25,Utrecht,VVV Venlo,1,2,-1,L
77329,19,HOL1,2019-08-25,Zwolle,Sparta Rotterdam,2,2,0,D
77330,19,HOL1,2019-08-30,FC Emmen,Zwolle,1,3,-2,L
77331,19,HOL1,2019-08-31,Heerenveen,For Sittard,1,1,0,D
77332,19,HOL1,2019-08-31,Groningen,Heracles,1,2,-1,L
77333,19,HOL1,2019-08-31,ADO Den Haag,VVV Venlo,1,0,1,W
77334,19,HOL1,2019-09-01,Twente Enschede,Utrecht,3,1,2,W
77335,19,HOL1,2019-09-01,Sparta Rotterdam,Ajax Amsterdam,1,4,-3,L
77336,19,HOL1,2019-09-01,Willem II,Feyenoord Rotterdam,0,1,-1,L
77337,19,HOL1,2019-09-01,Vitesse,AZ Alkmaar,2,1,1,W
77338,19,HOL1,2019-09-01,Waalwijk,PSV Eindhoven,1,3,-2,L
77339,19,HOL1,2019-09-14,AZ Alkmaar,Sparta Rotterdam,5,1,4,W
77340,19,HOL1,2019-09-14,Ajax Amsterdam,Heerenveen,4,1,3,W
77341,19,HOL1,2019-09-14,VVV Venlo,Groningen,2,1,1,W
77342,19,HOL1,2019-09-14,PSV Eindhoven,Vitesse,5,0,5,W
77343,19,HOL1,2019-09-14,Utrecht,FC Emmen,3,1,2,W
77344,19,HOL1,2019-09-15,Zwolle,Waalwijk,6,2,4,W
77345,19,HOL1,2019-09-15,Feyenoord Rotterdam,ADO Den Haag,3,2,1,W
77346,19,HOL1,2019-09-15,Heracles,Willem II,4,1,3,W
77347,19,HOL1,2019-09-15,For Sittard,Twente Enschede,2,3,-1,L
77348,19,HOL1,2019-09-20,Twente Enschede,Heracles,2,3,-1,L
77349,19,HOL1,2019-09-21,Sparta Rotterdam,Waalwijk,4,0,4,W
77350,19,HOL1,2019-09-21,Groningen,Zwolle,2,0,2,W
77351,19,HOL1,2019-09-21,Willem II,VVV Venlo,1,0,1,W
77352,19,HOL1,2019-09-21,Vitesse,For Sittard,4,2,2,W
77353,19,HOL1,2019-09-22,Heerenveen,Utrecht,1,1,0,D
77354,19,HOL1,2019-09-22,FC Emmen,Feyenoord Rotterdam,3,3,0,D
77355,19,HOL1,2019-09-22,ADO Den Haag,AZ Alkmaar,0,1,-1,L
77356,19,HOL1,2019-09-22,PSV Eindhoven,Ajax Amsterdam,1,1,0,D
77357,19,HOL1,2019-09-25,PSV Eindhoven,Groningen,3,1,2,W
77358,19,HOL1,2019-09-25,Ajax Amsterdam,For Sittard,5,0,5,W
77359,19,HOL1,2019-09-26,Feyenoord Rotterdam,AZ Alkmaar,0,3,-3,L
77360,19,HOL1,2019-09-27,FC Emmen,ADO Den Haag,3,0,3,W
77361,19,HOL1,2019-09-28,VVV Venlo,Heerenveen,0,3,-3,L
77362,19,HOL1,2019-09-28,Ajax Amsterdam,Groningen,2,0,2,W
77363,19,HOL1,2019-09-28,For Sittard,Sparta Rotterdam,0,0,0,D
77364,19,HOL1,2019-09-29,Waalwijk,Vitesse,1,2,-1,L
77365,19,HOL1,2019-09-29,Zwolle,PSV Eindhoven,0,4,-4,L
77366,19,HOL1,2019-09-29,Utrecht,Willem II,2,0,2,W
77367,19,HOL1,2019-09-29,AZ Alkmaar,Heracles,2,0,2,W
77368,19,HOL1,2019-09-29,Feyenoord Rotterdam,Twente Enschede,5,1,4,W
77369,19,HOL1,2019-10-04,Groningen,Waalwijk,3,0,3,W
77370,19,HOL1,2019-10-05,Heracles,FC Emmen,2,0,2,W
77371,19,HOL1,2019-10-05,Sparta Rotterdam,Twente Enschede,2,1,1,W
77372,19,HOL1,2019-10-05,Vitesse,Utrecht,2,1,1,W
77373,19,HOL1,2019-10-05,Heerenveen,Zwolle,1,0,1,W
77374,19,HOL1,2019-10-06,ADO Den Haag,Ajax Amsterdam,0,2,-2,L
77375,19,HOL1,2019-10-06,For Sittard,Feyenoord Rotterdam,4,2,2,W
77376,19,HOL1,2019-10-06,PSV Eindhoven,VVV Venlo,4,1,3,W
77377,19,HOL1,2019-10-06,Willem II,AZ Alkmaar,1,1,0,D
77378,19,HOL1,2019-10-19,AZ Alkmaar,Heerenveen,2,4,-2,L
77379,19,HOL1,2019-10-19,Waalwijk,Ajax Amsterdam,1,2,-1,L
77380,19,HOL1,2019-10-19,Twente Enschede,Willem II,0,1,-1,L
77381,19,HOL1,2019-10-19,Utrecht,PSV Eindhoven,3,0,3,W
77382,19,HOL1,2019-10-19,VVV Venlo,Vitesse,0,4,-4,L
77383,19,HOL1,2019-10-20,Zwolle,ADO Den Haag,3,1,2,W
77384,19,HOL1,2019-10-20,FC Emmen,For Sittard,2,1,1,W
77385,19,HOL1,2019-10-20,Groningen,Sparta Rotterdam,2,0,2,W
77386,19,HOL1,2019-10-20,Feyenoord Rotterdam,Heracles,1,1,0,D
77387,19,HOL1,2019-10-25,Twente Enschede,FC Emmen,4,1,3,W
77388,19,HOL1,2019-10-26,Willem II,Waalwijk,2,1,1,W
77389,19,HOL1,2019-10-26,For Sittard,VVV Venlo,4,1,3,W
77390,19,HOL1,2019-10-26,Vitesse,ADO Den Haag,0,2,-2,L
77391,19,HOL1,2019-10-26,Heracles,Zwolle,4,0,4,W
77392,19,HOL1,2019-10-27,Heerenveen,Groningen,1,1,0,D
77393,19,HOL1,2019-10-27,PSV Eindhoven,AZ Alkmaar,0,4,-4,L
77394,19,HOL1,2019-10-27,Sparta Rotterdam,Utrecht,1,2,-1,L
77395,19,HOL1,2019-10-27,Ajax Amsterdam,Feyenoord Rotterdam,4,0,4,W
77396,19,HOL1,2019-11-01,Zwolle,Ajax Amsterdam,2,4,-2,L
77397,19,HOL1,2019-11-02,Waalwijk,Heracles,2,0,2,W
77398,19,HOL1,2019-11-02,Sparta Rotterdam,PSV Eindhoven,2,2,0,D
77399,19,HOL1,2019-11-02,AZ Alkmaar,Twente Enschede,3,0,3,W
77400,19,HOL1,2019-11-03,FC Emmen,Vitesse,2,1,1,W
77401,19,HOL1,2019-11-03,Utrecht,For Sittard,6,0,6,W
77402,19,HOL1,2019-11-03,VVV Venlo,Feyenoord Rotterdam,0,3,-3,L
77403,19,HOL1,2019-11-03,Groningen,Willem II,2,0,2,W
77404,19,HOL1,2019-11-03,ADO Den Haag,Heerenveen,1,1,0,D
77405,19,HOL1,2019-11-08,Vitesse,Groningen,1,2,-1,L
77406,19,HOL1,2019-11-09,Heerenveen,Sparta Rotterdam,2,1,1,W
77407,19,HOL1,2019-11-09,For Sittard,ADO Den Haag,1,0,1,W
77408,19,HOL1,2019-11-09,Heracles,VVV Venlo,6,1,5,W
77409,19,HOL1,2019-11-10,Ajax Amsterdam,Utrecht,4,0,4,W
77410,19,HOL1,2019-11-10,Willem II,PSV Eindhoven,2,1,1,W
77411,19,HOL1,2019-11-10,Twente Enschede,Zwolle,2,1,1,W
77412,19,HOL1,2019-11-10,Feyenoord Rotterdam,Waalwijk,3,2,1,W
77413,19,HOL1,2019-11-10,AZ Alkmaar,FC Emmen,3,0,3,W
77414,19,HOL1,2019-11-23,Utrecht,AZ Alkmaar,0,3,-3,L
77415,19,HOL1,2019-11-23,Zwolle,For Sittard,3,1,2,W
77416,19,HOL1,2019-11-23,Ajax Amsterdam,Heracles,4,1,3,W
77417,19,HOL1,2019-11-23,ADO Den Haag,Willem II,3,3,0,D
77418,19,HOL1,2019-11-24,Groningen,Feyenoord Rotterdam,1,1,0,D
77419,19,HOL1,2019-11-24,PSV Eindhoven,Heerenveen,2,1,1,W
77420,19,HOL1,2019-11-24,Waalwijk,FC Emmen,1,1,0,D
77421,19,HOL1,2019-11-24,VVV Venlo,Twente Enschede,2,1,1,W
77422,19,HOL1,2019-11-24,Sparta Rotterdam,Vitesse,2,0,2,W
77423,19,HOL1,2019-11-29,Heerenveen,Vitesse,3,2,1,W
77424,19,HOL1,2019-11-30,Willem II,Sparta Rotterdam,4,0,4,W
77425,19,HOL1,2019-11-30,For Sittard,Groningen,1,0,1,W
77426,19,HOL1,2019-11-30,Heracles,ADO Den Haag,4,0,4,W
77427,19,HOL1,2019-12-01,Twente Enschede,Ajax Amsterdam,2,5,-3,L
77428,19,HOL1,2019-12-01,Utrecht,Waalwijk,0,1,-1,L
77429,19,HOL1,2019-12-01,Feyenoord Rotterdam,Zwolle,1,0,1,W
77430,19,HOL1,2019-12-01,AZ Alkmaar,VVV Venlo,1,0,1,W
77431,19,HOL1,2019-12-01,FC Emmen,PSV Eindhoven,1,1,0,D
77432,19,HOL1,2019-12-06,Ajax Amsterdam,Willem II,0,2,-2,L
77433,19,HOL1,2019-12-07,ADO Den Haag,Twente Enschede,0,0,0,D
77434,19,HOL1,2019-12-07,PSV Eindhoven,For Sittard,5,0,5,W
77435,19,HOL1,2019-12-07,VVV Venlo,FC Emmen,2,0,2,W
77436,19,HOL1,2019-12-07,Zwolle,AZ Alkmaar,0,3,-3,L
77437,19,HOL1,2019-12-08,Vitesse,Feyenoord Rotterdam,0,0,0,D
77438,19,HOL1,2019-12-08,Groningen,Utrecht,0,1,-1,L
77439,19,HOL1,2019-12-08,Waalwijk,Heerenveen,1,3,-2,L
77440,19,HOL1,2019-12-08,Sparta Rotterdam,Heracles,0,0,0,D
77441,19,HOL1,2019-12-13,Heerenveen,Willem II,1,2,-1,L
77442,19,HOL1,2019-12-14,ADO Den Haag,Groningen,1,1,0,D
77443,19,HOL1,2019-12-14,For Sittard,Waalwijk,3,2,1,W
77444,19,HOL1,2019-12-14,VVV Venlo,Zwolle,1,2,-1,L
77445,19,HOL1,2019-12-14,Twente Enschede,Vitesse,0,3,-3,L
77446,19,HOL1,2019-12-15,FC Emmen,Sparta Rotterdam,2,0,2,W
77447,19,HOL1,2019-12-15,Feyenoord Rotterdam,PSV Eindhoven,3,1,2,W
77448,19,HOL1,2019-12-15,AZ Alkmaar,Ajax Amsterdam,1,0,1,W
77449,19,HOL1,2019-12-15,Heracles,Utrecht,1,3,-2,L
77450,19,HOL1,2019-12-20,Waalwijk,Twente Enschede,3,0,3,W
77451,19,HOL1,2019-12-21,Heerenveen,Heracles,1,1,0,D
77452,19,HOL1,2019-12-21,PSV Eindhoven,Zwolle,4,1,3,W
77453,19,HOL1,2019-12-21,Sparta Rotterdam,AZ Alkmaar,3,0,3,W
77454,19,HOL1,2019-12-21,Willem II,For Sittard,0,0,0,D
77455,19,HOL1,2019-12-22,Ajax Amsterdam,ADO Den Haag,6,1,5,W
77456,19,HOL1,2019-12-22,Groningen,FC Emmen,2,0,2,W
77457,19,HOL1,2019-12-22,Utrecht,Feyenoord Rotterdam,1,2,-1,L
77458,19,HOL1,2019-12-22,Vitesse,VVV Venlo,3,0,3,W
77459,19,HOL1,2020-01-17,Zwolle,Utrecht,3,3,0,D
77460,19,HOL1,2020-01-18,For Sittard,Vitesse,1,3,-2,L
77461,19,HOL1,2020-01-18,Twente Enschede,Groningen,0,0,0,D
77462,19,HOL1,2020-01-18,Feyenoord Rotterdam,Heerenveen,3,1,2,W
77463,19,HOL1,2020-01-18,AZ Alkmaar,Willem II,1,3,-2,L
77464,19,HOL1,2020-01-19,VVV Venlo,PSV Eindhoven,1,1,0,D
77465,19,HOL1,2020-01-19,Ajax Amsterdam,Sparta Rotterdam,2,1,1,W
77466,19,HOL1,2020-01-19,FC Emmen,Heracles,1,0,1,W
77467,19,HOL1,2020-01-19,ADO Den Haag,Waalwijk,2,0,2,W
77468,19,HOL1,2020-01-24,Utrecht,ADO Den Haag,4,0,4,W
77469,19,HOL1,2020-01-25,Heerenveen,AZ Alkmaar,1,2,-1,L
77470,19,HOL1,2020-01-25,Heracles,Feyenoord Rotterdam,2,3,-1,L
77471,19,HOL1,2020-01-25,Waalwijk,VVV Venlo,1,2,-1,L
77472,19,HOL1,2020-01-25,Sparta Rotterdam,For Sittard,1,1,0,D
77473,19,HOL1,2020-01-26,Vitesse,FC Emmen,1,1,0,D
77474,19,HOL1,2020-01-26,Groningen,Ajax Amsterdam,2,1,1,W
77475,19,HOL1,2020-01-26,Willem II,Zwolle,0,0,0,D
77476,19,HOL1,2020-01-26,PSV Eindhoven,Twente Enschede,1,1,0,D
77477,19,HOL1,2020-01-31,AZ Alkmaar,Waalwijk,4,0,4,W
77478,19,HOL1,2020-02-01,ADO Den Haag,Vitesse,0,0,0,D
77479,19,HOL1,2020-02-01,Feyenoord Rotterdam,FC Emmen,3,0,3,W
77480,19,HOL1,2020-02-01,Twente Enschede,Sparta Rotterdam,2,0,2,W
77481,19,HOL1,2020-02-01,Zwolle,Groningen,1,0,1,W
77482,19,HOL1,2020-02-02,Willem II,Heracles,1,0,1,W
77483,19,HOL1,2020-02-02,For Sittard,Heerenveen,2,1,1,W
77484,19,HOL1,2020-02-02,VVV Venlo,Utrecht,1,1,0,D
77485,19,HOL1,2020-02-02,Ajax Amsterdam,PSV Eindhoven,1,0,1,W
77486,19,HOL1,2020-02-07,Heracles,For Sittard,2,0,2,W
77487,19,HOL1,2020-02-08,Groningen,Vitesse,1,0,1,W
77488,19,HOL1,2020-02-08,Heerenveen,VVV Venlo,1,1,0,D
77489,19,HOL1,2020-02-08,PSV Eindhoven,Willem II,3,0,3,W
77490,19,HOL1,2020-02-08,Waalwijk,Zwolle,0,0,0,D
77491,19,HOL1,2020-02-11,FC Emmen,Twente Enschede,2,0,2,W
77492,19,HOL1,2020-02-11,Sparta Rotterdam,ADO Den Haag,4,2,2,W
77493,19,HOL1,2020-02-14,VVV Venlo,Heracles,1,0,1,W
77494,19,HOL1,2020-02-15,Twente Enschede,AZ Alkmaar,2,0,2,W
77495,19,HOL1,2020-02-15,ADO Den Haag,PSV Eindhoven,0,3,-3,L
77496,19,HOL1,2020-02-15,For Sittard,FC Emmen,0,0,0,D
77497,19,HOL1,2020-02-16,Vitesse,Heerenveen,4,2,2,W
77498,19,HOL1,2020-02-16,Ajax Amsterdam,Waalwijk,3,0,3,W
77499,19,HOL1,2020-02-16,Sparta Rotterdam,Groningen,1,2,-1,L
77500,19,HOL1,2020-02-16,Willem II,Utrecht,1,1,0,D
77501,19,HOL1,2020-02-16,Zwolle,Feyenoord Rotterdam,3,4,-1,L
77502,19,HOL1,2020-02-21,Waalwijk,Sparta Rotterdam,0,1,-1,L
77503,19,HOL1,2020-02-22,FC Emmen,Willem II,4,2,2,W
77504,19,HOL1,2020-02-22,Feyenoord Rotterdam,For Sittard,2,1,1,W
77505,19,HOL1,2020-02-22,Heerenveen,ADO Den Haag,2,2,0,D
77506,19,HOL1,2020-02-22,Groningen,VVV Venlo,0,1,-1,L
77507,19,HOL1,2020-02-23,Utrecht,Twente Enschede,2,1,1,W
77508,19,HOL1,2020-02-23,AZ Alkmaar,Zwolle,2,0,2,W
77509,19,HOL1,2020-02-23,Vitesse,PSV Eindhoven,1,2,-1,L
77510,19,HOL1,2020-02-23,Heracles,Ajax Amsterdam,1,0,1,W
77511,19,HOL1,2020-02-28,Willem II,Groningen,3,1,2,W
77512,19,HOL1,2020-02-29,ADO Den Haag,Heracles,0,0,0,D
77513,19,HOL1,2020-02-29,VVV Venlo,For Sittard,0,0,0,D
77514,19,HOL1,2020-02-29,Zwolle,Vitesse,4,3,1,W
77515,19,HOL1,2020-02-29,Twente Enschede,Heerenveen,2,3,-1,L
77516,19,HOL1,2020-03-01,Waalwijk,Utrecht,2,1,1,W
77517,19,HOL1,2020-03-01,PSV Eindhoven,Feyenoord Rotterdam,1,1,0,D
77518,19,HOL1,2020-03-01,Sparta Rotterdam,FC Emmen,5,1,4,W
77519,19,HOL1,2020-03-01,Ajax Amsterdam,AZ Alkmaar,0,2,-2,L
77520,19,HOL1,2020-03-06,For Sittard,Zwolle,1,1,0,D
77521,19,HOL1,2020-03-07,AZ Alkmaar,ADO Den Haag,4,0,4,W
77522,19,HOL1,2020-03-07,FC Emmen,VVV Venlo,3,0,3,W
77523,19,HOL1,2020-03-07,Vitesse,Twente Enschede,1,0,1,W
77524,19,HOL1,2020-03-07,Heerenveen,Ajax Amsterdam,1,3,-2,L
77525,19,HOL1,2020-03-08,Utrecht,Sparta Rotterdam,5,1,4,W
77526,19,HOL1,2020-03-08,Feyenoord Rotterdam,Willem II,2,0,2,W
77527,19,HOL1,2020-03-08,Heracles,Waalwijk,4,2,2,W
77528,19,HOL1,2020-03-08,Groningen,PSV Eindhoven,0,1,-1,L
77529,20,HOL1,2020-09-12,Heerenveen,Willem II,2,0,2,W
77530,20,HOL1,2020-09-12,Zwolle,Feyenoord Rotterdam,0,2,-2,L
77531,20,HOL1,2020-09-12,Twente Enschede,For Sittard,2,0,2,W
77532,20,HOL1,2020-09-13,FC Emmen,VVV Venlo,3,5,-2,L
77533,20,HOL1,2020-09-13,Heracles,ADO Den Haag,2,0,2,W
77534,20,HOL1,2020-09-13,Sparta Rotterdam,Ajax Amsterdam,0,1,-1,L
77535,20,HOL1,2020-09-13,Groningen,PSV Eindhoven,1,3,-2,L
77536,20,HOL1,2020-09-13,Waalwijk,Vitesse,0,1,-1,L
77537,20,HOL1,2020-09-18,VVV Venlo,Utrecht,1,1,0,D
77538,20,HOL1,2020-09-19,AZ Alkmaar,Zwolle,1,1,0,D
77539,20,HOL1,2020-09-19,Vitesse,Sparta Rotterdam,2,0,2,W
77540,20,HOL1,2020-09-19,PSV Eindhoven,FC Emmen,2,1,1,W
77541,20,HOL1,2020-09-19,For Sittard,Heerenveen,1,3,-2,L
77542,20,HOL1,2020-09-20,ADO Den Haag,Groningen,0,1,-1,L
77543,20,HOL1,2020-09-20,Feyenoord Rotterdam,Twente Enschede,1,1,0,D
77544,20,HOL1,2020-09-20,Willem II,Heracles,4,0,4,W
77545,20,HOL1,2020-09-20,Ajax Amsterdam,Waalwijk,3,0,3,W
77546,20,HOL1,2020-09-25,Twente Enschede,Groningen,3,1,2,W
77547,20,HOL1,2020-09-26,Zwolle,Sparta Rotterdam,4,0,4,W
77548,20,HOL1,2020-09-26,For Sittard,AZ Alkmaar,3,3,0,D
77549,20,HOL1,2020-09-26,Heerenveen,VVV Venlo,1,0,1,W
77550,20,HOL1,2020-09-26,Ajax Amsterdam,Vitesse,2,1,1,W
77551,20,HOL1,2020-09-27,Feyenoord Rotterdam,ADO Den Haag,4,2,2,W
77552,20,HOL1,2020-09-27,Utrecht,Waalwijk,3,1,2,W
77553,20,HOL1,2020-09-27,Heracles,PSV Eindhoven,1,1,0,D
77554,20,HOL1,2020-09-27,FC Emmen,Willem II,1,1,0,D
77555,20,HOL1,2020-10-02,Utrecht,Heerenveen,1,1,0,D
77556,20,HOL1,2020-10-03,Vitesse,Heracles,3,0,3,W
77557,20,HOL1,2020-10-03,VVV Venlo,ADO Den Haag,1,2,-1,L
77558,20,HOL1,2020-10-03,Twente Enschede,FC Emmen,1,1,0,D
77559,20,HOL1,2020-10-04,Groningen,Ajax Amsterdam,1,0,1,W
77560,20,HOL1,2020-10-04,Sparta Rotterdam,AZ Alkmaar,4,4,0,D
77561,20,HOL1,2020-10-04,Willem II,Feyenoord Rotterdam,1,4,-3,L
77562,20,HOL1,2020-10-04,PSV Eindhoven,For Sittard,2,0,2,W
77563,20,HOL1,2020-10-17,Heracles,Waalwijk,0,1,-1,L
77564,20,HOL1,2020-10-17,AZ Alkmaar,VVV Venlo,2,2,0,D
77565,20,HOL1,2020-10-17,Willem II,Twente Enschede,0,3,-3,L
77566,20,HOL1,2020-10-18,Feyenoord Rotterdam,Sparta Rotterdam,1,1,0,D
77567,20,HOL1,2020-10-18,Ajax Amsterdam,Heerenveen,5,1,4,W
77568,20,HOL1,2020-10-18,ADO Den Haag,Vitesse,0,2,-2,L
77569,20,HOL1,2020-10-18,Groningen,Utrecht,0,0,0,D
77570,20,HOL1,2020-10-18,Zwolle,PSV Eindhoven,0,3,-3,L
77571,20,HOL1,2020-10-18,FC Emmen,For Sittard,2,2,0,D
77572,20,HOL1,2020-10-21,Waalwijk,Zwolle,1,1,0,D
77573,20,HOL1,2020-10-24,VVV Venlo,Ajax Amsterdam,0,13,-13,L
77574,20,HOL1,2020-10-24,Utrecht,Twente Enschede,2,1,1,W
77575,20,HOL1,2020-10-24,Zwolle,Willem II,0,0,0,D
77576,20,HOL1,2020-10-24,Heerenveen,FC Emmen,4,0,4,W
77577,20,HOL1,2020-10-25,For Sittard,Groningen,1,3,-2,L
77578,20,HOL1,2020-10-25,Vitesse,PSV Eindhoven,2,1,1,W
77579,20,HOL1,2020-10-25,Sparta Rotterdam,Heracles,1,1,0,D
77580,20,HOL1,2020-10-25,Waalwijk,Feyenoord Rotterdam,2,2,0,D
77581,20,HOL1,2020-10-25,ADO Den Haag,AZ Alkmaar,2,2,0,D
77582,20,HOL1,2020-10-31,Twente Enschede,Zwolle,5,1,4,W
77583,20,HOL1,2020-10-31,Ajax Amsterdam,For Sittard,5,2,3,W
77584,20,HOL1,2020-10-31,Groningen,VVV Venlo,2,1,1,W
77585,20,HOL1,2020-10-31,Willem II,Vitesse,1,3,-2,L
77586,20,HOL1,2020-11-01,Heracles,Utrecht,4,1,3,W
77587,20,HOL1,2020-11-01,Sparta Rotterdam,Heerenveen,1,4,-3,L
77588,20,HOL1,2020-11-01,FC Emmen,Feyenoord Rotterdam,2,3,-1,L
77589,20,HOL1,2020-11-01,PSV Eindhoven,ADO Den Haag,4,0,4,W
77590,20,HOL1,2020-11-01,AZ Alkmaar,Waalwijk,3,0,3,W
77591,20,HOL1,2020-11-06,For Sittard,Zwolle,2,2,0,D
77592,20,HOL1,2020-11-07,ADO Den Haag,Twente Enschede,2,4,-2,L
77593,20,HOL1,2020-11-07,VVV Venlo,Heracles,3,2,1,W
77594,20,HOL1,2020-11-07,Waalwijk,Sparta Rotterdam,0,2,-2,L
77595,20,HOL1,2020-11-08,Utrecht,Ajax Amsterdam,0,3,-3,L
77596,20,HOL1,2020-11-08,Vitesse,FC Emmen,3,1,2,W
77597,20,HOL1,2020-11-08,Feyenoord Rotterdam,Groningen,2,0,2,W
77598,20,HOL1,2020-11-08,Heerenveen,AZ Alkmaar,0,3,-3,L
77599,20,HOL1,2020-11-08,PSV Eindhoven,Willem II,3,0,3,W
77600,20,HOL1,2020-11-21,Willem II,VVV Venlo,2,1,1,W
77601,20,HOL1,2020-11-21,Groningen,Vitesse,1,1,0,D
77602,20,HOL1,2020-11-21,Zwolle,Utrecht,1,1,0,D
77603,20,HOL1,2020-11-22,Ajax Amsterdam,Heracles,5,0,5,W
77604,20,HOL1,2020-11-22,Sparta Rotterdam,ADO Den Haag,6,0,6,W
77605,20,HOL1,2020-11-22,For Sittard,Feyenoord Rotterdam,1,3,-2,L
77606,20,HOL1,2020-11-22,Twente Enschede,PSV Eindhoven,1,1,0,D
77607,20,HOL1,2020-11-22,Waalwijk,Heerenveen,1,1,0,D
77608,20,HOL1,2020-11-22,AZ Alkmaar,FC Emmen,1,0,1,W
77609,20,HOL1,2020-11-27,Twente Enschede,Waalwijk,0,2,-2,L
77610,20,HOL1,2020-11-28,FC Emmen,Ajax Amsterdam,0,5,-5,L
77611,20,HOL1,2020-11-28,ADO Den Haag,Heerenveen,1,1,0,D
77612,20,HOL1,2020-11-28,VVV Venlo,Zwolle,2,2,0,D
77613,20,HOL1,2020-11-29,Vitesse,For Sittard,2,0,2,W
77614,20,HOL1,2020-11-29,Groningen,Willem II,1,0,1,W
77615,20,HOL1,2020-11-29,Feyenoord Rotterdam,Utrecht,1,1,0,D
77616,20,HOL1,2020-11-29,Heracles,AZ Alkmaar,1,2,-1,L
77617,20,HOL1,2020-11-29,PSV Eindhoven,Sparta Rotterdam,1,0,1,W
77618,20,HOL1,2020-12-04,Sparta Rotterdam,FC Emmen,2,1,1,W
77619,20,HOL1,2020-12-05,Waalwijk,VVV Venlo,3,2,1,W
77620,20,HOL1,2020-12-05,For Sittard,Willem II,3,2,1,W
77621,20,HOL1,2020-12-05,Ajax Amsterdam,Twente Enschede,1,2,-1,L
77622,20,HOL1,2020-12-05,Zwolle,Vitesse,2,1,1,W
77623,20,HOL1,2020-12-06,Feyenoord Rotterdam,Heracles,0,0,0,D
77624,20,HOL1,2020-12-06,AZ Alkmaar,Groningen,1,2,-1,L
77625,20,HOL1,2020-12-06,Utrecht,ADO Den Haag,1,1,0,D
77626,20,HOL1,2020-12-06,Heerenveen,PSV Eindhoven,2,2,0,D
77627,20,HOL1,2020-12-11,Heracles,For Sittard,1,2,-1,L
77628,20,HOL1,2020-12-12,Groningen,Waalwijk,2,0,2,W
77629,20,HOL1,2020-12-12,FC Emmen,ADO Den Haag,1,1,0,D
77630,20,HOL1,2020-12-12,Ajax Amsterdam,Zwolle,4,0,4,W
77631,20,HOL1,2020-12-13,Vitesse,Heerenveen,1,1,0,D
77632,20,HOL1,2020-12-13,VVV Venlo,Feyenoord Rotterdam,0,3,-3,L
77633,20,HOL1,2020-12-13,Willem II,Sparta Rotterdam,1,3,-2,L
77634,20,HOL1,2020-12-13,PSV Eindhoven,Utrecht,2,1,1,W
77635,20,HOL1,2020-12-13,Twente Enschede,AZ Alkmaar,1,3,-2,L
77636,20,HOL1,2020-12-18,Zwolle,FC Emmen,0,0,0,D
77637,20,HOL1,2020-12-19,Sparta Rotterdam,Groningen,2,3,-1,L
77638,20,HOL1,2020-12-19,VVV Venlo,Twente Enschede,1,2,-1,L
77639,20,HOL1,2020-12-19,Waalwijk,PSV Eindhoven,1,4,-3,L
77640,20,HOL1,2020-12-19,Utrecht,For Sittard,1,1,0,D
77641,20,HOL1,2020-12-20,Vitesse,Feyenoord Rotterdam,1,0,1,W
77642,20,HOL1,2020-12-20,ADO Den Haag,Ajax Amsterdam,2,4,-2,L
77643,20,HOL1,2020-12-20,Heerenveen,Heracles,1,2,-1,L
77644,20,HOL1,2020-12-20,AZ Alkmaar,Willem II,5,3,2,W
77645,20,HOL1,2020-12-22,For Sittard,Waalwijk,2,1,1,W
77646,20,HOL1,2020-12-22,FC Emmen,Utrecht,2,3,-1,L
77647,20,HOL1,2020-12-22,PSV Eindhoven,VVV Venlo,4,1,3,W
77648,20,HOL1,2020-12-22,Twente Enschede,Sparta Rotterdam,0,2,-2,L
77649,20,HOL1,2020-12-23,AZ Alkmaar,Vitesse,3,1,2,W
77650,20,HOL1,2020-12-23,Willem II,Ajax Amsterdam,1,1,0,D
77651,20,HOL1,2020-12-23,Groningen,Heracles,0,1,-1,L
77652,20,HOL1,2020-12-23,ADO Den Haag,Zwolle,0,2,-2,L
77653,20,HOL1,2020-12-23,Feyenoord Rotterdam,Heerenveen,3,0,3,W
77654,20,HOL1,2020-12-27,Utrecht,AZ Alkmaar,2,2,0,D
77655,20,HOL1,2021-01-09,Waalwijk,ADO Den Haag,0,1,-1,L
77656,20,HOL1,2021-01-09,FC Emmen,Twente Enschede,1,4,-3,L
77657,20,HOL1,2021-01-09,Heracles,Vitesse,0,2,-2,L
77658,20,HOL1,2021-01-09,Zwolle,AZ Alkmaar,1,1,0,D
77659,20,HOL1,2021-01-09,Utrecht,Groningen,2,2,0,D
77660,20,HOL1,2021-01-10,Sparta Rotterdam,Feyenoord Rotterdam,0,2,-2,L
77661,20,HOL1,2021-01-10,Heerenveen,For Sittard,1,3,-2,L
77662,20,HOL1,2021-01-10,VVV Venlo,Willem II,2,1,1,W
77663,20,HOL1,2021-01-10,Ajax Amsterdam,PSV Eindhoven,2,2,0,D
77664,20,HOL1,2021-01-12,Vitesse,Utrecht,1,0,1,W
77665,20,HOL1,2021-01-12,Heracles,FC Emmen,4,0,4,W
77666,20,HOL1,2021-01-13,PSV Eindhoven,AZ Alkmaar,1,3,-2,L
77667,20,HOL1,2021-01-13,For Sittard,Sparta Rotterdam,0,1,-1,L
77668,20,HOL1,2021-01-13,ADO Den Haag,VVV Venlo,1,4,-3,L
77669,20,HOL1,2021-01-13,Feyenoord Rotterdam,Zwolle,1,0,1,W
77670,20,HOL1,2021-01-14,Heerenveen,Waalwijk,1,1,0,D
77671,20,HOL1,2021-01-14,Twente Enschede,Ajax Amsterdam,1,3,-2,L
77672,20,HOL1,2021-01-14,Willem II,Groningen,2,3,-1,L
77673,20,HOL1,2021-01-16,FC Emmen,Vitesse,1,4,-3,L
77674,20,HOL1,2021-01-16,Sparta Rotterdam,PSV Eindhoven,3,5,-2,L
77675,20,HOL1,2021-01-16,Utrecht,Heracles,2,0,2,W
77676,20,HOL1,2021-01-16,Zwolle,For Sittard,0,2,-2,L
77677,20,HOL1,2021-01-16,AZ Alkmaar,ADO Den Haag,2,1,1,W
77678,20,HOL1,2021-01-17,Waalwijk,Willem II,1,1,0,D
77679,20,HOL1,2021-01-17,Groningen,Twente Enschede,2,2,0,D
77680,20,HOL1,2021-01-17,VVV Venlo,Heerenveen,1,1,0,D
77681,20,HOL1,2021-01-17,Ajax Amsterdam,Feyenoord Rotterdam,1,0,1,W
77682,20,HOL1,2021-01-22,Willem II,Zwolle,1,3,-2,L
77683,20,HOL1,2021-01-23,ADO Den Haag,FC Emmen,0,0,0,D
77684,20,HOL1,2021-01-23,Vitesse,Groningen,1,0,1,W
77685,20,HOL1,2021-01-23,PSV Eindhoven,Waalwijk,2,0,2,W
77686,20,HOL1,2021-01-23,Heracles,Heerenveen,1,0,1,W
77687,20,HOL1,2021-01-24,For Sittard,Ajax Amsterdam,1,2,-1,L
77688,20,HOL1,2021-01-24,Twente Enschede,VVV Venlo,0,1,-1,L
77689,20,HOL1,2021-01-24,Utrecht,Sparta Rotterdam,1,0,1,W
77690,20,HOL1,2021-01-24,Feyenoord Rotterdam,AZ Alkmaar,2,3,-1,L
77691,20,HOL1,2021-01-26,Zwolle,Heracles,2,2,0,D
77692,20,HOL1,2021-01-26,FC Emmen,PSV Eindhoven,0,2,-2,L
77693,20,HOL1,2021-01-26,Groningen,ADO Den Haag,3,0,3,W
77694,20,HOL1,2021-01-27,AZ Alkmaar,Utrecht,0,1,-1,L
77695,20,HOL1,2021-01-27,Waalwijk,For Sittard,1,2,-1,L
77696,20,HOL1,2021-01-27,VVV Venlo,Vitesse,4,1,3,W
77697,20,HOL1,2021-01-27,Heerenveen,Feyenoord Rotterdam,3,0,3,W
77698,20,HOL1,2021-01-28,Sparta Rotterdam,Twente Enschede,0,0,0,D
77699,20,HOL1,2021-01-28,Ajax Amsterdam,Willem II,3,1,2,W
77700,20,HOL1,2021-01-30,Heracles,Groningen,1,0,1,W
77701,20,HOL1,2021-01-30,Utrecht,Zwolle,3,3,0,D
77702,20,HOL1,2021-01-30,For Sittard,VVV Venlo,3,2,1,W
77703,20,HOL1,2021-01-30,Vitesse,Waalwijk,1,1,0,D
77704,20,HOL1,2021-01-31,Twente Enschede,Heerenveen,0,0,0,D
77705,20,HOL1,2021-01-31,Feyenoord Rotterdam,PSV Eindhoven,3,1,2,W
77706,20,HOL1,2021-01-31,Willem II,FC Emmen,2,0,2,W
77707,20,HOL1,2021-01-31,AZ Alkmaar,Ajax Amsterdam,0,3,-3,L
77708,20,HOL1,2021-01-31,ADO Den Haag,Sparta Rotterdam,1,1,0,D
77709,20,HOL1,2021-02-05,For Sittard,Heracles,0,1,-1,L
77710,20,HOL1,2021-02-06,Zwolle,Waalwijk,1,1,0,D
77711,20,HOL1,2021-02-06,FC Emmen,AZ Alkmaar,0,1,-1,L
77712,20,HOL1,2021-02-06,PSV Eindhoven,Twente Enschede,3,0,3,W
77713,20,HOL1,2021-02-06,Heerenveen,Vitesse,1,0,1,W
77714,20,HOL1,2021-02-12,Waalwijk,FC Emmen,1,0,1,W
77715,20,HOL1,2021-02-13,Groningen,Zwolle,1,0,1,W
77716,20,HOL1,2021-02-13,Sparta Rotterdam,For Sittard,1,2,-1,L
77717,20,HOL1,2021-02-13,ADO Den Haag,PSV Eindhoven,2,2,0,D
77718,20,HOL1,2021-02-13,Heracles,Ajax Amsterdam,0,2,-2,L
77719,20,HOL1,2021-02-14,AZ Alkmaar,Heerenveen,3,1,2,W
77720,20,HOL1,2021-02-14,Utrecht,VVV Venlo,3,1,2,W
77721,20,HOL1,2021-02-14,Feyenoord Rotterdam,Willem II,5,0,5,W
77722,20,HOL1,2021-02-14,Vitesse,Twente Enschede,0,2,-2,L
77723,20,HOL1,2021-02-19,Willem II,Utrecht,0,6,-6,L
77724,20,HOL1,2021-02-20,FC Emmen,Zwolle,3,2,1,W
77725,20,HOL1,2021-02-20,VVV Venlo,AZ Alkmaar,1,4,-3,L
77726,20,HOL1,2021-02-20,For Sittard,ADO Den Haag,2,0,2,W
77727,20,HOL1,2021-02-21,Twente Enschede,Feyenoord Rotterdam,2,2,0,D
77728,20,HOL1,2021-02-21,Waalwijk,Heracles,3,0,3,W
77729,20,HOL1,2021-02-21,Heerenveen,Groningen,1,1,0,D
77730,20,HOL1,2021-02-21,PSV Eindhoven,Vitesse,3,1,2,W
77731,20,HOL1,2021-02-21,Ajax Amsterdam,Sparta Rotterdam,4,2,2,W
77732,20,HOL1,2021-02-24,Willem II,ADO Den Haag,1,1,0,D
77733,20,HOL1,2021-02-24,Groningen,Feyenoord Rotterdam,0,0,0,D
77734,20,HOL1,2021-02-26,Zwolle,Heerenveen,4,1,3,W
77735,20,HOL1,2021-02-27,Utrecht,FC Emmen,0,1,-1,L
77736,20,HOL1,2021-02-27,ADO Den Haag,Waalwijk,0,0,0,D
77737,20,HOL1,2021-02-27,Vitesse,VVV Venlo,4,1,3,W
77738,20,HOL1,2021-02-27,Heracles,Twente Enschede,2,2,0,D
77739,20,HOL1,2021-02-28,Sparta Rotterdam,Willem II,0,2,-2,L
77740,20,HOL1,2021-02-28,Groningen,For Sittard,1,0,1,W
77741,20,HOL1,2021-02-28,PSV Eindhoven,Ajax Amsterdam,1,1,0,D
77742,20,HOL1,2021-02-28,AZ Alkmaar,Feyenoord Rotterdam,4,2,2,W
77743,20,HOL1,2021-03-05,FC Emmen,Sparta Rotterdam,1,1,0,D
77744,20,HOL1,2021-03-06,Feyenoord Rotterdam,VVV Venlo,6,0,6,W
77745,20,HOL1,2021-03-06,Twente Enschede,Willem II,1,1,0,D
77746,20,HOL1,2021-03-06,Heerenveen,ADO Den Haag,3,0,3,W
77747,20,HOL1,2021-03-06,Waalwijk,Utrecht,1,2,-1,L
77748,20,HOL1,2021-03-07,Ajax Amsterdam,Groningen,3,1,2,W
77749,20,HOL1,2021-03-07,For Sittard,PSV Eindhoven,1,3,-2,L
77750,20,HOL1,2021-03-07,Heracles,Zwolle,2,1,1,W
77751,20,HOL1,2021-03-07,Vitesse,AZ Alkmaar,2,1,1,W
77752,20,HOL1,2021-03-09,VVV Venlo,Sparta Rotterdam,0,1,-1,L
77753,20,HOL1,2021-03-13,Willem II,Heerenveen,3,1,2,W
77754,20,HOL1,2021-03-13,ADO Den Haag,Heracles,1,2,-1,L
77755,20,HOL1,2021-03-13,AZ Alkmaar,Twente Enschede,4,1,3,W
77756,20,HOL1,2021-03-13,Groningen,FC Emmen,1,1,0,D
77757,20,HOL1,2021-03-13,Sparta Rotterdam,Waalwijk,2,0,2,W
77758,20,HOL1,2021-03-14,VVV Venlo,For Sittard,1,3,-2,L
77759,20,HOL1,2021-03-14,Utrecht,Vitesse,1,3,-2,L
77760,20,HOL1,2021-03-14,PSV Eindhoven,Feyenoord Rotterdam,1,1,0,D
77761,20,HOL1,2021-03-14,Zwolle,Ajax Amsterdam,0,2,-2,L
77762,20,HOL1,2021-03-19,Heerenveen,Twente Enschede,0,0,0,D
77763,20,HOL1,2021-03-20,For Sittard,Utrecht,0,1,-1,L
77764,20,HOL1,2021-03-20,Feyenoord Rotterdam,FC Emmen,1,1,0,D
77765,20,HOL1,2021-03-20,Waalwijk,Groningen,3,1,2,W
77766,20,HOL1,2021-03-21,Zwolle,VVV Venlo,2,1,1,W
77767,20,HOL1,2021-03-21,AZ Alkmaar,PSV Eindhoven,2,0,2,W
77768,20,HOL1,2021-03-21,Vitesse,Willem II,0,0,0,D
77769,20,HOL1,2021-03-21,Heracles,Sparta Rotterdam,1,1,0,D
77770,20,HOL1,2021-03-21,Ajax Amsterdam,ADO Den Haag,5,0,5,W
77771,20,HOL1,2021-04-03,VVV Venlo,Groningen,0,1,-1,L
77772,20,HOL1,2021-04-03,Twente Enschede,Vitesse,1,2,-1,L
77773,20,HOL1,2021-04-03,Willem II,AZ Alkmaar,0,1,-1,L
77774,20,HOL1,2021-04-03,Sparta Rotterdam,Zwolle,3,2,1,W
77775,20,HOL1,2021-04-04,Feyenoord Rotterdam,For Sittard,2,0,2,W
77776,20,HOL1,2021-04-04,ADO Den Haag,Utrecht,1,4,-3,L
77777,20,HOL1,2021-04-04,PSV Eindhoven,Heracles,3,0,3,W
77778,20,HOL1,2021-04-04,FC Emmen,Waalwijk,3,1,2,W
77779,20,HOL1,2021-04-04,Heerenveen,Ajax Amsterdam,1,2,-1,L
77780,20,HOL1,2021-04-09,Vitesse,ADO Den Haag,0,0,0,D
77781,20,HOL1,2021-04-10,Heracles,Willem II,4,0,4,W
77782,20,HOL1,2021-04-10,AZ Alkmaar,Sparta Rotterdam,2,0,2,W
77783,20,HOL1,2021-04-10,For Sittard,FC Emmen,1,3,-2,L
77784,20,HOL1,2021-04-10,Zwolle,Twente Enschede,1,0,1,W
77785,20,HOL1,2021-04-11,Utrecht,Feyenoord Rotterdam,1,2,-1,L
77786,20,HOL1,2021-04-11,Groningen,Heerenveen,0,2,-2,L
77787,20,HOL1,2021-04-11,VVV Venlo,PSV Eindhoven,0,2,-2,L
77788,20,HOL1,2021-04-11,Waalwijk,Ajax Amsterdam,0,1,-1,L
77789,20,HOL1,2021-04-22,Ajax Amsterdam,Utrecht,1,1,0,D
77790,20,HOL1,2021-04-23,Willem II,Waalwijk,1,0,1,W
77791,20,HOL1,2021-04-24,Heerenveen,Zwolle,0,2,-2,L
77792,20,HOL1,2021-04-24,PSV Eindhoven,Groningen,1,0,1,W
77793,20,HOL1,2021-04-24,Sparta Rotterdam,VVV Venlo,2,0,2,W
77794,20,HOL1,2021-04-25,FC Emmen,Heracles,3,1,2,W
77795,20,HOL1,2021-04-25,ADO Den Haag,For Sittard,0,3,-3,L
77796,20,HOL1,2021-04-25,Ajax Amsterdam,AZ Alkmaar,2,0,2,W
77797,20,HOL1,2021-04-25,Twente Enschede,Utrecht,1,2,-1,L
77798,20,HOL1,2021-04-25,Feyenoord Rotterdam,Vitesse,0,0,0,D
77799,20,HOL1,2021-05-01,Heracles,VVV Venlo,4,0,4,W
77800,20,HOL1,2021-05-01,For Sittard,Twente Enschede,3,0,3,W
77801,20,HOL1,2021-05-01,Waalwijk,AZ Alkmaar,1,3,-2,L
77802,20,HOL1,2021-05-01,Vitesse,Zwolle,2,1,1,W
77803,20,HOL1,2021-05-01,Utrecht,Willem II,3,2,1,W
77804,20,HOL1,2021-05-02,ADO Den Haag,Feyenoord Rotterdam,3,2,1,W
77805,20,HOL1,2021-05-02,Ajax Amsterdam,FC Emmen,4,0,4,W
77806,20,HOL1,2021-05-02,Groningen,Sparta Rotterdam,1,2,-1,L
77807,20,HOL1,2021-05-02,PSV Eindhoven,Heerenveen,2,2,0,D
77808,20,HOL1,2021-05-07,Sparta Rotterdam,Vitesse,3,0,3,W
77809,20,HOL1,2021-05-08,Twente Enschede,Heracles,1,1,0,D
77810,20,HOL1,2021-05-08,Heerenveen,Utrecht,0,0,0,D
77811,20,HOL1,2021-05-08,AZ Alkmaar,For Sittard,1,0,1,W
77812,20,HOL1,2021-05-08,VVV Venlo,Waalwijk,3,3,0,D
77813,20,HOL1,2021-05-09,FC Emmen,Groningen,0,4,-4,L
77814,20,HOL1,2021-05-09,Feyenoord Rotterdam,Ajax Amsterdam,0,3,-3,L
77815,20,HOL1,2021-05-09,Zwolle,ADO Den Haag,0,1,-1,L
77816,20,HOL1,2021-05-09,Willem II,PSV Eindhoven,0,2,-2,L
77817,20,HOL1,2021-05-13,ADO Den Haag,Willem II,1,4,-3,L
77818,20,HOL1,2021-05-13,Ajax Amsterdam,VVV Venlo,3,1,2,W
77819,20,HOL1,2021-05-13,FC Emmen,Heerenveen,3,1,2,W
77820,20,HOL1,2021-05-13,Groningen,AZ Alkmaar,0,0,0,D
77821,20,HOL1,2021-05-13,For Sittard,Vitesse,3,3,0,D
77822,20,HOL1,2021-05-13,Heracles,Feyenoord Rotterdam,1,1,0,D
77823,20,HOL1,2021-05-13,PSV Eindhoven,Zwolle,4,2,2,W
77824,20,HOL1,2021-05-13,Waalwijk,Twente Enschede,2,1,1,W
77825,20,HOL1,2021-05-13,Sparta Rotterdam,Utrecht,0,0,0,D
77826,20,HOL1,2021-05-16,AZ Alkmaar,Heracles,5,0,5,W
77827,20,HOL1,2021-05-16,Twente Enschede,ADO Den Haag,3,2,1,W
77828,20,HOL1,2021-05-16,Utrecht,PSV Eindhoven,1,1,0,D
77829,20,HOL1,2021-05-16,Feyenoord Rotterdam,Waalwijk,3,0,3,W
77830,20,HOL1,2021-05-16,Zwolle,Groningen,1,0,1,W
77831,20,HOL1,2021-05-16,Heerenveen,Sparta Rotterdam,1,2,-1,L
77832,20,HOL1,2021-05-16,Vitesse,Ajax Amsterdam,1,3,-2,L
77833,20,HOL1,2021-05-16,VVV Venlo,FC Emmen,0,4,-4,L
77834,20,HOL1,2021-05-16,Willem II,For Sittard,2,1,1,W
77835,21,HOL1,2021-08-13,Go Ahead Eagles,Heerenveen,0,1,-1,L
77836,21,HOL1,2021-08-14,Waalwijk,AZ Alkmaar,1,0,1,W
77837,21,HOL1,2021-08-14,Heracles,PSV Eindhoven,0,2,-2,L
77838,21,HOL1,2021-08-14,For Sittard,Twente Enschede,2,1,1,W
77839,21,HOL1,2021-08-14,Ajax Amsterdam,NEC Nijmegen,5,0,5,W
77840,21,HOL1,2021-08-15,Cambuur,Groningen,1,2,-1,L
77841,21,HOL1,2021-08-15,Utrecht,Sparta Rotterdam,4,0,4,W
77842,21,HOL1,2021-08-15,Zwolle,Vitesse,0,1,-1,L
77843,21,HOL1,2021-08-15,Willem II,Feyenoord Rotterdam,0,4,-4,L
77844,21,HOL1,2021-08-20,NEC Nijmegen,Zwolle,2,0,2,W
77845,21,HOL1,2021-08-21,Heerenveen,Waalwijk,3,2,1,W
77846,21,HOL1,2021-08-21,PSV Eindhoven,Cambuur,4,1,3,W
77847,21,HOL1,2021-08-21,Sparta Rotterdam,Heracles,1,1,0,D
77848,21,HOL1,2021-08-21,Groningen,Utrecht,0,0,0,D
77849,21,HOL1,2021-08-22,Twente Enschede,Ajax Amsterdam,1,1,0,D
77850,21,HOL1,2021-08-22,Feyenoord Rotterdam,Go Ahead Eagles,2,0,2,W
77851,21,HOL1,2021-08-22,Vitesse,Willem II,0,3,-3,L
77852,21,HOL1,2021-08-27,For Sittard,Waalwijk,2,2,0,D
77853,21,HOL1,2021-08-28,Cambuur,Twente Enschede,2,0,2,W
77854,21,HOL1,2021-08-28,Go Ahead Eagles,Sparta Rotterdam,2,0,2,W
77855,21,HOL1,2021-08-28,PSV Eindhoven,Groningen,5,2,3,W
77856,21,HOL1,2021-08-28,Willem II,Zwolle,1,0,1,W
77857,21,HOL1,2021-08-29,Utrecht,Feyenoord Rotterdam,3,1,2,W
77858,21,HOL1,2021-08-29,Ajax Amsterdam,Vitesse,5,0,5,W
77859,21,HOL1,2021-08-29,Heracles,NEC Nijmegen,0,1,-1,L
77860,21,HOL1,2021-08-29,Heerenveen,AZ Alkmaar,1,3,-2,L
77861,21,HOL1,2021-09-11,Twente Enschede,Utrecht,1,0,1,W
77862,21,HOL1,2021-09-11,Zwolle,Ajax Amsterdam,0,2,-2,L
77863,21,HOL1,2021-09-11,Cambuur,Go Ahead Eagles,5,2,3,W
77864,21,HOL1,2021-09-11,AZ Alkmaar,PSV Eindhoven,0,3,-3,L
77865,21,HOL1,2021-09-12,NEC Nijmegen,Willem II,0,0,0,D
77866,21,HOL1,2021-09-12,Sparta Rotterdam,For Sittard,3,1,2,W
77867,21,HOL1,2021-09-12,Groningen,Heerenveen,1,1,0,D
77868,21,HOL1,2021-09-12,Waalwijk,Vitesse,1,2,-1,L
77869,21,HOL1,2021-09-17,Sparta Rotterdam,NEC Nijmegen,1,1,0,D
77870,21,HOL1,2021-09-18,Heerenveen,For Sittard,1,0,1,W
77871,21,HOL1,2021-09-18,Willem II,Groningen,2,1,1,W
77872,21,HOL1,2021-09-18,Ajax Amsterdam,Cambuur,9,0,9,W
77873,21,HOL1,2021-09-18,Utrecht,Waalwijk,2,2,0,D
77874,21,HOL1,2021-09-19,Go Ahead Eagles,Zwolle,1,0,1,W
77875,21,HOL1,2021-09-19,PSV Eindhoven,Feyenoord Rotterdam,0,4,-4,L
77876,21,HOL1,2021-09-19,Vitesse,Twente Enschede,1,4,-3,L
77877,21,HOL1,2021-09-19,Heracles,AZ Alkmaar,3,2,1,W
77878,21,HOL1,2021-09-21,For Sittard,Ajax Amsterdam,0,5,-5,L
77879,21,HOL1,2021-09-21,Waalwijk,Willem II,1,2,-1,L
77880,21,HOL1,2021-09-22,Go Ahead Eagles,PSV Eindhoven,1,2,-1,L
77881,21,HOL1,2021-09-22,NEC Nijmegen,Utrecht,0,3,-3,L
77882,21,HOL1,2021-09-22,Groningen,Vitesse,0,1,-1,L
77883,21,HOL1,2021-09-22,Feyenoord Rotterdam,Heerenveen,3,1,2,W
77884,21,HOL1,2021-09-22,Zwolle,Sparta Rotterdam,1,1,0,D
77885,21,HOL1,2021-09-23,Cambuur,Heracles,2,1,1,W
77886,21,HOL1,2021-09-23,Twente Enschede,AZ Alkmaar,3,1,2,W
77887,21,HOL1,2021-09-25,Willem II,PSV Eindhoven,2,1,1,W
77888,21,HOL1,2021-09-25,Ajax Amsterdam,Groningen,3,0,3,W
77889,21,HOL1,2021-09-25,Vitesse,For Sittard,1,1,0,D
77890,21,HOL1,2021-09-25,Feyenoord Rotterdam,NEC Nijmegen,5,3,2,W
77891,21,HOL1,2021-09-25,Utrecht,Zwolle,5,1,4,W
77892,21,HOL1,2021-09-26,Sparta Rotterdam,Cambuur,0,4,-4,L
77893,21,HOL1,2021-09-26,AZ Alkmaar,Go Ahead Eagles,5,0,5,W
77894,21,HOL1,2021-09-26,Heerenveen,Twente Enschede,2,3,-1,L
77895,21,HOL1,2021-09-26,Heracles,Waalwijk,1,0,1,W
77896,21,HOL1,2021-10-01,Groningen,Twente Enschede,1,1,0,D
77897,21,HOL1,2021-10-02,Waalwijk,Go Ahead Eagles,1,1,0,D
77898,21,HOL1,2021-10-02,Heracles,Willem II,3,2,1,W
77899,21,HOL1,2021-10-02,Zwolle,Heerenveen,0,1,-1,L
77900,21,HOL1,2021-10-02,For Sittard,NEC Nijmegen,1,3,-2,L
77901,21,HOL1,2021-10-03,Ajax Amsterdam,Utrecht,0,1,-1,L
77902,21,HOL1,2021-10-03,Cambuur,AZ Alkmaar,1,3,-2,L
77903,21,HOL1,2021-10-03,Vitesse,Feyenoord Rotterdam,2,1,1,W
77904,21,HOL1,2021-10-03,PSV Eindhoven,Sparta Rotterdam,2,1,1,W
77905,21,HOL1,2021-10-16,Feyenoord Rotterdam,Waalwijk,2,2,0,D
77906,21,HOL1,2021-10-16,Go Ahead Eagles,Heracles,4,2,2,W
77907,21,HOL1,2021-10-16,Heerenveen,Ajax Amsterdam,0,2,-2,L
77908,21,HOL1,2021-10-16,For Sittard,Cambuur,1,0,1,W
77909,21,HOL1,2021-10-16,PSV Eindhoven,Zwolle,3,1,2,W
77910,21,HOL1,2021-10-17,AZ Alkmaar,Utrecht,5,1,4,W
77911,21,HOL1,2021-10-17,NEC Nijmegen,Vitesse,0,1,-1,L
77912,21,HOL1,2021-10-17,Sparta Rotterdam,Groningen,1,1,0,D
77913,21,HOL1,2021-10-17,Twente Enschede,Willem II,1,1,0,D
77914,21,HOL1,2021-10-22,Willem II,For Sittard,1,1,0,D
77915,21,HOL1,2021-10-23,Utrecht,Heerenveen,2,1,1,W
77916,21,HOL1,2021-10-23,Zwolle,Heracles,1,0,1,W
77917,21,HOL1,2021-10-23,Waalwijk,Sparta Rotterdam,1,0,1,W
77918,21,HOL1,2021-10-24,Twente Enschede,NEC Nijmegen,1,2,-1,L
77919,21,HOL1,2021-10-24,Cambuur,Feyenoord Rotterdam,2,3,-1,L
77920,21,HOL1,2021-10-24,Vitesse,Go Ahead Eagles,1,2,-1,L
77921,21,HOL1,2021-10-24,Ajax Amsterdam,PSV Eindhoven,5,0,5,W
77922,21,HOL1,2021-10-24,Groningen,AZ Alkmaar,2,0,2,W
77923,21,HOL1,2021-10-30,PSV Eindhoven,Twente Enschede,5,2,3,W
77924,21,HOL1,2021-10-30,Heracles,Ajax Amsterdam,0,0,0,D
77925,21,HOL1,2021-10-30,Heerenveen,Vitesse,1,2,-1,L
77926,21,HOL1,2021-10-30,AZ Alkmaar,Zwolle,3,2,1,W
77927,21,HOL1,2021-10-31,Sparta Rotterdam,Feyenoord Rotterdam,0,1,-1,L
77928,21,HOL1,2021-10-31,NEC Nijmegen,Groningen,3,0,3,W
77929,21,HOL1,2021-10-31,Utrecht,Willem II,5,1,4,W
77930,21,HOL1,2021-10-31,Waalwijk,Cambuur,0,1,-1,L
77931,21,HOL1,2021-10-31,Go Ahead Eagles,For Sittard,4,3,1,W
77932,21,HOL1,2021-11-05,Twente Enschede,Heracles,1,0,1,W
77933,21,HOL1,2021-11-06,NEC Nijmegen,Heerenveen,1,1,0,D
77934,21,HOL1,2021-11-06,Willem II,Sparta Rotterdam,0,3,-3,L
77935,21,HOL1,2021-11-06,Zwolle,Cambuur,1,2,-1,L
77936,21,HOL1,2021-11-07,Groningen,Waalwijk,1,1,0,D
77937,21,HOL1,2021-11-07,For Sittard,PSV Eindhoven,1,4,-3,L
77938,21,HOL1,2021-11-07,Vitesse,Utrecht,2,1,1,W
77939,21,HOL1,2021-11-07,Feyenoord Rotterdam,AZ Alkmaar,1,0,1,W
77940,21,HOL1,2021-11-07,Ajax Amsterdam,Go Ahead Eagles,0,0,0,D
77941,21,HOL1,2021-11-20,PSV Eindhoven,Vitesse,2,0,2,W
77942,21,HOL1,2021-11-20,Sparta Rotterdam,Twente Enschede,0,1,-1,L
77943,21,HOL1,2021-11-20,AZ Alkmaar,NEC Nijmegen,1,1,0,D
77944,21,HOL1,2021-11-20,Heracles,For Sittard,3,1,2,W
77945,21,HOL1,2021-11-21,Go Ahead Eagles,Groningen,0,1,-1,L
77946,21,HOL1,2021-11-21,Feyenoord Rotterdam,Zwolle,4,0,4,W
77947,21,HOL1,2021-11-21,Heerenveen,Willem II,2,1,1,W
77948,21,HOL1,2021-11-21,Waalwijk,Ajax Amsterdam,0,5,-5,L
77949,21,HOL1,2021-11-21,Cambuur,Utrecht,2,1,1,W
77950,21,HOL1,2021-11-26,NEC Nijmegen,Cambuur,2,3,-1,L
77951,21,HOL1,2021-11-27,For Sittard,Groningen,1,4,-3,L
77952,21,HOL1,2021-11-27,Zwolle,Waalwijk,0,0,0,D
77953,21,HOL1,2021-11-27,Willem II,Go Ahead Eagles,0,1,-1,L
77954,21,HOL1,2021-11-28,Sparta Rotterdam,Ajax Amsterdam,0,1,-1,L
77955,21,HOL1,2021-11-28,Utrecht,Heracles,1,0,1,W
77956,21,HOL1,2021-11-28,Twente Enschede,Feyenoord Rotterdam,0,0,0,D
77957,21,HOL1,2021-11-28,Heerenveen,PSV Eindhoven,1,1,0,D
77958,21,HOL1,2021-11-28,Vitesse,AZ Alkmaar,0,0,0,D
77959,21,HOL1,2021-12-01,Feyenoord Rotterdam,Heracles,2,1,1,W
77960,21,HOL1,2021-12-02,AZ Alkmaar,For Sittard,2,1,1,W
77961,21,HOL1,2021-12-02,Ajax Amsterdam,Willem II,5,0,5,W
77962,21,HOL1,2021-12-03,Groningen,Zwolle,1,1,0,D
77963,21,HOL1,2021-12-04,PSV Eindhoven,Utrecht,4,1,3,W
77964,21,HOL1,2021-12-04,Cambuur,Vitesse,1,6,-5,L
77965,21,HOL1,2021-12-04,Heracles,Heerenveen,0,1,-1,L
77966,21,HOL1,2021-12-05,Waalwijk,NEC Nijmegen,2,1,1,W
77967,21,HOL1,2021-12-05,AZ Alkmaar,Sparta Rotterdam,3,1,2,W
77968,21,HOL1,2021-12-05,Go Ahead Eagles,Twente Enschede,1,2,-1,L
77969,21,HOL1,2021-12-05,Feyenoord Rotterdam,For Sittard,5,0,5,W
77970,21,HOL1,2021-12-10,Willem II,Cambuur,1,3,-2,L
77971,21,HOL1,2021-12-11,Utrecht,Go Ahead Eagles,0,0,0,D
77972,21,HOL1,2021-12-11,Heerenveen,Sparta Rotterdam,0,0,0,D
77973,21,HOL1,2021-12-11,Zwolle,For Sittard,0,1,-1,L
77974,21,HOL1,2021-12-12,Twente Enschede,Waalwijk,2,1,1,W
77975,21,HOL1,2021-12-12,Groningen,Feyenoord Rotterdam,1,1,0,D
77976,21,HOL1,2021-12-12,Vitesse,Heracles,2,1,1,W
77977,21,HOL1,2021-12-12,Ajax Amsterdam,AZ Alkmaar,1,2,-1,L
77978,21,HOL1,2021-12-12,NEC Nijmegen,PSV Eindhoven,1,2,-1,L
77979,21,HOL1,2021-12-18,For Sittard,Utrecht,2,2,0,D
77980,21,HOL1,2021-12-18,Sparta Rotterdam,Vitesse,2,2,0,D
77981,21,HOL1,2021-12-18,AZ Alkmaar,Willem II,4,1,3,W
77982,21,HOL1,2021-12-18,Heracles,Groningen,4,2,2,W
77983,21,HOL1,2021-12-18,Zwolle,Twente Enschede,1,3,-2,L
77984,21,HOL1,2021-12-19,Cambuur,Heerenveen,1,2,-1,L
77985,21,HOL1,2021-12-19,Feyenoord Rotterdam,Ajax Amsterdam,0,2,-2,L
77986,21,HOL1,2021-12-19,Go Ahead Eagles,NEC Nijmegen,0,2,-2,L
77987,21,HOL1,2021-12-19,Waalwijk,PSV Eindhoven,1,4,-3,L
77988,21,HOL1,2021-12-21,Vitesse,Zwolle,1,0,1,W
77989,21,HOL1,2021-12-21,AZ Alkmaar,Groningen,1,0,1,W
77990,21,HOL1,2021-12-22,Heerenveen,Feyenoord Rotterdam,0,3,-3,L
77991,21,HOL1,2021-12-22,Willem II,NEC Nijmegen,0,1,-1,L
77992,21,HOL1,2021-12-22,Heracles,Cambuur,1,1,0,D
77993,21,HOL1,2021-12-22,Utrecht,Twente Enschede,1,1,0,D
77994,21,HOL1,2021-12-22,Ajax Amsterdam,For Sittard,5,0,5,W
77995,21,HOL1,2021-12-23,PSV Eindhoven,Go Ahead Eagles,2,0,2,W
77996,21,HOL1,2021-12-23,Sparta Rotterdam,Waalwijk,1,1,0,D
77997,21,HOL1,2022-01-14,Zwolle,Willem II,2,0,2,W
77998,21,HOL1,2022-01-15,NEC Nijmegen,Heracles,0,0,0,D
77999,21,HOL1,2022-01-15,Feyenoord Rotterdam,Vitesse,0,1,-1,L
78000,21,HOL1,2022-01-15,Twente Enschede,Heerenveen,2,0,2,W
78001,21,HOL1,2022-01-15,Go Ahead Eagles,Waalwijk,0,2,-2,L
78002,21,HOL1,2022-01-16,Utrecht,Ajax Amsterdam,0,3,-3,L
78003,21,HOL1,2022-01-16,Groningen,PSV Eindhoven,0,1,-1,L
78004,21,HOL1,2022-01-16,Cambuur,Sparta Rotterdam,1,1,0,D
78005,21,HOL1,2022-01-16,For Sittard,AZ Alkmaar,1,2,-1,L
78006,21,HOL1,2022-01-22,Vitesse,Groningen,1,3,-2,L
78007,21,HOL1,2022-01-22,AZ Alkmaar,Cambuur,0,0,0,D
78008,21,HOL1,2022-01-22,Heerenveen,Zwolle,0,1,-1,L
78009,21,HOL1,2022-01-22,Willem II,Twente Enschede,0,1,-1,L
78010,21,HOL1,2022-01-23,NEC Nijmegen,Feyenoord Rotterdam,1,4,-3,L
78011,21,HOL1,2022-01-23,Heracles,Go Ahead Eagles,1,1,0,D
78012,21,HOL1,2022-01-23,PSV Eindhoven,Ajax Amsterdam,1,2,-1,L
78013,21,HOL1,2022-01-23,Sparta Rotterdam,Utrecht,0,3,-3,L
78014,21,HOL1,2022-01-23,Waalwijk,For Sittard,2,1,1,W
78015,21,HOL1,2022-02-05,Utrecht,Cambuur,3,2,1,W
78016,21,HOL1,2022-02-05,For Sittard,Heerenveen,2,0,2,W
78017,21,HOL1,2022-02-05,Zwolle,NEC Nijmegen,1,1,0,D
78018,21,HOL1,2022-02-05,PSV Eindhoven,AZ Alkmaar,1,2,-1,L
78019,21,HOL1,2022-02-05,Twente Enschede,Vitesse,3,0,3,W
78020,21,HOL1,2022-02-06,Feyenoord Rotterdam,Sparta Rotterdam,4,0,4,W
78021,21,HOL1,2022-02-06,Groningen,Go Ahead Eagles,2,1,1,W
78022,21,HOL1,2022-02-06,Willem II,Waalwijk,3,1,2,W
78023,21,HOL1,2022-02-06,Ajax Amsterdam,Heracles,3,0,3,W
78024,21,HOL1,2022-02-11,Heracles,Utrecht,1,0,1,W
78025,21,HOL1,2022-02-12,Groningen,For Sittard,0,1,-1,L
78026,21,HOL1,2022-02-12,Cambuur,Zwolle,3,4,-1,L
78027,21,HOL1,2022-02-12,Vitesse,PSV Eindhoven,0,5,-5,L
78028,21,HOL1,2022-02-13,Go Ahead Eagles,AZ Alkmaar,1,4,-3,L
78029,21,HOL1,2022-02-13,Sparta Rotterdam,Willem II,1,0,1,W
78030,21,HOL1,2022-02-13,Waalwijk,Feyenoord Rotterdam,0,2,-2,L
78031,21,HOL1,2022-02-13,Heerenveen,NEC Nijmegen,0,1,-1,L
78032,21,HOL1,2022-02-13,Ajax Amsterdam,Twente Enschede,5,0,5,W
78033,21,HOL1,2022-02-19,NEC Nijmegen,Waalwijk,1,1,0,D
78034,21,HOL1,2022-02-19,Willem II,Ajax Amsterdam,0,1,-1,L
78035,21,HOL1,2022-02-19,AZ Alkmaar,Heracles,2,1,1,W
78036,21,HOL1,2022-02-20,Zwolle,Groningen,1,1,0,D
78037,21,HOL1,2022-02-20,Feyenoord Rotterdam,Cambuur,3,1,2,W
78038,21,HOL1,2022-02-20,Twente Enschede,Go Ahead Eagles,2,2,0,D
78039,21,HOL1,2022-02-20,Utrecht,Vitesse,1,1,0,D
78040,21,HOL1,2022-02-20,PSV Eindhoven,Heerenveen,3,1,2,W
78041,21,HOL1,2022-02-25,Waalwijk,Twente Enschede,1,2,-1,L
78042,21,HOL1,2022-02-26,Heracles,Zwolle,2,0,2,W
78043,21,HOL1,2022-02-26,Groningen,Willem II,1,0,1,W
78044,21,HOL1,2022-02-26,Cambuur,For Sittard,2,1,1,W
78045,21,HOL1,2022-02-27,AZ Alkmaar,Feyenoord Rotterdam,2,1,1,W
78046,21,HOL1,2022-02-27,Vitesse,NEC Nijmegen,4,1,3,W
78047,21,HOL1,2022-02-27,Sparta Rotterdam,PSV Eindhoven,1,2,-1,L
78048,21,HOL1,2022-02-27,Go Ahead Eagles,Ajax Amsterdam,2,1,1,W
78049,21,HOL1,2022-02-27,Heerenveen,Utrecht,1,2,-1,L
78050,21,HOL1,2022-03-05,Willem II,Heerenveen,0,0,0,D
78051,21,HOL1,2022-03-05,Go Ahead Eagles,Utrecht,1,1,0,D
78052,21,HOL1,2022-03-05,Feyenoord Rotterdam,Groningen,1,1,0,D
78053,21,HOL1,2022-03-06,PSV Eindhoven,Heracles,3,1,2,W
78054,21,HOL1,2022-03-06,Twente Enschede,Cambuur,1,0,1,W
78055,21,HOL1,2022-03-06,Ajax Amsterdam,Waalwijk,3,2,1,W
78056,21,HOL1,2022-03-06,NEC Nijmegen,AZ Alkmaar,1,3,-2,L
78057,21,HOL1,2022-03-06,For Sittard,Zwolle,0,1,-1,L
78058,21,HOL1,2022-03-11,Cambuur,Ajax Amsterdam,2,3,-1,L
78059,21,HOL1,2022-03-12,Sparta Rotterdam,Go Ahead Eagles,1,0,1,W
78060,21,HOL1,2022-03-12,Groningen,NEC Nijmegen,4,3,1,W
78061,21,HOL1,2022-03-12,Waalwijk,Heerenveen,0,0,0,D
78062,21,HOL1,2022-03-13,For Sittard,Willem II,1,0,1,W
78063,21,HOL1,2022-03-13,Utrecht,PSV Eindhoven,0,1,-1,L
78064,21,HOL1,2022-03-13,Heracles,Vitesse,0,0,0,D
78065,21,HOL1,2022-03-13,Zwolle,Feyenoord Rotterdam,1,2,-1,L
78066,21,HOL1,2022-03-13,AZ Alkmaar,Twente Enschede,0,1,-1,L
78067,21,HOL1,2022-03-18,Heerenveen,Heracles,2,0,2,W
78068,21,HOL1,2022-03-19,Go Ahead Eagles,Cambuur,3,0,3,W
78069,21,HOL1,2022-03-19,Twente Enschede,Zwolle,1,0,1,W
78070,21,HOL1,2022-03-19,NEC Nijmegen,Sparta Rotterdam,0,0,0,D
78071,21,HOL1,2022-03-20,Utrecht,Groningen,1,3,-2,L
78072,21,HOL1,2022-03-20,Ajax Amsterdam,Feyenoord Rotterdam,3,2,1,W
78073,21,HOL1,2022-03-20,PSV Eindhoven,For Sittard,5,0,5,W
78074,21,HOL1,2022-03-20,Vitesse,Waalwijk,1,2,-1,L
78075,21,HOL1,2022-03-20,Willem II,AZ Alkmaar,2,2,0,D
78076,21,HOL1,2022-04-02,Groningen,Ajax Amsterdam,1,3,-2,L
78077,21,HOL1,2022-04-02,Twente Enschede,PSV Eindhoven,3,3,0,D
78078,21,HOL1,2022-04-02,AZ Alkmaar,Vitesse,3,1,2,W
78079,21,HOL1,2022-04-02,Waalwijk,Utrecht,1,1,0,D
78080,21,HOL1,2022-04-02,Feyenoord Rotterdam,Willem II,2,0,2,W
78081,21,HOL1,2022-04-03,Zwolle,Go Ahead Eagles,0,1,-1,L
78082,21,HOL1,2022-04-03,For Sittard,Heracles,0,2,-2,L
78083,21,HOL1,2022-04-03,Sparta Rotterdam,Heerenveen,1,1,0,D
78084,21,HOL1,2022-04-03,Cambuur,NEC Nijmegen,1,2,-1,L
78085,21,HOL1,2022-04-08,Go Ahead Eagles,Willem II,4,0,4,W
78086,21,HOL1,2022-04-09,Utrecht,For Sittard,1,1,0,D
78087,21,HOL1,2022-04-09,Ajax Amsterdam,Sparta Rotterdam,2,1,1,W
78088,21,HOL1,2022-04-09,NEC Nijmegen,Twente Enschede,0,2,-2,L
78089,21,HOL1,2022-04-10,Heerenveen,Groningen,3,1,2,W
78090,21,HOL1,2022-04-10,PSV Eindhoven,Waalwijk,2,0,2,W
78091,21,HOL1,2022-04-10,Vitesse,Cambuur,1,0,1,W
78092,21,HOL1,2022-04-10,Heracles,Feyenoord Rotterdam,1,4,-3,L
78093,21,HOL1,2022-04-10,Zwolle,AZ Alkmaar,2,1,1,W
78094,21,HOL1,2022-04-16,For Sittard,Sparta Rotterdam,3,0,3,W
78095,21,HOL1,2022-04-19,Vitesse,Sparta Rotterdam,0,1,-1,L
78096,21,HOL1,2022-04-22,Twente Enschede,Sparta Rotterdam,2,0,2,W
78097,21,HOL1,2022-04-23,NEC Nijmegen,Ajax Amsterdam,0,1,-1,L
78098,21,HOL1,2022-04-23,AZ Alkmaar,Heerenveen,2,1,1,W
78099,21,HOL1,2022-04-23,Waalwijk,Zwolle,0,2,-2,L
78100,21,HOL1,2022-04-23,Cambuur,PSV Eindhoven,1,2,-1,L
78101,21,HOL1,2022-04-24,Willem II,Vitesse,1,0,1,W
78102,21,HOL1,2022-04-24,Groningen,Heracles,0,1,-1,L
78103,21,HOL1,2022-04-24,Feyenoord Rotterdam,Utrecht,2,1,1,W
78104,21,HOL1,2022-04-24,For Sittard,Go Ahead Eagles,1,0,1,W
78105,21,HOL1,2022-04-29,Utrecht,NEC Nijmegen,1,0,1,W
78106,21,HOL1,2022-04-30,Ajax Amsterdam,Zwolle,3,0,3,W
78107,21,HOL1,2022-04-30,Heracles,Twente Enschede,1,1,0,D
78108,21,HOL1,2022-04-30,Sparta Rotterdam,AZ Alkmaar,1,1,0,D
78109,21,HOL1,2022-05-01,Heerenveen,Cambuur,3,3,0,D
78110,21,HOL1,2022-05-01,Go Ahead Eagles,Vitesse,1,2,-1,L
78111,21,HOL1,2022-05-01,PSV Eindhoven,Willem II,4,2,2,W
78112,21,HOL1,2022-05-01,For Sittard,Feyenoord Rotterdam,1,3,-2,L
78113,21,HOL1,2022-05-01,Waalwijk,Groningen,3,1,2,W
78114,21,HOL1,2022-05-06,Cambuur,Waalwijk,1,1,0,D
78115,21,HOL1,2022-05-07,Twente Enschede,For Sittard,1,2,-1,L
78116,21,HOL1,2022-05-07,Zwolle,Utrecht,1,1,0,D
78117,21,HOL1,2022-05-07,Willem II,Heracles,2,0,2,W
78118,21,HOL1,2022-05-07,Groningen,Sparta Rotterdam,1,2,-1,L
78119,21,HOL1,2022-05-08,NEC Nijmegen,Go Ahead Eagles,1,0,1,W
78120,21,HOL1,2022-05-08,AZ Alkmaar,Ajax Amsterdam,2,2,0,D
78121,21,HOL1,2022-05-08,Vitesse,Heerenveen,1,2,-1,L
78122,21,HOL1,2022-05-08,Feyenoord Rotterdam,PSV Eindhoven,2,2,0,D
78123,21,HOL1,2022-05-11,Ajax Amsterdam,Heerenveen,5,0,5,W
78124,21,HOL1,2022-05-11,Utrecht,AZ Alkmaar,2,2,0,D
78125,21,HOL1,2022-05-11,For Sittard,Vitesse,1,2,-1,L
78126,21,HOL1,2022-05-11,Go Ahead Eagles,Feyenoord Rotterdam,0,1,-1,L
78127,21,HOL1,2022-05-11,PSV Eindhoven,NEC Nijmegen,3,2,1,W
78128,21,HOL1,2022-05-11,Waalwijk,Heracles,2,0,2,W
78129,21,HOL1,2022-05-11,Cambuur,Willem II,1,1,0,D
78130,21,HOL1,2022-05-11,Sparta Rotterdam,Zwolle,2,0,2,W
78131,21,HOL1,2022-05-11,Twente Enschede,Groningen,3,0,3,W
78132,21,HOL1,2022-05-15,AZ Alkmaar,Waalwijk,1,3,-2,L
78133,21,HOL1,2022-05-15,Groningen,Cambuur,2,3,-1,L
78134,21,HOL1,2022-05-15,Feyenoord Rotterdam,Twente Enschede,1,2,-1,L
78135,21,HOL1,2022-05-15,Heracles,Sparta Rotterdam,1,3,-2,L
78136,21,HOL1,2022-05-15,NEC Nijmegen,For Sittard,0,1,-1,L
78137,21,HOL1,2022-05-15,Zwolle,PSV Eindhoven,1,2,-1,L
78138,21,HOL1,2022-05-15,Heerenveen,Go Ahead Eagles,3,1,2,W
78139,21,HOL1,2022-05-15,Vitesse,Ajax Amsterdam,2,2,0,D
78140,21,HOL1,2022-05-15,Willem II,Utrecht,3,0,3,W
78141,22,HOL1,2022-08-05,Heerenveen,Sparta Rotterdam,0,0,0,D
78142,22,HOL1,2022-08-06,For Sittard,Ajax Amsterdam,2,3,-1,L
78143,22,HOL1,2022-08-06,Cambuur,Excelsior,0,2,-2,L
78144,22,HOL1,2022-08-06,PSV Eindhoven,FC Emmen,4,1,3,W
78145,22,HOL1,2022-08-06,Waalwijk,Utrecht,2,2,0,D
78146,22,HOL1,2022-08-07,Groningen,Volendam,2,2,0,D
78147,22,HOL1,2022-08-07,Vitesse,Feyenoord Rotterdam,2,5,-3,L
78148,22,HOL1,2022-08-07,NEC Nijmegen,Twente Enschede,0,1,-1,L
78149,22,HOL1,2022-08-07,AZ Alkmaar,Go Ahead Eagles,2,0,2,W
78150,22,HOL1,2022-08-12,Excelsior,Vitesse,3,1,2,W
78151,22,HOL1,2022-08-13,Go Ahead Eagles,PSV Eindhoven,2,5,-3,L
78152,22,HOL1,2022-08-13,FC Emmen,Waalwijk,1,1,0,D
78153,22,HOL1,2022-08-13,Utrecht,Cambuur,0,0,0,D
78154,22,HOL1,2022-08-13,Feyenoord Rotterdam,Heerenveen,0,0,0,D
78155,22,HOL1,2022-08-14,Volendam,NEC Nijmegen,1,4,-3,L
78156,22,HOL1,2022-08-14,Ajax Amsterdam,Groningen,6,1,5,W
78157,22,HOL1,2022-08-14,Twente Enschede,For Sittard,3,0,3,W
78158,22,HOL1,2022-08-14,Sparta Rotterdam,AZ Alkmaar,2,3,-1,L
78159,22,HOL1,2022-08-20,Vitesse,Heerenveen,0,4,-4,L
78160,22,HOL1,2022-08-20,For Sittard,Cambuur,1,4,-3,L
78161,22,HOL1,2022-08-20,FC Emmen,Utrecht,3,2,1,W
78162,22,HOL1,2022-08-21,Groningen,Go Ahead Eagles,1,0,1,W
78163,22,HOL1,2022-08-21,Sparta Rotterdam,Ajax Amsterdam,0,1,-1,L
78164,22,HOL1,2022-08-21,Waalwijk,Feyenoord Rotterdam,0,1,-1,L
78165,22,HOL1,2022-08-26,NEC Nijmegen,Groningen,1,1,0,D
78166,22,HOL1,2022-08-27,Go Ahead Eagles,Sparta Rotterdam,0,1,-1,L
78167,22,HOL1,2022-08-27,Vitesse,Waalwijk,2,2,0,D
78168,22,HOL1,2022-08-27,Feyenoord Rotterdam,FC Emmen,4,0,4,W
78169,22,HOL1,2022-08-27,Heerenveen,For Sittard,2,1,1,W
78170,22,HOL1,2022-08-28,Utrecht,Ajax Amsterdam,0,2,-2,L
78171,22,HOL1,2022-08-28,Excelsior,PSV Eindhoven,1,6,-5,L
78172,22,HOL1,2022-08-28,Volendam,Twente Enschede,1,0,1,W
78173,22,HOL1,2022-08-28,Cambuur,AZ Alkmaar,0,1,-1,L
78174,22,HOL1,2022-08-31,PSV Eindhoven,Volendam,7,1,6,W
78175,22,HOL1,2022-08-31,Twente Enschede,Excelsior,4,0,4,W
78176,22,HOL1,2022-09-01,AZ Alkmaar,NEC Nijmegen,1,1,0,D
78177,22,HOL1,2022-09-02,For Sittard,Utrecht,3,4,-1,L
78178,22,HOL1,2022-09-03,Ajax Amsterdam,Cambuur,4,0,4,W
78179,22,HOL1,2022-09-03,Twente Enschede,PSV Eindhoven,2,1,1,W
78180,22,HOL1,2022-09-03,Sparta Rotterdam,Volendam,4,0,4,W
78181,22,HOL1,2022-09-03,Go Ahead Eagles,Feyenoord Rotterdam,3,4,-1,L
78182,22,HOL1,2022-09-04,Waalwijk,Excelsior,5,2,3,W
78183,22,HOL1,2022-09-04,FC Emmen,AZ Alkmaar,0,3,-3,L
78184,22,HOL1,2022-09-04,Heerenveen,NEC Nijmegen,0,0,0,D
78185,22,HOL1,2022-09-04,Groningen,Vitesse,0,1,-1,L
78186,22,HOL1,2022-09-09,Volendam,Go Ahead Eagles,2,3,-1,L
78187,22,HOL1,2022-09-10,NEC Nijmegen,For Sittard,1,1,0,D
78188,22,HOL1,2022-09-10,Ajax Amsterdam,Heerenveen,5,0,5,W
78189,22,HOL1,2022-09-10,Excelsior,FC Emmen,2,1,1,W
78190,22,HOL1,2022-09-11,Utrecht,Vitesse,1,0,1,W
78191,22,HOL1,2022-09-11,PSV Eindhoven,Waalwijk,1,0,1,W
78192,22,HOL1,2022-09-11,Cambuur,Groningen,0,1,-1,L
78193,22,HOL1,2022-09-11,AZ Alkmaar,Twente Enschede,1,1,0,D
78194,22,HOL1,2022-09-11,Feyenoord Rotterdam,Sparta Rotterdam,3,0,3,W
78195,22,HOL1,2022-09-16,Utrecht,NEC Nijmegen,0,0,0,D
78196,22,HOL1,2022-09-17,Sparta Rotterdam,Groningen,2,1,1,W
78197,22,HOL1,2022-09-17,Vitesse,Volendam,1,1,0,D
78198,22,HOL1,2022-09-17,Waalwijk,Cambuur,5,1,4,W
78199,22,HOL1,2022-09-17,For Sittard,Excelsior,1,0,1,W
78200,22,HOL1,2022-09-18,Go Ahead Eagles,FC Emmen,2,0,2,W
78201,22,HOL1,2022-09-18,PSV Eindhoven,Feyenoord Rotterdam,4,3,1,W
78202,22,HOL1,2022-09-18,Heerenveen,Twente Enschede,2,1,1,W
78203,22,HOL1,2022-09-18,AZ Alkmaar,Ajax Amsterdam,2,1,1,W
78204,22,HOL1,2022-10-01,Cambuur,PSV Eindhoven,3,0,3,W
78205,22,HOL1,2022-10-01,Groningen,AZ Alkmaar,1,4,-3,L
78206,22,HOL1,2022-10-01,Ajax Amsterdam,Go Ahead Eagles,1,1,0,D
78207,22,HOL1,2022-10-01,Twente Enschede,Vitesse,3,0,3,W
78208,22,HOL1,2022-10-02,For Sittard,Volendam,2,0,2,W
78209,22,HOL1,2022-10-02,Excelsior,Utrecht,0,1,-1,L
78210,22,HOL1,2022-10-02,NEC Nijmegen,Feyenoord Rotterdam,1,1,0,D
78211,22,HOL1,2022-10-02,Waalwijk,Sparta Rotterdam,2,2,0,D
78212,22,HOL1,2022-10-02,FC Emmen,Heerenveen,0,0,0,D
78213,22,HOL1,2022-10-07,Groningen,Waalwijk,2,3,-1,L
78214,22,HOL1,2022-10-08,Volendam,Ajax Amsterdam,2,4,-2,L
78215,22,HOL1,2022-10-08,Sparta Rotterdam,FC Emmen,3,1,2,W
78216,22,HOL1,2022-10-08,NEC Nijmegen,Excelsior,1,1,0,D
78217,22,HOL1,2022-10-09,Go Ahead Eagles,Cambuur,0,0,0,D
78218,22,HOL1,2022-10-09,Feyenoord Rotterdam,Twente Enschede,2,0,2,W
78219,22,HOL1,2022-10-09,Utrecht,AZ Alkmaar,1,2,-1,L
78220,22,HOL1,2022-10-09,Heerenveen,PSV Eindhoven,0,1,-1,L
78221,22,HOL1,2022-10-09,Vitesse,For Sittard,1,2,-1,L
78222,22,HOL1,2022-10-14,FC Emmen,Volendam,1,1,0,D
78223,22,HOL1,2022-10-15,For Sittard,Waalwijk,0,0,0,D
78224,22,HOL1,2022-10-15,Go Ahead Eagles,Heerenveen,1,1,0,D
78225,22,HOL1,2022-10-15,Cambuur,Vitesse,0,3,-3,L
78226,22,HOL1,2022-10-16,Sparta Rotterdam,NEC Nijmegen,2,0,2,W
78227,22,HOL1,2022-10-16,Twente Enschede,Groningen,3,0,3,W
78228,22,HOL1,2022-10-16,PSV Eindhoven,Utrecht,6,1,5,W
78229,22,HOL1,2022-10-16,AZ Alkmaar,Feyenoord Rotterdam,1,3,-2,L
78230,22,HOL1,2022-10-16,Ajax Amsterdam,Excelsior,7,1,6,W
78231,22,HOL1,2022-10-22,Feyenoord Rotterdam,For Sittard,1,1,0,D
78232,22,HOL1,2022-10-22,Waalwijk,Ajax Amsterdam,1,4,-3,L
78233,22,HOL1,2022-10-22,Vitesse,FC Emmen,2,1,1,W
78234,22,HOL1,2022-10-23,Excelsior,AZ Alkmaar,2,1,1,W
78235,22,HOL1,2022-10-23,Cambuur,Twente Enschede,0,1,-1,L
78236,22,HOL1,2022-10-23,Groningen,PSV Eindhoven,4,2,2,W
78237,22,HOL1,2022-10-23,NEC Nijmegen,Go Ahead Eagles,3,3,0,D
78238,22,HOL1,2022-10-23,Utrecht,Sparta Rotterdam,3,1,2,W
78239,22,HOL1,2022-10-23,Volendam,Heerenveen,1,3,-2,L
78240,22,HOL1,2022-10-29,Heerenveen,Utrecht,1,2,-1,L
78241,22,HOL1,2022-10-29,Sparta Rotterdam,For Sittard,3,1,2,W
78242,22,HOL1,2022-10-29,Go Ahead Eagles,Excelsior,3,1,2,W
78243,22,HOL1,2022-10-30,FC Emmen,Groningen,0,0,0,D
78244,22,HOL1,2022-10-30,Twente Enschede,Waalwijk,3,0,3,W
78245,22,HOL1,2022-10-30,PSV Eindhoven,NEC Nijmegen,3,0,3,W
78246,22,HOL1,2022-10-30,AZ Alkmaar,Volendam,2,1,1,W
78247,22,HOL1,2022-11-04,Cambuur,NEC Nijmegen,0,1,-1,L
78248,22,HOL1,2022-11-05,Vitesse,Sparta Rotterdam,0,4,-4,L
78249,22,HOL1,2022-11-05,For Sittard,FC Emmen,0,1,-1,L
78250,22,HOL1,2022-11-05,Excelsior,Heerenveen,0,1,-1,L
78251,22,HOL1,2022-11-06,Utrecht,Groningen,2,1,1,W
78252,22,HOL1,2022-11-06,Twente Enschede,Go Ahead Eagles,1,1,0,D
78253,22,HOL1,2022-11-06,Volendam,Feyenoord Rotterdam,0,2,-2,L
78254,22,HOL1,2022-11-06,Ajax Amsterdam,PSV Eindhoven,1,2,-1,L
78255,22,HOL1,2022-11-06,Waalwijk,AZ Alkmaar,3,1,2,W
78256,22,HOL1,2022-11-09,Ajax Amsterdam,Vitesse,2,2,0,D
78257,22,HOL1,2022-11-10,Feyenoord Rotterdam,Cambuur,1,0,1,W
78258,22,HOL1,2022-11-11,Sparta Rotterdam,Twente Enschede,1,1,0,D
78259,22,HOL1,2022-11-12,Volendam,Utrecht,0,4,-4,L
78260,22,HOL1,2022-11-12,FC Emmen,Ajax Amsterdam,3,3,0,D
78261,22,HOL1,2022-11-12,PSV Eindhoven,AZ Alkmaar,0,1,-1,L
78262,22,HOL1,2022-11-13,NEC Nijmegen,Waalwijk,6,1,5,W
78263,22,HOL1,2022-11-13,Groningen,For Sittard,2,3,-1,L
78264,22,HOL1,2022-11-13,Heerenveen,Cambuur,2,1,1,W
78265,22,HOL1,2022-11-13,Feyenoord Rotterdam,Excelsior,5,1,4,W
78266,22,HOL1,2022-11-13,Go Ahead Eagles,Vitesse,2,2,0,D
78267,22,HOL1,2023-01-06,Twente Enschede,FC Emmen,2,0,2,W
78268,22,HOL1,2023-01-07,Waalwijk,Heerenveen,0,0,0,D
78269,22,HOL1,2023-01-07,AZ Alkmaar,Vitesse,1,1,0,D
78270,22,HOL1,2023-01-07,For Sittard,Go Ahead Eagles,0,2,-2,L
78271,22,HOL1,2023-01-07,PSV Eindhoven,Sparta Rotterdam,0,0,0,D
78272,22,HOL1,2023-01-08,Utrecht,Feyenoord Rotterdam,1,1,0,D
78273,22,HOL1,2023-01-08,NEC Nijmegen,Ajax Amsterdam,1,1,0,D
78274,22,HOL1,2023-01-08,Cambuur,Volendam,0,3,-3,L
78275,22,HOL1,2023-01-08,Excelsior,Groningen,1,0,1,W
78276,22,HOL1,2023-01-14,Heerenveen,AZ Alkmaar,0,2,-2,L
78277,22,HOL1,2023-01-14,Volendam,Waalwijk,2,1,1,W
78278,22,HOL1,2023-01-14,Sparta Rotterdam,Excelsior,1,0,1,W
78279,22,HOL1,2023-01-14,Ajax Amsterdam,Twente Enschede,0,0,0,D
78280,22,HOL1,2023-01-15,Vitesse,NEC Nijmegen,0,0,0,D
78281,22,HOL1,2023-01-15,For Sittard,PSV Eindhoven,2,2,0,D
78282,22,HOL1,2023-01-15,Go Ahead Eagles,Utrecht,2,2,0,D
78283,22,HOL1,2023-01-15,Groningen,Feyenoord Rotterdam,0,3,-3,L
78284,22,HOL1,2023-01-15,FC Emmen,Cambuur,0,0,0,D
78285,22,HOL1,2023-01-20,Excelsior,Volendam,2,0,2,W
78286,22,HOL1,2023-01-21,NEC Nijmegen,FC Emmen,3,1,2,W
78287,22,HOL1,2023-01-21,PSV Eindhoven,Vitesse,1,0,1,W
78288,22,HOL1,2023-01-21,Cambuur,Sparta Rotterdam,0,3,-3,L
78289,22,HOL1,2023-01-22,Heerenveen,Groningen,3,1,2,W
78290,22,HOL1,2023-01-22,Twente Enschede,Utrecht,2,0,2,W
78291,22,HOL1,2023-01-22,Feyenoord Rotterdam,Ajax Amsterdam,1,1,0,D
78292,22,HOL1,2023-01-22,AZ Alkmaar,For Sittard,3,1,2,W
78293,22,HOL1,2023-01-24,FC Emmen,PSV Eindhoven,1,0,1,W
78294,22,HOL1,2023-01-24,Sparta Rotterdam,Waalwijk,0,0,0,D
78295,22,HOL1,2023-01-25,Go Ahead Eagles,AZ Alkmaar,1,4,-3,L
78296,22,HOL1,2023-01-25,Vitesse,Twente Enschede,2,2,0,D
78297,22,HOL1,2023-01-25,For Sittard,Heerenveen,2,0,2,W
78298,22,HOL1,2023-01-25,Utrecht,Excelsior,1,0,1,W
78299,22,HOL1,2023-01-25,Feyenoord Rotterdam,NEC Nijmegen,2,0,2,W
78300,22,HOL1,2023-01-26,Groningen,Cambuur,0,1,-1,L
78301,22,HOL1,2023-01-26,Ajax Amsterdam,Volendam,1,1,0,D
78302,22,HOL1,2023-01-28,PSV Eindhoven,Go Ahead Eagles,2,0,2,W
78303,22,HOL1,2023-01-28,Waalwijk,FC Emmen,2,0,2,W
78304,22,HOL1,2023-01-28,Heerenveen,Vitesse,1,3,-2,L
78305,22,HOL1,2023-01-28,NEC Nijmegen,Sparta Rotterdam,1,1,0,D
78306,22,HOL1,2023-01-28,AZ Alkmaar,Utrecht,5,5,0,D
78307,22,HOL1,2023-01-29,Twente Enschede,Feyenoord Rotterdam,1,1,0,D
78308,22,HOL1,2023-01-29,Excelsior,Ajax Amsterdam,1,4,-3,L
78309,22,HOL1,2023-01-29,Volendam,Groningen,3,2,1,W
78310,22,HOL1,2023-01-29,Cambuur,For Sittard,1,2,-1,L
78311,22,HOL1,2023-02-01,Waalwijk,Go Ahead Eagles,3,1,2,W
78312,22,HOL1,2023-02-03,For Sittard,Sparta Rotterdam,0,0,0,D
78313,22,HOL1,2023-02-04,Volendam,AZ Alkmaar,1,1,0,D
78314,22,HOL1,2023-02-04,FC Emmen,Vitesse,2,2,0,D
78315,22,HOL1,2023-02-04,Utrecht,Heerenveen,1,0,1,W
78316,22,HOL1,2023-02-04,Excelsior,Waalwijk,0,0,0,D
78317,22,HOL1,2023-02-05,Cambuur,Ajax Amsterdam,0,5,-5,L
78318,22,HOL1,2023-02-05,Feyenoord Rotterdam,PSV Eindhoven,2,2,0,D
78319,22,HOL1,2023-02-05,Go Ahead Eagles,NEC Nijmegen,1,0,1,W
78320,22,HOL1,2023-02-05,Groningen,Twente Enschede,1,1,0,D
78321,22,HOL1,2023-02-10,AZ Alkmaar,Excelsior,5,0,5,W
78322,22,HOL1,2023-02-11,NEC Nijmegen,Cambuur,0,0,0,D
78323,22,HOL1,2023-02-11,PSV Eindhoven,Groningen,6,0,6,W
78324,22,HOL1,2023-02-11,FC Emmen,For Sittard,0,1,-1,L
78325,22,HOL1,2023-02-12,Sparta Rotterdam,Go Ahead Eagles,2,1,1,W
78326,22,HOL1,2023-02-12,Heerenveen,Feyenoord Rotterdam,1,2,-1,L
78327,22,HOL1,2023-02-12,Vitesse,Utrecht,2,0,2,W
78328,22,HOL1,2023-02-12,Ajax Amsterdam,Waalwijk,3,1,2,W
78329,22,HOL1,2023-02-12,Twente Enschede,Volendam,3,0,3,W
78330,22,HOL1,2023-02-17,Waalwijk,For Sittard,3,1,2,W
78331,22,HOL1,2023-02-18,Volendam,Vitesse,2,0,2,W
78332,22,HOL1,2023-02-18,Groningen,FC Emmen,1,1,0,D
78333,22,HOL1,2023-02-18,Feyenoord Rotterdam,AZ Alkmaar,2,1,1,W
78334,22,HOL1,2023-02-19,Cambuur,Heerenveen,1,2,-1,L
78335,22,HOL1,2023-02-19,Utrecht,PSV Eindhoven,2,2,0,D
78336,22,HOL1,2023-02-19,Go Ahead Eagles,Twente Enschede,2,0,2,W
78337,22,HOL1,2023-02-19,Ajax Amsterdam,Sparta Rotterdam,4,0,4,W
78338,22,HOL1,2023-02-19,Excelsior,NEC Nijmegen,0,3,-3,L
78339,22,HOL1,2023-02-24,Sparta Rotterdam,Utrecht,0,3,-3,L
78340,22,HOL1,2023-02-25,Groningen,Excelsior,3,0,3,W
78341,22,HOL1,2023-02-25,Heerenveen,Waalwijk,1,4,-3,L
78342,22,HOL1,2023-02-25,AZ Alkmaar,Cambuur,2,1,1,W
78343,22,HOL1,2023-02-25,NEC Nijmegen,Volendam,3,0,3,W
78344,22,HOL1,2023-02-26,For Sittard,Feyenoord Rotterdam,2,4,-2,L
78345,22,HOL1,2023-02-26,FC Emmen,Go Ahead Eagles,2,2,0,D
78346,22,HOL1,2023-02-26,Vitesse,Ajax Amsterdam,1,2,-1,L
78347,22,HOL1,2023-02-26,PSV Eindhoven,Twente Enschede,3,1,2,W
78348,22,HOL1,2023-03-03,Utrecht,For Sittard,1,2,-1,L
78349,22,HOL1,2023-03-03,Vitesse,AZ Alkmaar,0,1,-1,L
78350,22,HOL1,2023-03-04,Volendam,FC Emmen,3,1,2,W
78351,22,HOL1,2023-03-04,Feyenoord Rotterdam,Groningen,1,0,1,W
78352,22,HOL1,2023-03-04,Twente Enschede,Heerenveen,3,3,0,D
78353,22,HOL1,2023-03-05,Excelsior,Sparta Rotterdam,1,4,-3,L
78354,22,HOL1,2023-03-05,Waalwijk,PSV Eindhoven,0,1,-1,L
78355,22,HOL1,2023-03-05,Ajax Amsterdam,NEC Nijmegen,1,0,1,W
78356,22,HOL1,2023-03-05,Cambuur,Go Ahead Eagles,4,1,3,W
78357,22,HOL1,2023-03-11,FC Emmen,Excelsior,2,0,2,W
78358,22,HOL1,2023-03-11,For Sittard,Twente Enschede,0,3,-3,L
78359,22,HOL1,2023-03-11,AZ Alkmaar,Groningen,1,0,1,W
78360,22,HOL1,2023-03-11,Sparta Rotterdam,Vitesse,3,1,2,W
78361,22,HOL1,2023-03-12,NEC Nijmegen,Utrecht,2,2,0,D
78362,22,HOL1,2023-03-12,Heerenveen,Ajax Amsterdam,2,4,-2,L
78363,22,HOL1,2023-03-12,PSV Eindhoven,Cambuur,5,2,3,W
78364,22,HOL1,2023-03-12,Feyenoord Rotterdam,Volendam,2,1,1,W
78365,22,HOL1,2023-03-17,Volendam,For Sittard,2,1,1,W
78366,22,HOL1,2023-03-18,Utrecht,Go Ahead Eagles,1,2,-1,L
78367,22,HOL1,2023-03-18,FC Emmen,Sparta Rotterdam,0,2,-2,L
78368,22,HOL1,2023-03-18,Waalwijk,NEC Nijmegen,1,3,-2,L
78369,22,HOL1,2023-03-19,Groningen,Heerenveen,0,2,-2,L
78370,22,HOL1,2023-03-19,Ajax Amsterdam,Feyenoord Rotterdam,2,3,-1,L
78371,22,HOL1,2023-03-19,Excelsior,Cambuur,4,1,3,W
78372,22,HOL1,2023-03-19,Vitesse,PSV Eindhoven,1,1,0,D
78373,22,HOL1,2023-03-19,Twente Enschede,AZ Alkmaar,2,1,1,W
78374,22,HOL1,2023-04-01,AZ Alkmaar,Heerenveen,1,1,0,D
78375,22,HOL1,2023-04-01,Excelsior,Twente Enschede,0,0,0,D
78376,22,HOL1,2023-04-01,NEC Nijmegen,PSV Eindhoven,2,4,-2,L
78377,22,HOL1,2023-04-01,Cambuur,FC Emmen,1,2,-1,L
78378,22,HOL1,2023-04-01,Waalwijk,Vitesse,1,0,1,W
78379,22,HOL1,2023-04-02,Go Ahead Eagles,Ajax Amsterdam,0,0,0,D
78380,22,HOL1,2023-04-02,Utrecht,Volendam,0,0,0,D
78381,22,HOL1,2023-04-02,Sparta Rotterdam,Feyenoord Rotterdam,1,3,-2,L
78382,22,HOL1,2023-04-02,For Sittard,Groningen,3,1,2,W
