,Sea,Lge,Date,HT,AT,HS,AS,GD,WDL
83500,0,SCO2,2000-08-05,Ayr United,Ross County,1,0,1,W
83501,0,SCO2,2000-08-05,Clyde,Falkirk,3,1,2,W
83502,0,SCO2,2000-08-05,Inverness CT,Airdrie United,2,0,2,W
83503,0,SCO2,2000-08-05,Greenock Morton,Livingston,0,2,-2,L
83504,0,SCO2,2000-08-05,Raith Rovers,Alloa Athletic,1,2,-1,L
83505,0,SCO2,2000-08-12,Airdrie United,Raith Rovers,1,1,0,D
83506,0,SCO2,2000-08-12,Alloa Athletic,Ayr United,1,1,0,D
83507,0,SCO2,2000-08-12,Falkirk,Greenock Morton,1,0,1,W
83508,0,SCO2,2000-08-12,Livingston,Inverness CT,3,1,2,W
83509,0,SCO2,2000-08-12,Ross County,Clyde,0,2,-2,L
83510,0,SCO2,2000-08-19,Ayr United,Airdrie United,3,1,2,W
83511,0,SCO2,2000-08-19,Clyde,Livingston,1,1,0,D
83512,0,SCO2,2000-08-19,Inverness CT,Falkirk,2,3,-1,L
83513,0,SCO2,2000-08-19,Greenock Morton,Alloa Athletic,2,0,2,W
83514,0,SCO2,2000-08-26,Alloa Athletic,Livingston,0,6,-6,L
83515,0,SCO2,2000-08-26,Ayr United,Falkirk,5,2,3,W
83516,0,SCO2,2000-08-26,Clyde,Greenock Morton,0,3,-3,L
83517,0,SCO2,2000-08-26,Raith Rovers,Inverness CT,4,1,3,W
83518,0,SCO2,2000-08-26,Ross County,Airdrie United,1,1,0,D
83519,0,SCO2,2000-09-02,Raith Rovers,Ross County,4,1,3,W
83520,0,SCO2,2000-09-09,Airdrie United,Alloa Athletic,2,2,0,D
83521,0,SCO2,2000-09-09,Falkirk,Raith Rovers,2,1,1,W
83522,0,SCO2,2000-09-09,Inverness CT,Clyde,1,2,-1,L
83523,0,SCO2,2000-09-09,Livingston,Ayr United,2,0,2,W
83524,0,SCO2,2000-09-09,Greenock Morton,Ross County,0,1,-1,L
83525,0,SCO2,2000-09-16,Clyde,Airdrie United,4,1,3,W
83526,0,SCO2,2000-09-16,Falkirk,Alloa Athletic,1,1,0,D
83527,0,SCO2,2000-09-16,Inverness CT,Ross County,0,1,-1,L
83528,0,SCO2,2000-09-16,Livingston,Raith Rovers,0,4,-4,L
83529,0,SCO2,2000-09-16,Greenock Morton,Ayr United,1,1,0,D
83530,0,SCO2,2000-09-23,Airdrie United,Livingston,1,2,-1,L
83531,0,SCO2,2000-09-23,Alloa Athletic,Inverness CT,1,4,-3,L
83532,0,SCO2,2000-09-23,Ayr United,Clyde,2,1,1,W
83533,0,SCO2,2000-09-23,Raith Rovers,Greenock Morton,0,1,-1,L
83534,0,SCO2,2000-09-23,Ross County,Falkirk,0,2,-2,L
83535,0,SCO2,2000-09-30,Ayr United,Inverness CT,3,3,0,D
83536,0,SCO2,2000-09-30,Clyde,Raith Rovers,0,0,0,D
83537,0,SCO2,2000-09-30,Falkirk,Livingston,3,2,1,W
83538,0,SCO2,2000-09-30,Greenock Morton,Airdrie United,1,5,-4,L
83539,0,SCO2,2000-09-30,Ross County,Alloa Athletic,1,0,1,W
83540,0,SCO2,2000-10-07,Airdrie United,Falkirk,1,2,-1,L
83541,0,SCO2,2000-10-07,Alloa Athletic,Clyde,3,1,2,W
83542,0,SCO2,2000-10-07,Inverness CT,Greenock Morton,4,0,4,W
83543,0,SCO2,2000-10-07,Livingston,Ross County,3,1,2,W
83544,0,SCO2,2000-10-07,Raith Rovers,Ayr United,1,3,-2,L
83545,0,SCO2,2000-10-14,Airdrie United,Inverness CT,1,2,-1,L
83546,0,SCO2,2000-10-14,Alloa Athletic,Raith Rovers,0,1,-1,L
83547,0,SCO2,2000-10-14,Falkirk,Clyde,3,2,1,W
83548,0,SCO2,2000-10-14,Livingston,Greenock Morton,1,0,1,W
83549,0,SCO2,2000-10-14,Ross County,Ayr United,1,1,0,D
83550,0,SCO2,2000-10-21,Ayr United,Alloa Athletic,3,1,2,W
83551,0,SCO2,2000-10-21,Clyde,Ross County,2,2,0,D
83552,0,SCO2,2000-10-21,Inverness CT,Livingston,2,2,0,D
83553,0,SCO2,2000-10-21,Greenock Morton,Falkirk,0,4,-4,L
83554,0,SCO2,2000-10-21,Raith Rovers,Airdrie United,1,1,0,D
83555,0,SCO2,2000-10-28,Airdrie United,Ross County,5,1,4,W
83556,0,SCO2,2000-10-28,Falkirk,Ayr United,3,0,3,W
83557,0,SCO2,2000-10-28,Inverness CT,Raith Rovers,1,2,-1,L
83558,0,SCO2,2000-10-28,Livingston,Alloa Athletic,4,0,4,W
83559,0,SCO2,2000-10-28,Greenock Morton,Clyde,1,1,0,D
83560,0,SCO2,2000-11-04,Alloa Athletic,Airdrie United,2,0,2,W
83561,0,SCO2,2000-11-04,Ayr United,Livingston,1,1,0,D
83562,0,SCO2,2000-11-04,Clyde,Inverness CT,1,1,0,D
83563,0,SCO2,2000-11-04,Raith Rovers,Falkirk,0,2,-2,L
83564,0,SCO2,2000-11-04,Ross County,Greenock Morton,3,1,2,W
83565,0,SCO2,2000-11-11,Clyde,Ayr United,0,1,-1,L
83566,0,SCO2,2000-11-11,Falkirk,Ross County,2,3,-1,L
83567,0,SCO2,2000-11-11,Inverness CT,Alloa Athletic,2,1,1,W
83568,0,SCO2,2000-11-11,Livingston,Airdrie United,2,2,0,D
83569,0,SCO2,2000-11-11,Greenock Morton,Raith Rovers,1,2,-1,L
83570,0,SCO2,2000-11-18,Alloa Athletic,Falkirk,3,2,1,W
83571,0,SCO2,2000-11-18,Ayr United,Greenock Morton,1,1,0,D
83572,0,SCO2,2000-11-18,Ross County,Inverness CT,0,3,-3,L
83573,0,SCO2,2000-11-22,Airdrie United,Clyde,1,3,-2,L
83574,0,SCO2,2000-11-25,Ayr United,Raith Rovers,4,2,2,W
83575,0,SCO2,2000-11-25,Clyde,Alloa Athletic,0,0,0,D
83576,0,SCO2,2000-11-25,Falkirk,Airdrie United,0,2,-2,L
83577,0,SCO2,2000-11-25,Greenock Morton,Inverness CT,2,0,2,W
83578,0,SCO2,2000-11-25,Ross County,Livingston,0,2,-2,L
83579,0,SCO2,2000-12-02,Airdrie United,Greenock Morton,1,1,0,D
83580,0,SCO2,2000-12-02,Alloa Athletic,Ross County,0,0,0,D
83581,0,SCO2,2000-12-02,Inverness CT,Ayr United,7,3,4,W
83582,0,SCO2,2000-12-02,Livingston,Falkirk,4,1,3,W
83583,0,SCO2,2000-12-02,Raith Rovers,Clyde,1,2,-1,L
83584,0,SCO2,2000-12-05,Raith Rovers,Livingston,1,2,-1,L
83585,0,SCO2,2000-12-09,Airdrie United,Ayr United,0,0,0,D
83586,0,SCO2,2000-12-09,Alloa Athletic,Greenock Morton,2,1,1,W
83587,0,SCO2,2000-12-09,Falkirk,Inverness CT,2,2,0,D
83588,0,SCO2,2000-12-09,Livingston,Clyde,2,0,2,W
83589,0,SCO2,2000-12-09,Ross County,Raith Rovers,0,0,0,D
83590,0,SCO2,2000-12-16,Ayr United,Ross County,0,2,-2,L
83591,0,SCO2,2000-12-16,Clyde,Falkirk,0,3,-3,L
83592,0,SCO2,2000-12-16,Inverness CT,Airdrie United,4,0,4,W
83593,0,SCO2,2000-12-16,Greenock Morton,Livingston,1,2,-1,L
83594,0,SCO2,2000-12-16,Raith Rovers,Alloa Athletic,2,1,1,W
83595,0,SCO2,2000-12-23,Inverness CT,Clyde,2,2,0,D
83596,0,SCO2,2000-12-26,Airdrie United,Alloa Athletic,2,1,1,W
83597,0,SCO2,2001-01-02,Clyde,Airdrie United,1,1,0,D
83598,0,SCO2,2001-01-02,Falkirk,Alloa Athletic,2,2,0,D
83599,0,SCO2,2001-01-02,Inverness CT,Ross County,3,3,0,D
83600,0,SCO2,2001-01-02,Livingston,Raith Rovers,2,0,2,W
83601,0,SCO2,2001-01-02,Greenock Morton,Ayr United,0,6,-6,L
83602,0,SCO2,2001-01-06,Airdrie United,Livingston,1,1,0,D
83603,0,SCO2,2001-01-06,Alloa Athletic,Inverness CT,1,1,0,D
83604,0,SCO2,2001-01-06,Ayr United,Clyde,2,0,2,W
83605,0,SCO2,2001-01-06,Raith Rovers,Greenock Morton,0,0,0,D
83606,0,SCO2,2001-01-13,Ayr United,Inverness CT,1,1,0,D
83607,0,SCO2,2001-01-13,Clyde,Raith Rovers,3,1,2,W
83608,0,SCO2,2001-01-13,Falkirk,Livingston,1,0,1,W
83609,0,SCO2,2001-01-13,Greenock Morton,Airdrie United,0,3,-3,L
83610,0,SCO2,2001-01-30,Alloa Athletic,Livingston,0,2,-2,L
83611,0,SCO2,2001-02-03,Ayr United,Airdrie United,2,2,0,D
83612,0,SCO2,2001-02-03,Clyde,Livingston,0,3,-3,L
83613,0,SCO2,2001-02-03,Inverness CT,Falkirk,1,1,0,D
83614,0,SCO2,2001-02-03,Greenock Morton,Alloa Athletic,1,1,0,D
83615,0,SCO2,2001-02-03,Raith Rovers,Ross County,0,4,-4,L
83616,0,SCO2,2001-02-10,Airdrie United,Raith Rovers,3,0,3,W
83617,0,SCO2,2001-02-17,Clyde,Greenock Morton,1,1,0,D
83618,0,SCO2,2001-02-17,Raith Rovers,Ayr United,1,4,-3,L
83619,0,SCO2,2001-02-24,Falkirk,Ayr United,1,2,-1,L
83620,0,SCO2,2001-02-24,Livingston,Alloa Athletic,1,0,1,W
83621,0,SCO2,2001-02-24,Greenock Morton,Clyde,0,1,-1,L
83622,0,SCO2,2001-03-03,Ayr United,Livingston,1,1,0,D
83623,0,SCO2,2001-03-06,Ayr United,Falkirk,6,0,6,W
83624,0,SCO2,2001-03-10,Alloa Athletic,Clyde,0,0,0,D
83625,0,SCO2,2001-03-10,Raith Rovers,Inverness CT,1,1,0,D
83626,0,SCO2,2001-03-10,Ross County,Falkirk,4,1,3,W
83627,0,SCO2,2001-03-13,Alloa Athletic,Ayr United,0,2,-2,L
83628,0,SCO2,2001-03-13,Inverness CT,Greenock Morton,4,2,2,W
83629,0,SCO2,2001-03-17,Clyde,Ayr United,2,2,0,D
83630,0,SCO2,2001-03-17,Falkirk,Ross County,1,1,0,D
83631,0,SCO2,2001-03-17,Inverness CT,Alloa Athletic,2,0,2,W
83632,0,SCO2,2001-03-17,Greenock Morton,Raith Rovers,1,1,0,D
83633,0,SCO2,2001-03-20,Livingston,Ayr United,0,1,-1,L
83634,0,SCO2,2001-03-20,Ross County,Clyde,2,0,2,W
83635,0,SCO2,2001-03-23,Inverness CT,Raith Rovers,2,0,2,W
83636,0,SCO2,2001-03-24,Airdrie United,Falkirk,1,2,-1,L
83637,0,SCO2,2001-03-24,Ross County,Alloa Athletic,2,3,-1,L
83638,0,SCO2,2001-03-27,Alloa Athletic,Airdrie United,6,0,6,W
83639,0,SCO2,2001-03-27,Clyde,Inverness CT,2,2,0,D
83640,0,SCO2,2001-03-27,Falkirk,Greenock Morton,1,3,-2,L
83641,0,SCO2,2001-03-27,Livingston,Ross County,1,1,0,D
83642,0,SCO2,2001-03-31,Airdrie United,Clyde,1,0,1,W
83643,0,SCO2,2001-03-31,Alloa Athletic,Falkirk,0,1,-1,L
83644,0,SCO2,2001-03-31,Ayr United,Greenock Morton,3,0,3,W
83645,0,SCO2,2001-03-31,Raith Rovers,Livingston,2,0,2,W
83646,0,SCO2,2001-03-31,Ross County,Inverness CT,0,1,-1,L
83647,0,SCO2,2001-04-03,Livingston,Inverness CT,4,1,3,W
83648,0,SCO2,2001-04-03,Raith Rovers,Falkirk,0,0,0,D
83649,0,SCO2,2001-04-03,Ross County,Airdrie United,3,4,-1,L
83650,0,SCO2,2001-04-07,Ayr United,Raith Rovers,2,0,2,W
83651,0,SCO2,2001-04-07,Clyde,Alloa Athletic,1,1,0,D
83652,0,SCO2,2001-04-07,Falkirk,Airdrie United,1,1,0,D
83653,0,SCO2,2001-04-07,Greenock Morton,Inverness CT,0,3,-3,L
83654,0,SCO2,2001-04-07,Ross County,Livingston,0,1,-1,L
83655,0,SCO2,2001-04-10,Airdrie United,Ross County,2,2,0,D
83656,0,SCO2,2001-04-10,Falkirk,Raith Rovers,2,0,2,W
83657,0,SCO2,2001-04-14,Airdrie United,Greenock Morton,0,2,-2,L
83658,0,SCO2,2001-04-14,Alloa Athletic,Ross County,1,1,0,D
83659,0,SCO2,2001-04-14,Inverness CT,Ayr United,1,0,1,W
83660,0,SCO2,2001-04-14,Raith Rovers,Clyde,0,1,-1,L
83661,0,SCO2,2001-04-17,Ross County,Greenock Morton,0,2,-2,L
83662,0,SCO2,2001-04-21,Airdrie United,Inverness CT,1,1,0,D
83663,0,SCO2,2001-04-21,Alloa Athletic,Raith Rovers,1,2,-1,L
83664,0,SCO2,2001-04-21,Falkirk,Clyde,1,1,0,D
83665,0,SCO2,2001-04-21,Livingston,Greenock Morton,2,0,2,W
83666,0,SCO2,2001-04-21,Ross County,Ayr United,0,1,-1,L
83667,0,SCO2,2001-04-24,Livingston,Falkirk,3,0,3,W
83668,0,SCO2,2001-04-24,Greenock Morton,Ross County,0,3,-3,L
83669,0,SCO2,2001-04-28,Ayr United,Alloa Athletic,4,1,3,W
83670,0,SCO2,2001-04-28,Clyde,Ross County,2,0,2,W
83671,0,SCO2,2001-04-28,Inverness CT,Livingston,2,3,-1,L
83672,0,SCO2,2001-04-28,Greenock Morton,Falkirk,2,1,1,W
83673,0,SCO2,2001-04-28,Raith Rovers,Airdrie United,5,0,5,W
83674,0,SCO2,2001-05-01,Livingston,Airdrie United,5,0,5,W
83675,0,SCO2,2001-05-05,Airdrie United,Ayr United,1,1,0,D
83676,0,SCO2,2001-05-05,Alloa Athletic,Greenock Morton,0,3,-3,L
83677,0,SCO2,2001-05-05,Falkirk,Inverness CT,2,1,1,W
83678,0,SCO2,2001-05-05,Livingston,Clyde,0,2,-2,L
83679,0,SCO2,2001-05-05,Ross County,Raith Rovers,4,0,4,W
83680,1,SCO2,2001-08-04,Airdrie United,Raith Rovers,2,2,0,D
83681,1,SCO2,2001-08-04,Clyde,Inverness CT,1,1,0,D
83682,1,SCO2,2001-08-04,Falkirk,Ayr United,1,2,-1,L
83683,1,SCO2,2001-08-04,Partick Thistle,St Mirren,3,3,0,D
83684,1,SCO2,2001-08-04,Ross County,Arbroath,0,2,-2,L
83685,1,SCO2,2001-08-11,Arbroath,Airdrie United,0,6,-6,L
83686,1,SCO2,2001-08-11,Ayr United,Ross County,2,0,2,W
83687,1,SCO2,2001-08-11,Inverness CT,Falkirk,1,2,-1,L
83688,1,SCO2,2001-08-11,Raith Rovers,Partick Thistle,1,2,-1,L
83689,1,SCO2,2001-08-11,St Mirren,Clyde,4,1,3,W
83690,1,SCO2,2001-08-18,Airdrie United,Ayr United,2,1,1,W
83691,1,SCO2,2001-08-18,Clyde,Arbroath,1,0,1,W
83692,1,SCO2,2001-08-18,Falkirk,St Mirren,3,2,1,W
83693,1,SCO2,2001-08-18,Partick Thistle,Inverness CT,1,0,1,W
83694,1,SCO2,2001-08-18,Ross County,Raith Rovers,1,0,1,W
83695,1,SCO2,2001-08-25,Arbroath,Partick Thistle,1,3,-2,L
83696,1,SCO2,2001-08-25,Ayr United,Raith Rovers,1,1,0,D
83697,1,SCO2,2001-08-25,Falkirk,Clyde,1,1,0,D
83698,1,SCO2,2001-08-25,Ross County,Airdrie United,0,1,-1,L
83699,1,SCO2,2001-08-25,St Mirren,Inverness CT,1,1,0,D
83700,1,SCO2,2001-09-08,Airdrie United,St Mirren,0,0,0,D
83701,1,SCO2,2001-09-08,Clyde,Ross County,3,0,3,W
83702,1,SCO2,2001-09-08,Inverness CT,Arbroath,5,1,4,W
83703,1,SCO2,2001-09-08,Partick Thistle,Ayr United,2,1,1,W
83704,1,SCO2,2001-09-08,Raith Rovers,Falkirk,5,2,3,W
83705,1,SCO2,2001-09-15,Airdrie United,Falkirk,2,1,1,W
83706,1,SCO2,2001-09-15,Ayr United,St Mirren,4,2,2,W
83707,1,SCO2,2001-09-15,Partick Thistle,Clyde,3,0,3,W
83708,1,SCO2,2001-09-15,Raith Rovers,Arbroath,3,1,2,W
83709,1,SCO2,2001-09-15,Ross County,Inverness CT,2,1,1,W
83710,1,SCO2,2001-09-18,Arbroath,Ayr United,3,2,1,W
83711,1,SCO2,2001-09-18,Clyde,Airdrie United,0,3,-3,L
83712,1,SCO2,2001-09-18,Falkirk,Partick Thistle,1,1,0,D
83713,1,SCO2,2001-09-18,St Mirren,Ross County,1,0,1,W
83714,1,SCO2,2001-09-19,Inverness CT,Raith Rovers,5,2,3,W
83715,1,SCO2,2001-09-22,Airdrie United,Inverness CT,6,0,6,W
83716,1,SCO2,2001-09-22,Arbroath,Falkirk,1,0,1,W
83717,1,SCO2,2001-09-22,Raith Rovers,St Mirren,3,0,3,W
83718,1,SCO2,2001-09-22,Ross County,Partick Thistle,3,2,1,W
83719,1,SCO2,2001-09-23,Ayr United,Clyde,2,1,1,W
83720,1,SCO2,2001-09-29,Clyde,Raith Rovers,3,2,1,W
83721,1,SCO2,2001-09-29,Falkirk,Ross County,4,2,2,W
83722,1,SCO2,2001-09-29,Inverness CT,Ayr United,3,1,2,W
83723,1,SCO2,2001-09-29,Partick Thistle,Airdrie United,1,1,0,D
83724,1,SCO2,2001-09-29,St Mirren,Arbroath,1,0,1,W
83725,1,SCO2,2001-10-06,Raith Rovers,Airdrie United,2,2,0,D
83726,1,SCO2,2001-10-13,Arbroath,Ross County,2,1,1,W
83727,1,SCO2,2001-10-13,Ayr United,Falkirk,2,2,0,D
83728,1,SCO2,2001-10-13,Inverness CT,Clyde,5,1,4,W
83729,1,SCO2,2001-10-13,St Mirren,Partick Thistle,1,0,1,W
83730,1,SCO2,2001-10-20,Airdrie United,Arbroath,3,1,2,W
83731,1,SCO2,2001-10-20,Clyde,St Mirren,1,1,0,D
83732,1,SCO2,2001-10-20,Falkirk,Inverness CT,1,2,-1,L
83733,1,SCO2,2001-10-20,Partick Thistle,Raith Rovers,2,1,1,W
83734,1,SCO2,2001-10-20,Ross County,Ayr United,3,2,1,W
83735,1,SCO2,2001-10-27,Arbroath,Inverness CT,3,2,1,W
83736,1,SCO2,2001-10-27,Ayr United,Partick Thistle,0,2,-2,L
83737,1,SCO2,2001-10-27,Falkirk,Raith Rovers,1,0,1,W
83738,1,SCO2,2001-10-27,Ross County,Clyde,4,0,4,W
83739,1,SCO2,2001-10-27,St Mirren,Airdrie United,0,0,0,D
83740,1,SCO2,2001-11-03,Airdrie United,Ross County,1,1,0,D
83741,1,SCO2,2001-11-03,Clyde,Falkirk,1,1,0,D
83742,1,SCO2,2001-11-03,Inverness CT,St Mirren,1,2,-1,L
83743,1,SCO2,2001-11-03,Partick Thistle,Arbroath,4,1,3,W
83744,1,SCO2,2001-11-03,Raith Rovers,Ayr United,1,1,0,D
83745,1,SCO2,2001-11-10,Airdrie United,Clyde,1,2,-1,L
83746,1,SCO2,2001-11-10,Ayr United,Arbroath,0,1,-1,L
83747,1,SCO2,2001-11-10,Partick Thistle,Falkirk,5,1,4,W
83748,1,SCO2,2001-11-10,Raith Rovers,Inverness CT,1,5,-4,L
83749,1,SCO2,2001-11-10,Ross County,St Mirren,0,1,-1,L
83750,1,SCO2,2001-11-17,Arbroath,Raith Rovers,1,1,0,D
83751,1,SCO2,2001-11-17,Clyde,Partick Thistle,3,1,2,W
83752,1,SCO2,2001-11-17,Falkirk,Airdrie United,1,2,-1,L
83753,1,SCO2,2001-11-17,Inverness CT,Ross County,3,0,3,W
83754,1,SCO2,2001-11-17,St Mirren,Ayr United,0,1,-1,L
83755,1,SCO2,2001-11-24,Airdrie United,Partick Thistle,1,0,1,W
83756,1,SCO2,2001-11-24,Arbroath,St Mirren,0,2,-2,L
83757,1,SCO2,2001-11-24,Ayr United,Inverness CT,3,0,3,W
83758,1,SCO2,2001-11-24,Raith Rovers,Clyde,1,2,-1,L
83759,1,SCO2,2001-11-24,Ross County,Falkirk,1,2,-1,L
83760,1,SCO2,2001-12-01,Clyde,Ayr United,2,2,0,D
83761,1,SCO2,2001-12-01,Falkirk,Arbroath,3,2,1,W
83762,1,SCO2,2001-12-01,Inverness CT,Airdrie United,1,2,-1,L
83763,1,SCO2,2001-12-01,Partick Thistle,Ross County,0,0,0,D
83764,1,SCO2,2001-12-01,St Mirren,Raith Rovers,1,1,0,D
83765,1,SCO2,2001-12-08,Arbroath,Clyde,2,1,1,W
83766,1,SCO2,2001-12-08,Ayr United,Airdrie United,1,3,-2,L
83767,1,SCO2,2001-12-08,Inverness CT,Partick Thistle,1,2,-1,L
83768,1,SCO2,2001-12-08,Raith Rovers,Ross County,1,3,-2,L
83769,1,SCO2,2001-12-08,St Mirren,Falkirk,1,5,-4,L
83770,1,SCO2,2001-12-15,Airdrie United,Raith Rovers,1,1,0,D
83771,1,SCO2,2001-12-15,Clyde,Inverness CT,1,0,1,W
83772,1,SCO2,2001-12-15,Falkirk,Ayr United,0,2,-2,L
83773,1,SCO2,2001-12-15,Partick Thistle,St Mirren,1,0,1,W
83774,1,SCO2,2001-12-15,Ross County,Arbroath,0,1,-1,L
83775,1,SCO2,2001-12-22,Inverness CT,Arbroath,3,2,1,W
83776,1,SCO2,2001-12-26,Partick Thistle,Ayr United,2,1,1,W
83777,1,SCO2,2001-12-29,Ayr United,Raith Rovers,3,1,2,W
83778,1,SCO2,2001-12-29,St Mirren,Inverness CT,0,0,0,D
83779,1,SCO2,2002-01-02,Partick Thistle,Clyde,2,1,1,W
83780,1,SCO2,2002-01-12,Arbroath,Ayr United,0,2,-2,L
83781,1,SCO2,2002-01-12,Clyde,Airdrie United,0,1,-1,L
83782,1,SCO2,2002-01-12,Falkirk,Partick Thistle,1,4,-3,L
83783,1,SCO2,2002-01-12,Inverness CT,Raith Rovers,5,0,5,W
83784,1,SCO2,2002-01-12,St Mirren,Ross County,1,1,0,D
83785,1,SCO2,2002-01-19,Airdrie United,Inverness CT,3,0,3,W
83786,1,SCO2,2002-01-19,Arbroath,Falkirk,0,1,-1,L
83787,1,SCO2,2002-01-19,Ayr United,Clyde,0,1,-1,L
83788,1,SCO2,2002-01-19,Raith Rovers,St Mirren,1,0,1,W
83789,1,SCO2,2002-01-19,Ross County,Partick Thistle,0,1,-1,L
83790,1,SCO2,2002-01-22,Airdrie United,St Mirren,2,3,-1,L
83791,1,SCO2,2002-01-26,Raith Rovers,Arbroath,0,0,0,D
83792,1,SCO2,2002-02-02,Clyde,Raith Rovers,1,2,-1,L
83793,1,SCO2,2002-02-02,Falkirk,Ross County,1,4,-3,L
83794,1,SCO2,2002-02-02,Inverness CT,Ayr United,1,1,0,D
83795,1,SCO2,2002-02-02,Partick Thistle,Airdrie United,1,1,0,D
83796,1,SCO2,2002-02-02,St Mirren,Arbroath,2,3,-1,L
83797,1,SCO2,2002-02-09,Airdrie United,Ayr United,1,2,-1,L
83798,1,SCO2,2002-02-09,Clyde,Arbroath,1,0,1,W
83799,1,SCO2,2002-02-09,Falkirk,St Mirren,0,0,0,D
83800,1,SCO2,2002-02-09,Partick Thistle,Inverness CT,4,1,3,W
83801,1,SCO2,2002-02-09,Ross County,Raith Rovers,4,2,2,W
83802,1,SCO2,2002-02-16,Arbroath,Airdrie United,2,1,1,W
83803,1,SCO2,2002-02-16,Ayr United,Ross County,0,0,0,D
83804,1,SCO2,2002-02-16,Inverness CT,Falkirk,3,2,1,W
83805,1,SCO2,2002-02-16,Raith Rovers,Partick Thistle,2,0,2,W
83806,1,SCO2,2002-02-16,St Mirren,Clyde,2,2,0,D
83807,1,SCO2,2002-02-23,Raith Rovers,Falkirk,5,1,4,W
83808,1,SCO2,2002-02-26,Arbroath,Partick Thistle,1,0,1,W
83809,1,SCO2,2002-02-26,Ayr United,St Mirren,4,1,3,W
83810,1,SCO2,2002-03-02,Airdrie United,Ross County,0,2,-2,L
83811,1,SCO2,2002-03-02,Clyde,Falkirk,2,3,-1,L
83812,1,SCO2,2002-03-02,Inverness CT,St Mirren,4,2,2,W
83813,1,SCO2,2002-03-02,Partick Thistle,Arbroath,2,2,0,D
83814,1,SCO2,2002-03-02,Raith Rovers,Ayr United,3,3,0,D
83815,1,SCO2,2002-03-05,Falkirk,Clyde,1,6,-5,L
83816,1,SCO2,2002-03-09,Arbroath,Inverness CT,1,0,1,W
83817,1,SCO2,2002-03-09,Ayr United,Partick Thistle,1,1,0,D
83818,1,SCO2,2002-03-09,Falkirk,Raith Rovers,2,1,1,W
83819,1,SCO2,2002-03-09,Ross County,Clyde,2,1,1,W
83820,1,SCO2,2002-03-09,St Mirren,Airdrie United,2,1,1,W
83821,1,SCO2,2002-03-12,Airdrie United,Falkirk,1,0,1,W
83822,1,SCO2,2002-03-12,Clyde,Ross County,0,0,0,D
83823,1,SCO2,2002-03-16,Airdrie United,Clyde,2,2,0,D
83824,1,SCO2,2002-03-16,Partick Thistle,Falkirk,3,0,3,W
83825,1,SCO2,2002-03-16,Raith Rovers,Inverness CT,0,0,0,D
83826,1,SCO2,2002-03-16,Ross County,St Mirren,4,1,3,W
83827,1,SCO2,2002-03-19,Ross County,Inverness CT,0,0,0,D
83828,1,SCO2,2002-03-23,Arbroath,Raith Rovers,2,2,0,D
83829,1,SCO2,2002-03-23,Falkirk,Airdrie United,2,2,0,D
83830,1,SCO2,2002-03-23,Inverness CT,Ross County,1,1,0,D
83831,1,SCO2,2002-03-26,Ayr United,Arbroath,0,0,0,D
83832,1,SCO2,2002-03-26,Ross County,Airdrie United,4,1,3,W
83833,1,SCO2,2002-03-27,Clyde,Partick Thistle,2,1,1,W
83834,1,SCO2,2002-03-30,Clyde,Ayr United,2,2,0,D
83835,1,SCO2,2002-03-30,Falkirk,Arbroath,1,3,-2,L
83836,1,SCO2,2002-03-30,Inverness CT,Airdrie United,1,0,1,W
83837,1,SCO2,2002-03-30,Partick Thistle,Ross County,1,1,0,D
83838,1,SCO2,2002-03-30,St Mirren,Raith Rovers,1,0,1,W
83839,1,SCO2,2002-04-02,St Mirren,Ayr United,1,1,0,D
83840,1,SCO2,2002-04-06,Airdrie United,Partick Thistle,1,1,0,D
83841,1,SCO2,2002-04-06,Arbroath,St Mirren,0,3,-3,L
83842,1,SCO2,2002-04-06,Ayr United,Inverness CT,1,0,1,W
83843,1,SCO2,2002-04-06,Raith Rovers,Clyde,0,1,-1,L
83844,1,SCO2,2002-04-06,Ross County,Falkirk,4,2,2,W
83845,1,SCO2,2002-04-13,Arbroath,Ross County,1,1,0,D
83846,1,SCO2,2002-04-13,Ayr United,Falkirk,0,0,0,D
83847,1,SCO2,2002-04-13,Inverness CT,Clyde,1,1,0,D
83848,1,SCO2,2002-04-13,Raith Rovers,Airdrie United,2,1,1,W
83849,1,SCO2,2002-04-13,St Mirren,Partick Thistle,0,2,-2,L
83850,1,SCO2,2002-04-20,Airdrie United,Arbroath,2,0,2,W
83851,1,SCO2,2002-04-20,Clyde,St Mirren,3,1,2,W
83852,1,SCO2,2002-04-20,Falkirk,Inverness CT,0,0,0,D
83853,1,SCO2,2002-04-20,Partick Thistle,Raith Rovers,1,0,1,W
83854,1,SCO2,2002-04-20,Ross County,Ayr United,1,1,0,D
83855,1,SCO2,2002-04-27,Arbroath,Clyde,2,0,2,W
83856,1,SCO2,2002-04-27,Ayr United,Airdrie United,1,0,1,W
83857,1,SCO2,2002-04-27,Inverness CT,Partick Thistle,3,0,3,W
83858,1,SCO2,2002-04-27,Raith Rovers,Ross County,0,1,-1,L
83859,1,SCO2,2002-04-27,St Mirren,Falkirk,0,0,0,D
83860,2,SCO2,2002-08-03,Arbroath,Ross County,0,3,-3,L
83861,2,SCO2,2002-08-03,Ayr United,Falkirk,1,3,-2,L
83862,2,SCO2,2002-08-03,Inverness CT,Alloa Athletic,0,0,0,D
83863,2,SCO2,2002-08-03,Queen of the South,Clyde,2,1,1,W
83864,2,SCO2,2002-08-03,St Mirren,St Johnstone,0,2,-2,L
83865,2,SCO2,2002-08-10,Alloa Athletic,Arbroath,0,3,-3,L
83866,2,SCO2,2002-08-10,Clyde,Ayr United,1,0,1,W
83867,2,SCO2,2002-08-10,Falkirk,St Mirren,2,0,2,W
83868,2,SCO2,2002-08-10,Ross County,Queen of the South,2,0,2,W
83869,2,SCO2,2002-08-10,St Johnstone,Inverness CT,1,0,1,W
83870,2,SCO2,2002-08-17,Arbroath,Clyde,1,1,0,D
83871,2,SCO2,2002-08-17,Ayr United,Ross County,2,1,1,W
83872,2,SCO2,2002-08-17,Inverness CT,Falkirk,1,2,-1,L
83873,2,SCO2,2002-08-17,Queen of the South,St Johnstone,0,0,0,D
83874,2,SCO2,2002-08-17,St Mirren,Alloa Athletic,3,1,2,W
83875,2,SCO2,2002-08-24,Alloa Athletic,Falkirk,1,6,-5,L
83876,2,SCO2,2002-08-24,Arbroath,St Johnstone,0,1,-1,L
83877,2,SCO2,2002-08-24,Clyde,St Mirren,2,3,-1,L
83878,2,SCO2,2002-08-24,Inverness CT,Ross County,2,0,2,W
83879,2,SCO2,2002-08-24,Queen of the South,Ayr United,1,2,-1,L
83880,2,SCO2,2002-08-31,Ayr United,Arbroath,1,0,1,W
83881,2,SCO2,2002-08-31,Falkirk,Queen of the South,3,0,3,W
83882,2,SCO2,2002-08-31,Ross County,Clyde,1,1,0,D
83883,2,SCO2,2002-08-31,St Johnstone,Alloa Athletic,2,0,2,W
83884,2,SCO2,2002-08-31,St Mirren,Inverness CT,0,4,-4,L
83885,2,SCO2,2002-09-14,Arbroath,St Mirren,2,2,0,D
83886,2,SCO2,2002-09-14,Ayr United,St Johnstone,0,0,0,D
83887,2,SCO2,2002-09-14,Clyde,Alloa Athletic,0,0,0,D
83888,2,SCO2,2002-09-14,Queen of the South,Inverness CT,1,3,-2,L
83889,2,SCO2,2002-09-14,Ross County,Falkirk,1,1,0,D
83890,2,SCO2,2002-09-21,Alloa Athletic,Ayr United,0,1,-1,L
83891,2,SCO2,2002-09-21,Falkirk,Clyde,2,1,1,W
83892,2,SCO2,2002-09-21,Inverness CT,Arbroath,5,0,5,W
83893,2,SCO2,2002-09-21,St Johnstone,Ross County,1,1,0,D
83894,2,SCO2,2002-09-21,St Mirren,Queen of the South,2,1,1,W
83895,2,SCO2,2002-09-28,Ayr United,St Mirren,1,1,0,D
83896,2,SCO2,2002-09-28,Clyde,Inverness CT,3,0,3,W
83897,2,SCO2,2002-09-28,Falkirk,St Johnstone,1,0,1,W
83898,2,SCO2,2002-09-28,Queen of the South,Arbroath,2,2,0,D
83899,2,SCO2,2002-09-28,Ross County,Alloa Athletic,0,1,-1,L
83900,2,SCO2,2002-10-05,Alloa Athletic,Queen of the South,0,1,-1,L
83901,2,SCO2,2002-10-05,Arbroath,Falkirk,2,0,2,W
83902,2,SCO2,2002-10-05,Inverness CT,Ayr United,2,0,2,W
83903,2,SCO2,2002-10-05,St Johnstone,Clyde,0,1,-1,L
83904,2,SCO2,2002-10-05,St Mirren,Ross County,1,1,0,D
83905,2,SCO2,2002-10-12,Clyde,Queen of the South,2,1,1,W
83906,2,SCO2,2002-10-19,Alloa Athletic,Inverness CT,0,6,-6,L
83907,2,SCO2,2002-10-19,Falkirk,Ayr United,3,0,3,W
83908,2,SCO2,2002-10-19,Ross County,Arbroath,4,0,4,W
83909,2,SCO2,2002-10-19,St Johnstone,St Mirren,2,0,2,W
83910,2,SCO2,2002-10-26,Arbroath,Alloa Athletic,0,1,-1,L
83911,2,SCO2,2002-10-26,Ayr United,Clyde,1,1,0,D
83912,2,SCO2,2002-10-26,Inverness CT,St Johnstone,2,1,1,W
83913,2,SCO2,2002-10-26,Queen of the South,Ross County,2,0,2,W
83914,2,SCO2,2002-10-26,St Mirren,Falkirk,4,4,0,D
83915,2,SCO2,2002-11-02,Alloa Athletic,St Johnstone,1,3,-2,L
83916,2,SCO2,2002-11-02,Clyde,Ross County,2,1,1,W
83917,2,SCO2,2002-11-02,Inverness CT,St Mirren,4,1,3,W
83918,2,SCO2,2002-11-02,Queen of the South,Falkirk,1,1,0,D
83919,2,SCO2,2002-11-05,Arbroath,Ayr United,1,1,0,D
83920,2,SCO2,2002-11-09,Ayr United,Queen of the South,0,1,-1,L
83921,2,SCO2,2002-11-09,Falkirk,Alloa Athletic,3,0,3,W
83922,2,SCO2,2002-11-09,Ross County,Inverness CT,0,2,-2,L
83923,2,SCO2,2002-11-09,St Johnstone,Arbroath,2,0,2,W
83924,2,SCO2,2002-11-09,St Mirren,Clyde,1,4,-3,L
83925,2,SCO2,2002-11-16,Alloa Athletic,Clyde,1,4,-3,L
83926,2,SCO2,2002-11-16,Falkirk,Ross County,2,0,2,W
83927,2,SCO2,2002-11-16,Inverness CT,Queen of the South,5,3,2,W
83928,2,SCO2,2002-11-16,St Johnstone,Ayr United,0,2,-2,L
83929,2,SCO2,2002-11-16,St Mirren,Arbroath,2,0,2,W
83930,2,SCO2,2002-11-23,Arbroath,Inverness CT,1,2,-1,L
83931,2,SCO2,2002-11-23,Ayr United,Alloa Athletic,3,1,2,W
83932,2,SCO2,2002-11-23,Clyde,Falkirk,2,0,2,W
83933,2,SCO2,2002-11-23,Queen of the South,St Mirren,3,0,3,W
83934,2,SCO2,2002-11-23,Ross County,St Johnstone,0,0,0,D
83935,2,SCO2,2002-11-30,Alloa Athletic,Ross County,1,1,0,D
83936,2,SCO2,2002-11-30,Arbroath,Queen of the South,1,2,-1,L
83937,2,SCO2,2002-11-30,Inverness CT,Clyde,1,0,1,W
83938,2,SCO2,2002-11-30,St Johnstone,Falkirk,0,1,-1,L
83939,2,SCO2,2002-11-30,St Mirren,Ayr United,1,0,1,W
83940,2,SCO2,2002-12-07,Ayr United,Inverness CT,3,3,0,D
83941,2,SCO2,2002-12-07,Clyde,St Johnstone,1,2,-1,L
83942,2,SCO2,2002-12-07,Falkirk,Arbroath,2,1,1,W
83943,2,SCO2,2002-12-07,Queen of the South,Alloa Athletic,1,1,0,D
83944,2,SCO2,2002-12-07,Ross County,St Mirren,4,0,4,W
83945,2,SCO2,2002-12-14,Alloa Athletic,St Mirren,2,3,-1,L
83946,2,SCO2,2002-12-14,Clyde,Arbroath,3,0,3,W
83947,2,SCO2,2002-12-14,Falkirk,Inverness CT,1,1,0,D
83948,2,SCO2,2002-12-14,Ross County,Ayr United,1,0,1,W
83949,2,SCO2,2002-12-14,St Johnstone,Queen of the South,2,2,0,D
83950,2,SCO2,2002-12-21,Arbroath,Ross County,2,1,1,W
83951,2,SCO2,2002-12-21,Inverness CT,Alloa Athletic,1,1,0,D
83952,2,SCO2,2002-12-28,Ayr United,Arbroath,4,0,4,W
83953,2,SCO2,2002-12-28,Falkirk,Queen of the South,5,0,5,W
83954,2,SCO2,2002-12-28,Ross County,Clyde,1,1,0,D
83955,2,SCO2,2002-12-28,St Johnstone,Alloa Athletic,3,0,3,W
83956,2,SCO2,2002-12-28,St Mirren,Inverness CT,1,4,-3,L
83957,2,SCO2,2003-01-01,Arbroath,St Johnstone,2,3,-1,L
83958,2,SCO2,2003-01-01,Clyde,St Mirren,3,2,1,W
83959,2,SCO2,2003-01-01,Queen of the South,Ayr United,1,1,0,D
83960,2,SCO2,2003-01-11,St Johnstone,Ross County,2,0,2,W
83961,2,SCO2,2003-01-18,Alloa Athletic,Queen of the South,3,3,0,D
83962,2,SCO2,2003-01-18,Arbroath,Falkirk,1,4,-3,L
83963,2,SCO2,2003-01-18,Inverness CT,Ayr United,0,1,-1,L
83964,2,SCO2,2003-01-18,St Johnstone,Clyde,1,2,-1,L
83965,2,SCO2,2003-01-18,St Mirren,Ross County,1,0,1,W
83966,2,SCO2,2003-02-01,Ayr United,St Mirren,0,0,0,D
83967,2,SCO2,2003-02-01,Falkirk,St Johnstone,1,1,0,D
83968,2,SCO2,2003-02-01,Ross County,Alloa Athletic,1,2,-1,L
83969,2,SCO2,2003-02-08,Arbroath,Clyde,1,2,-1,L
83970,2,SCO2,2003-02-08,Ayr United,Ross County,1,1,0,D
83971,2,SCO2,2003-02-08,Inverness CT,Falkirk,3,4,-1,L
83972,2,SCO2,2003-02-08,Queen of the South,St Johnstone,1,2,-1,L
83973,2,SCO2,2003-02-08,St Mirren,Alloa Athletic,1,1,0,D
83974,2,SCO2,2003-02-15,Falkirk,St Mirren,3,1,2,W
83975,2,SCO2,2003-02-15,St Johnstone,Inverness CT,2,0,2,W
83976,2,SCO2,2003-02-23,St Mirren,Queen of the South,2,2,0,D
83977,2,SCO2,2003-02-25,Alloa Athletic,Arbroath,3,2,1,W
83978,2,SCO2,2003-02-25,Ayr United,Falkirk,1,0,1,W
83979,2,SCO2,2003-02-25,Inverness CT,Ross County,1,5,-4,L
83980,2,SCO2,2003-02-25,Queen of the South,Clyde,1,1,0,D
83981,2,SCO2,2003-03-01,Alloa Athletic,St Johnstone,1,2,-1,L
83982,2,SCO2,2003-03-01,Arbroath,Ayr United,1,2,-1,L
83983,2,SCO2,2003-03-01,Clyde,Ross County,1,0,1,W
83984,2,SCO2,2003-03-01,Inverness CT,St Mirren,3,1,2,W
83985,2,SCO2,2003-03-01,Queen of the South,Falkirk,2,1,1,W
83986,2,SCO2,2003-03-04,Ayr United,St Johnstone,0,1,-1,L
83987,2,SCO2,2003-03-04,Falkirk,Clyde,3,0,3,W
83988,2,SCO2,2003-03-04,Inverness CT,Arbroath,2,0,2,W
83989,2,SCO2,2003-03-08,Ayr United,Queen of the South,0,1,-1,L
83990,2,SCO2,2003-03-08,Falkirk,Alloa Athletic,3,1,2,W
83991,2,SCO2,2003-03-08,Ross County,Inverness CT,0,2,-2,L
83992,2,SCO2,2003-03-08,St Johnstone,Arbroath,2,1,1,W
83993,2,SCO2,2003-03-08,St Mirren,Clyde,1,2,-1,L
83994,2,SCO2,2003-03-11,Clyde,Alloa Athletic,2,2,0,D
83995,2,SCO2,2003-03-11,Queen of the South,Inverness CT,0,0,0,D
83996,2,SCO2,2003-03-11,Ross County,Falkirk,0,1,-1,L
83997,2,SCO2,2003-03-15,Arbroath,Inverness CT,1,3,-2,L
83998,2,SCO2,2003-03-15,Ayr United,Alloa Athletic,0,1,-1,L
83999,2,SCO2,2003-03-15,Clyde,Falkirk,0,0,0,D
84000,2,SCO2,2003-03-15,Queen of the South,St Mirren,0,2,-2,L
84001,2,SCO2,2003-03-15,Ross County,St Johnstone,2,3,-1,L
84002,2,SCO2,2003-03-18,Clyde,Inverness CT,4,1,3,W
84003,2,SCO2,2003-03-18,Queen of the South,Arbroath,3,0,3,W
84004,2,SCO2,2003-03-22,Clyde,Ayr United,3,0,3,W
84005,2,SCO2,2003-03-22,Ross County,Queen of the South,0,3,-3,L
84006,2,SCO2,2003-03-22,St Mirren,St Johnstone,1,3,-2,L
84007,2,SCO2,2003-03-25,Alloa Athletic,Ayr United,2,3,-1,L
84008,2,SCO2,2003-03-29,Alloa Athletic,Falkirk,1,3,-2,L
84009,2,SCO2,2003-03-29,Arbroath,St Mirren,1,1,0,D
84010,2,SCO2,2003-04-05,Alloa Athletic,Clyde,1,2,-1,L
84011,2,SCO2,2003-04-05,Falkirk,Ross County,3,0,3,W
84012,2,SCO2,2003-04-05,Inverness CT,Queen of the South,1,0,1,W
84013,2,SCO2,2003-04-05,St Johnstone,Ayr United,1,0,1,W
84014,2,SCO2,2003-04-05,St Mirren,Arbroath,1,0,1,W
84015,2,SCO2,2003-04-12,Alloa Athletic,Ross County,2,1,1,W
84016,2,SCO2,2003-04-12,Arbroath,Queen of the South,0,0,0,D
84017,2,SCO2,2003-04-12,Inverness CT,Clyde,1,2,-1,L
84018,2,SCO2,2003-04-12,St Johnstone,Falkirk,0,1,-1,L
84019,2,SCO2,2003-04-12,St Mirren,Ayr United,1,1,0,D
84020,2,SCO2,2003-04-19,Clyde,St Johnstone,2,1,1,W
84021,2,SCO2,2003-04-19,Falkirk,Arbroath,4,1,3,W
84022,2,SCO2,2003-04-19,Queen of the South,Alloa Athletic,0,1,-1,L
84023,2,SCO2,2003-04-19,Ross County,St Mirren,2,0,2,W
84024,2,SCO2,2003-04-26,Alloa Athletic,Inverness CT,1,5,-4,L
84025,2,SCO2,2003-04-26,Clyde,Queen of the South,2,2,0,D
84026,2,SCO2,2003-04-26,Falkirk,Ayr United,3,0,3,W
84027,2,SCO2,2003-04-26,Ross County,Arbroath,3,1,2,W
84028,2,SCO2,2003-04-26,St Johnstone,St Mirren,1,1,0,D
84029,2,SCO2,2003-04-29,Ayr United,Inverness CT,1,0,1,W
84030,2,SCO2,2003-05-03,Arbroath,Alloa Athletic,0,1,-1,L
84031,2,SCO2,2003-05-03,Ayr United,Clyde,0,3,-3,L
84032,2,SCO2,2003-05-03,Inverness CT,St Johnstone,1,2,-1,L
84033,2,SCO2,2003-05-03,Queen of the South,Ross County,1,0,1,W
84034,2,SCO2,2003-05-03,St Mirren,Falkirk,1,2,-1,L
84035,2,SCO2,2003-05-10,Alloa Athletic,St Mirren,4,0,4,W
84036,2,SCO2,2003-05-10,Clyde,Arbroath,4,2,2,W
84037,2,SCO2,2003-05-10,Falkirk,Inverness CT,2,3,-1,L
84038,2,SCO2,2003-05-10,Ross County,Ayr United,4,1,3,W
84039,2,SCO2,2003-05-10,St Johnstone,Queen of the South,0,1,-1,L
84040,3,SCO2,2003-08-09,Clyde,Ayr United,3,0,3,W
84041,3,SCO2,2003-08-09,Falkirk,Inverness CT,2,1,1,W
84042,3,SCO2,2003-08-09,Raith Rovers,St Mirren,1,1,0,D
84043,3,SCO2,2003-08-09,Ross County,Brechin City,4,0,4,W
84044,3,SCO2,2003-08-09,St Johnstone,Queen of the South,4,1,3,W
84045,3,SCO2,2003-08-16,Ayr United,Falkirk,1,1,0,D
84046,3,SCO2,2003-08-16,Brechin City,Raith Rovers,0,3,-3,L
84047,3,SCO2,2003-08-16,Inverness CT,Clyde,0,0,0,D
84048,3,SCO2,2003-08-16,Queen of the South,Ross County,1,0,1,W
84049,3,SCO2,2003-08-16,St Mirren,St Johnstone,1,1,0,D
84050,3,SCO2,2003-08-23,Clyde,Brechin City,2,1,1,W
84051,3,SCO2,2003-08-23,Falkirk,Queen of the South,0,0,0,D
84052,3,SCO2,2003-08-23,Raith Rovers,Ayr United,1,1,0,D
84053,3,SCO2,2003-08-23,Ross County,St Mirren,2,0,2,W
84054,3,SCO2,2003-08-23,St Johnstone,Inverness CT,1,2,-1,L
84055,3,SCO2,2003-08-30,Ayr United,Queen of the South,1,4,-3,L
84056,3,SCO2,2003-08-30,Raith Rovers,Falkirk,0,1,-1,L
84057,3,SCO2,2003-08-30,Ross County,Inverness CT,1,1,0,D
84058,3,SCO2,2003-08-30,St Johnstone,Brechin City,3,1,2,W
84059,3,SCO2,2003-08-30,St Mirren,Clyde,2,1,1,W
84060,3,SCO2,2003-09-13,Brechin City,St Mirren,1,1,0,D
84061,3,SCO2,2003-09-13,Clyde,St Johnstone,2,0,2,W
84062,3,SCO2,2003-09-13,Falkirk,Ross County,0,2,-2,L
84063,3,SCO2,2003-09-13,Inverness CT,Ayr United,1,0,1,W
84064,3,SCO2,2003-09-13,Queen of the South,Raith Rovers,0,2,-2,L
84065,3,SCO2,2003-09-20,Brechin City,Inverness CT,0,2,-2,L
84066,3,SCO2,2003-09-20,Clyde,Falkirk,1,2,-1,L
84067,3,SCO2,2003-09-20,Ross County,Ayr United,2,2,0,D
84068,3,SCO2,2003-09-20,St Johnstone,Raith Rovers,0,1,-1,L
84069,3,SCO2,2003-09-20,St Mirren,Queen of the South,1,2,-1,L
84070,3,SCO2,2003-09-27,Ayr United,Brechin City,3,2,1,W
84071,3,SCO2,2003-09-27,Falkirk,St Johnstone,0,3,-3,L
84072,3,SCO2,2003-09-27,Inverness CT,St Mirren,2,0,2,W
84073,3,SCO2,2003-09-27,Queen of the South,Clyde,4,1,3,W
84074,3,SCO2,2003-09-27,Raith Rovers,Ross County,1,7,-6,L
84075,3,SCO2,2003-10-04,Brechin City,Queen of the South,0,1,-1,L
84076,3,SCO2,2003-10-04,Clyde,Ross County,2,2,0,D
84077,3,SCO2,2003-10-04,Inverness CT,Raith Rovers,2,1,1,W
84078,3,SCO2,2003-10-04,St Johnstone,Ayr United,1,1,0,D
84079,3,SCO2,2003-10-04,St Mirren,Falkirk,0,0,0,D
84080,3,SCO2,2003-10-18,Ayr United,St Mirren,0,2,-2,L
84081,3,SCO2,2003-10-18,Falkirk,Brechin City,3,0,3,W
84082,3,SCO2,2003-10-18,Queen of the South,Inverness CT,3,2,1,W
84083,3,SCO2,2003-10-18,Raith Rovers,Clyde,0,1,-1,L
84084,3,SCO2,2003-10-18,Ross County,St Johnstone,0,3,-3,L
84085,3,SCO2,2003-10-25,Falkirk,Ayr United,0,1,-1,L
84086,3,SCO2,2003-10-25,Raith Rovers,Brechin City,2,1,1,W
84087,3,SCO2,2003-10-25,Ross County,Queen of the South,1,0,1,W
84088,3,SCO2,2003-10-25,St Johnstone,St Mirren,1,0,1,W
84089,3,SCO2,2003-11-01,Ayr United,Clyde,2,2,0,D
84090,3,SCO2,2003-11-01,Brechin City,Ross County,4,2,2,W
84091,3,SCO2,2003-11-01,Inverness CT,Falkirk,1,2,-1,L
84092,3,SCO2,2003-11-01,Queen of the South,St Johnstone,1,1,0,D
84093,3,SCO2,2003-11-01,St Mirren,Raith Rovers,2,1,1,W
84094,3,SCO2,2003-11-05,Clyde,Inverness CT,1,0,1,W
84095,3,SCO2,2003-11-08,Ayr United,Inverness CT,0,3,-3,L
84096,3,SCO2,2003-11-08,Raith Rovers,Queen of the South,0,1,-1,L
84097,3,SCO2,2003-11-08,Ross County,Falkirk,1,2,-1,L
84098,3,SCO2,2003-11-08,St Johnstone,Clyde,3,0,3,W
84099,3,SCO2,2003-11-08,St Mirren,Brechin City,0,0,0,D
84100,3,SCO2,2003-11-14,Clyde,St Mirren,2,0,2,W
84101,3,SCO2,2003-11-14,Falkirk,Raith Rovers,3,2,1,W
84102,3,SCO2,2003-11-14,Inverness CT,Ross County,3,3,0,D
84103,3,SCO2,2003-11-16,Brechin City,St Johnstone,0,1,-1,L
84104,3,SCO2,2003-11-16,Queen of the South,Ayr United,1,0,1,W
84105,3,SCO2,2003-11-22,Brechin City,Ayr United,3,1,2,W
84106,3,SCO2,2003-11-22,Clyde,Queen of the South,3,1,2,W
84107,3,SCO2,2003-11-22,Ross County,Raith Rovers,3,2,1,W
84108,3,SCO2,2003-11-22,St Johnstone,Falkirk,0,4,-4,L
84109,3,SCO2,2003-11-22,St Mirren,Inverness CT,0,4,-4,L
84110,3,SCO2,2003-11-29,Ayr United,Ross County,1,3,-2,L
84111,3,SCO2,2003-11-29,Falkirk,Clyde,0,2,-2,L
84112,3,SCO2,2003-11-29,Inverness CT,Brechin City,5,0,5,W
84113,3,SCO2,2003-11-29,Raith Rovers,St Johnstone,1,4,-3,L
84114,3,SCO2,2003-12-03,Queen of the South,St Mirren,1,2,-1,L
84115,3,SCO2,2003-12-06,Brechin City,Falkirk,2,2,0,D
84116,3,SCO2,2003-12-06,Clyde,Raith Rovers,0,0,0,D
84117,3,SCO2,2003-12-06,Inverness CT,Queen of the South,4,1,3,W
84118,3,SCO2,2003-12-06,St Johnstone,Ross County,1,1,0,D
84119,3,SCO2,2003-12-06,St Mirren,Ayr United,3,2,1,W
84120,3,SCO2,2003-12-13,Ayr United,St Johnstone,1,1,0,D
84121,3,SCO2,2003-12-13,Falkirk,St Mirren,0,0,0,D
84122,3,SCO2,2003-12-13,Queen of the South,Brechin City,1,0,1,W
84123,3,SCO2,2003-12-13,Raith Rovers,Inverness CT,1,3,-2,L
84124,3,SCO2,2003-12-13,Ross County,Clyde,0,1,-1,L
84125,3,SCO2,2003-12-20,Clyde,Ayr United,2,1,1,W
84126,3,SCO2,2003-12-20,Ross County,Brechin City,2,1,1,W
84127,3,SCO2,2003-12-20,St Johnstone,Queen of the South,2,2,0,D
84128,3,SCO2,2003-12-27,Ayr United,Raith Rovers,1,0,1,W
84129,3,SCO2,2003-12-27,Brechin City,Clyde,1,3,-2,L
84130,3,SCO2,2003-12-27,Inverness CT,St Johnstone,1,0,1,W
84131,3,SCO2,2003-12-27,Queen of the South,Falkirk,2,0,2,W
84132,3,SCO2,2003-12-27,St Mirren,Ross County,1,1,0,D
84133,3,SCO2,2004-01-03,Ayr United,Queen of the South,1,1,0,D
84134,3,SCO2,2004-01-03,Raith Rovers,Falkirk,2,0,2,W
84135,3,SCO2,2004-01-03,Ross County,Inverness CT,1,0,1,W
84136,3,SCO2,2004-01-03,St Johnstone,Brechin City,2,2,0,D
84137,3,SCO2,2004-01-03,St Mirren,Clyde,2,3,-1,L
84138,3,SCO2,2004-01-17,Brechin City,St Mirren,2,0,2,W
84139,3,SCO2,2004-01-17,Falkirk,Ross County,2,0,2,W
84140,3,SCO2,2004-01-17,Inverness CT,Ayr United,2,1,1,W
84141,3,SCO2,2004-01-17,Queen of the South,Raith Rovers,1,1,0,D
84142,3,SCO2,2004-01-24,Brechin City,Inverness CT,2,4,-2,L
84143,3,SCO2,2004-01-24,Clyde,Falkirk,4,2,2,W
84144,3,SCO2,2004-01-24,Ross County,Ayr United,1,1,0,D
84145,3,SCO2,2004-01-24,St Johnstone,Raith Rovers,5,2,3,W
84146,3,SCO2,2004-01-24,St Mirren,Queen of the South,3,1,2,W
84147,3,SCO2,2004-01-31,Ayr United,Brechin City,1,2,-1,L
84148,3,SCO2,2004-01-31,Inverness CT,St Mirren,1,1,0,D
84149,3,SCO2,2004-02-07,Raith Rovers,Ross County,0,0,0,D
84150,3,SCO2,2004-02-14,Brechin City,Queen of the South,2,1,1,W
84151,3,SCO2,2004-02-14,Clyde,Ross County,1,0,1,W
84152,3,SCO2,2004-02-14,Inverness CT,Raith Rovers,3,0,3,W
84153,3,SCO2,2004-02-14,St Johnstone,Ayr United,3,0,3,W
84154,3,SCO2,2004-02-14,St Mirren,Falkirk,1,1,0,D
84155,3,SCO2,2004-02-21,Ayr United,St Mirren,2,0,2,W
84156,3,SCO2,2004-02-21,Falkirk,Brechin City,5,0,5,W
84157,3,SCO2,2004-02-21,Queen of the South,Inverness CT,2,1,1,W
84158,3,SCO2,2004-02-21,Raith Rovers,Clyde,0,3,-3,L
84159,3,SCO2,2004-02-21,Ross County,St Johnstone,2,0,2,W
84160,3,SCO2,2004-03-02,Falkirk,Inverness CT,2,1,1,W
84161,3,SCO2,2004-03-06,Ayr United,Falkirk,2,3,-1,L
84162,3,SCO2,2004-03-06,Clyde,St Johnstone,2,3,-1,L
84163,3,SCO2,2004-03-06,Queen of the South,Ross County,1,1,0,D
84164,3,SCO2,2004-03-06,Raith Rovers,St Mirren,2,0,2,W
84165,3,SCO2,2004-03-09,Falkirk,St Johnstone,0,1,-1,L
84166,3,SCO2,2004-03-10,Brechin City,Raith Rovers,1,1,0,D
84167,3,SCO2,2004-03-10,Queen of the South,Clyde,1,2,-1,L
84168,3,SCO2,2004-03-13,Clyde,Brechin City,0,0,0,D
84169,3,SCO2,2004-03-13,Falkirk,Queen of the South,0,2,-2,L
84170,3,SCO2,2004-03-13,Raith Rovers,Ayr United,2,1,1,W
84171,3,SCO2,2004-03-13,Ross County,St Mirren,1,0,1,W
84172,3,SCO2,2004-03-13,St Johnstone,Inverness CT,3,2,1,W
84173,3,SCO2,2004-03-16,Inverness CT,Clyde,3,1,2,W
84174,3,SCO2,2004-03-16,St Mirren,St Johnstone,1,1,0,D
84175,3,SCO2,2004-03-20,Ayr United,Inverness CT,1,1,0,D
84176,3,SCO2,2004-03-20,Ross County,Falkirk,1,1,0,D
84177,3,SCO2,2004-03-20,St Johnstone,Clyde,1,3,-2,L
84178,3,SCO2,2004-03-20,St Mirren,Brechin City,3,3,0,D
84179,3,SCO2,2004-03-23,Raith Rovers,Queen of the South,3,1,2,W
84180,3,SCO2,2004-03-27,Brechin City,St Johnstone,0,2,-2,L
84181,3,SCO2,2004-03-27,Clyde,St Mirren,2,2,0,D
84182,3,SCO2,2004-03-27,Falkirk,Raith Rovers,1,0,1,W
84183,3,SCO2,2004-03-27,Inverness CT,Ross County,1,0,1,W
84184,3,SCO2,2004-03-27,Queen of the South,Ayr United,0,0,0,D
84185,3,SCO2,2004-04-03,Brechin City,Ayr United,0,3,-3,L
84186,3,SCO2,2004-04-03,Clyde,Queen of the South,2,0,2,W
84187,3,SCO2,2004-04-03,Ross County,Raith Rovers,1,1,0,D
84188,3,SCO2,2004-04-03,St Johnstone,Falkirk,2,1,1,W
84189,3,SCO2,2004-04-03,St Mirren,Inverness CT,0,0,0,D
84190,3,SCO2,2004-04-10,Ayr United,Ross County,1,2,-1,L
84191,3,SCO2,2004-04-10,Falkirk,Clyde,1,1,0,D
84192,3,SCO2,2004-04-10,Queen of the South,St Mirren,1,0,1,W
84193,3,SCO2,2004-04-10,Raith Rovers,St Johnstone,1,1,0,D
84194,3,SCO2,2004-04-13,Inverness CT,Brechin City,1,0,1,W
84195,3,SCO2,2004-04-17,Brechin City,Falkirk,0,1,-1,L
84196,3,SCO2,2004-04-17,Clyde,Raith Rovers,4,1,3,W
84197,3,SCO2,2004-04-17,Inverness CT,Queen of the South,4,1,3,W
84198,3,SCO2,2004-04-17,St Johnstone,Ross County,1,1,0,D
84199,3,SCO2,2004-04-17,St Mirren,Ayr United,4,1,3,W
84200,3,SCO2,2004-04-24,Ayr United,St Johnstone,1,1,0,D
84201,3,SCO2,2004-04-24,Falkirk,St Mirren,1,0,1,W
84202,3,SCO2,2004-04-24,Queen of the South,Brechin City,2,2,0,D
84203,3,SCO2,2004-04-24,Raith Rovers,Inverness CT,0,1,-1,L
84204,3,SCO2,2004-04-24,Ross County,Clyde,0,0,0,D
84205,3,SCO2,2004-05-01,Ayr United,Clyde,1,1,0,D
84206,3,SCO2,2004-05-01,Brechin City,Ross County,1,0,1,W
84207,3,SCO2,2004-05-01,Inverness CT,Falkirk,0,0,0,D
84208,3,SCO2,2004-05-01,Queen of the South,St Johnstone,1,1,0,D
84209,3,SCO2,2004-05-01,St Mirren,Raith Rovers,1,1,0,D
84210,3,SCO2,2004-05-08,Clyde,Inverness CT,1,2,-1,L
84211,3,SCO2,2004-05-08,Falkirk,Ayr United,0,0,0,D
84212,3,SCO2,2004-05-08,Raith Rovers,Brechin City,1,1,0,D
84213,3,SCO2,2004-05-08,Ross County,Queen of the South,1,2,-1,L
84214,3,SCO2,2004-05-08,St Johnstone,St Mirren,1,3,-2,L
84215,3,SCO2,2004-05-15,Ayr United,Raith Rovers,1,0,1,W
84216,3,SCO2,2004-05-15,Brechin City,Clyde,2,5,-3,L
84217,3,SCO2,2004-05-15,Inverness CT,St Johnstone,3,1,2,W
84218,3,SCO2,2004-05-15,Queen of the South,Falkirk,1,0,1,W
84219,3,SCO2,2004-05-15,St Mirren,Ross County,2,0,2,W
84220,4,SCO2,2004-08-07,Airdrie United,St Johnstone,1,0,1,W
84221,4,SCO2,2004-08-07,Clyde,Partick Thistle,2,1,1,W
84222,4,SCO2,2004-08-07,Hamilton Academical,Raith Rovers,2,0,2,W
84223,4,SCO2,2004-08-07,Queen of the South,Ross County,0,1,-1,L
84224,4,SCO2,2004-08-07,St Mirren,Falkirk,2,0,2,W
84225,4,SCO2,2004-08-14,Falkirk,Hamilton Academical,1,1,0,D
84226,4,SCO2,2004-08-14,Partick Thistle,Airdrie United,3,2,1,W
84227,4,SCO2,2004-08-14,Raith Rovers,Clyde,2,3,-1,L
84228,4,SCO2,2004-08-14,Ross County,St Mirren,1,1,0,D
84229,4,SCO2,2004-08-14,St Johnstone,Queen of the South,1,3,-2,L
84230,4,SCO2,2004-08-21,Airdrie United,Raith Rovers,1,1,0,D
84231,4,SCO2,2004-08-21,Clyde,Ross County,1,0,1,W
84232,4,SCO2,2004-08-21,Hamilton Academical,Partick Thistle,0,1,-1,L
84233,4,SCO2,2004-08-21,Queen of the South,Falkirk,1,3,-2,L
84234,4,SCO2,2004-08-21,St Mirren,St Johnstone,2,1,1,W
84235,4,SCO2,2004-08-28,Falkirk,Airdrie United,5,0,5,W
84236,4,SCO2,2004-08-28,Queen of the South,Clyde,0,1,-1,L
84237,4,SCO2,2004-08-28,Ross County,Partick Thistle,0,1,-1,L
84238,4,SCO2,2004-08-28,St Johnstone,Raith Rovers,1,0,1,W
84239,4,SCO2,2004-08-28,St Mirren,Hamilton Academical,1,0,1,W
84240,4,SCO2,2004-09-04,Airdrie United,Queen of the South,0,1,-1,L
84241,4,SCO2,2004-09-04,Clyde,St Mirren,0,0,0,D
84242,4,SCO2,2004-09-04,Hamilton Academical,St Johnstone,1,1,0,D
84243,4,SCO2,2004-09-04,Partick Thistle,Falkirk,1,4,-3,L
84244,4,SCO2,2004-09-04,Raith Rovers,Ross County,1,2,-1,L
84245,4,SCO2,2004-09-11,Clyde,Airdrie United,1,2,-1,L
84246,4,SCO2,2004-09-11,Falkirk,Raith Rovers,4,2,2,W
84247,4,SCO2,2004-09-11,Queen of the South,Hamilton Academical,1,1,0,D
84248,4,SCO2,2004-09-11,Ross County,St Johnstone,0,1,-1,L
84249,4,SCO2,2004-09-11,St Mirren,Partick Thistle,2,1,1,W
84250,4,SCO2,2004-09-18,Airdrie United,Ross County,1,2,-1,L
84251,4,SCO2,2004-09-18,Hamilton Academical,Clyde,0,1,-1,L
84252,4,SCO2,2004-09-18,Partick Thistle,Queen of the South,1,2,-1,L
84253,4,SCO2,2004-09-18,Raith Rovers,St Mirren,0,3,-3,L
84254,4,SCO2,2004-09-18,St Johnstone,Falkirk,1,2,-1,L
84255,4,SCO2,2004-09-25,Falkirk,Clyde,1,1,0,D
84256,4,SCO2,2004-09-25,Hamilton Academical,Ross County,1,2,-1,L
84257,4,SCO2,2004-09-25,Raith Rovers,Queen of the South,1,2,-1,L
84258,4,SCO2,2004-09-25,St Johnstone,Partick Thistle,2,1,1,W
84259,4,SCO2,2004-09-25,St Mirren,Airdrie United,1,1,0,D
84260,4,SCO2,2004-10-02,Airdrie United,Hamilton Academical,0,2,-2,L
84261,4,SCO2,2004-10-02,Clyde,St Johnstone,1,0,1,W
84262,4,SCO2,2004-10-02,Partick Thistle,Raith Rovers,2,0,2,W
84263,4,SCO2,2004-10-02,Queen of the South,St Mirren,2,1,1,W
84264,4,SCO2,2004-10-02,Ross County,Falkirk,0,1,-1,L
84265,4,SCO2,2004-10-16,Airdrie United,Partick Thistle,4,2,2,W
84266,4,SCO2,2004-10-16,Clyde,Raith Rovers,2,0,2,W
84267,4,SCO2,2004-10-16,Hamilton Academical,Falkirk,0,1,-1,L
84268,4,SCO2,2004-10-16,Queen of the South,St Johnstone,0,1,-1,L
84269,4,SCO2,2004-10-16,St Mirren,Ross County,3,2,1,W
84270,4,SCO2,2004-10-23,Falkirk,St Mirren,0,0,0,D
84271,4,SCO2,2004-10-23,Partick Thistle,Clyde,0,0,0,D
84272,4,SCO2,2004-10-23,Raith Rovers,Hamilton Academical,2,2,0,D
84273,4,SCO2,2004-10-23,Ross County,Queen of the South,1,0,1,W
84274,4,SCO2,2004-10-23,St Johnstone,Airdrie United,1,1,0,D
84275,4,SCO2,2004-10-30,Airdrie United,Falkirk,1,3,-2,L
84276,4,SCO2,2004-10-30,Clyde,Queen of the South,2,0,2,W
84277,4,SCO2,2004-10-30,Hamilton Academical,St Mirren,2,2,0,D
84278,4,SCO2,2004-10-30,Partick Thistle,Ross County,4,0,4,W
84279,4,SCO2,2004-10-30,Raith Rovers,St Johnstone,1,0,1,W
84280,4,SCO2,2004-11-06,Queen of the South,Airdrie United,1,0,1,W
84281,4,SCO2,2004-11-06,St Johnstone,Hamilton Academical,3,0,3,W
84282,4,SCO2,2004-11-06,St Mirren,Clyde,0,0,0,D
84283,4,SCO2,2004-11-13,Airdrie United,Clyde,3,1,2,W
84284,4,SCO2,2004-11-13,Hamilton Academical,Queen of the South,1,0,1,W
84285,4,SCO2,2004-11-13,Partick Thistle,St Mirren,0,3,-3,L
84286,4,SCO2,2004-11-13,Raith Rovers,Falkirk,0,2,-2,L
84287,4,SCO2,2004-11-13,St Johnstone,Ross County,1,1,0,D
84288,4,SCO2,2004-11-20,Clyde,Hamilton Academical,2,1,1,W
84289,4,SCO2,2004-11-20,Falkirk,St Johnstone,3,1,2,W
84290,4,SCO2,2004-11-20,Queen of the South,Partick Thistle,1,0,1,W
84291,4,SCO2,2004-11-20,Ross County,Airdrie United,1,2,-1,L
84292,4,SCO2,2004-11-20,St Mirren,Raith Rovers,1,0,1,W
84293,4,SCO2,2004-11-23,Falkirk,Partick Thistle,3,0,3,W
84294,4,SCO2,2004-11-23,Ross County,Raith Rovers,1,1,0,D
84295,4,SCO2,2004-11-27,Falkirk,Ross County,2,2,0,D
84296,4,SCO2,2004-11-27,Hamilton Academical,Airdrie United,1,3,-2,L
84297,4,SCO2,2004-11-27,Raith Rovers,Partick Thistle,0,0,0,D
84298,4,SCO2,2004-11-27,St Johnstone,Clyde,3,0,3,W
84299,4,SCO2,2004-11-27,St Mirren,Queen of the South,2,2,0,D
84300,4,SCO2,2004-12-04,Airdrie United,St Mirren,3,2,1,W
84301,4,SCO2,2004-12-04,Clyde,Falkirk,0,2,-2,L
84302,4,SCO2,2004-12-04,Partick Thistle,St Johnstone,0,4,-4,L
84303,4,SCO2,2004-12-04,Queen of the South,Raith Rovers,2,0,2,W
84304,4,SCO2,2004-12-04,Ross County,Hamilton Academical,1,1,0,D
84305,4,SCO2,2004-12-11,Airdrie United,St Johnstone,0,0,0,D
84306,4,SCO2,2004-12-11,Clyde,Partick Thistle,1,1,0,D
84307,4,SCO2,2004-12-11,Hamilton Academical,Raith Rovers,1,0,1,W
84308,4,SCO2,2004-12-11,Queen of the South,Ross County,1,0,1,W
84309,4,SCO2,2004-12-11,St Mirren,Falkirk,0,1,-1,L
84310,4,SCO2,2004-12-18,Falkirk,Queen of the South,4,2,2,W
84311,4,SCO2,2004-12-18,Partick Thistle,Hamilton Academical,0,1,-1,L
84312,4,SCO2,2004-12-18,Raith Rovers,Airdrie United,0,2,-2,L
84313,4,SCO2,2004-12-18,Ross County,Clyde,0,1,-1,L
84314,4,SCO2,2004-12-18,St Johnstone,St Mirren,1,0,1,W
84315,4,SCO2,2004-12-26,Falkirk,Airdrie United,1,0,1,W
84316,4,SCO2,2004-12-26,St Johnstone,Raith Rovers,2,0,2,W
84317,4,SCO2,2004-12-26,St Mirren,Hamilton Academical,0,1,-1,L
84318,4,SCO2,2004-12-27,Ross County,Partick Thistle,2,1,1,W
84319,4,SCO2,2004-12-29,Airdrie United,Queen of the South,2,0,2,W
84320,4,SCO2,2004-12-29,Hamilton Academical,St Johnstone,0,3,-3,L
84321,4,SCO2,2004-12-29,Partick Thistle,Falkirk,2,1,1,W
84322,4,SCO2,2004-12-29,Raith Rovers,Ross County,1,4,-3,L
84323,4,SCO2,2005-01-01,Clyde,Airdrie United,1,0,1,W
84324,4,SCO2,2005-01-01,Falkirk,Raith Rovers,2,0,2,W
84325,4,SCO2,2005-01-01,Queen of the South,Hamilton Academical,1,2,-1,L
84326,4,SCO2,2005-01-01,St Mirren,Partick Thistle,1,1,0,D
84327,4,SCO2,2005-01-03,Ross County,St Johnstone,4,0,4,W
84328,4,SCO2,2005-01-15,Airdrie United,Ross County,2,1,1,W
84329,4,SCO2,2005-01-15,Hamilton Academical,Clyde,0,1,-1,L
84330,4,SCO2,2005-01-15,Partick Thistle,Queen of the South,3,1,2,W
84331,4,SCO2,2005-01-15,Raith Rovers,St Mirren,2,0,2,W
84332,4,SCO2,2005-01-15,St Johnstone,Falkirk,0,3,-3,L
84333,4,SCO2,2005-01-22,Hamilton Academical,Ross County,0,1,-1,L
84334,4,SCO2,2005-01-22,Raith Rovers,Queen of the South,0,1,-1,L
84335,4,SCO2,2005-01-22,St Johnstone,Partick Thistle,1,1,0,D
84336,4,SCO2,2005-01-22,St Mirren,Airdrie United,1,0,1,W
84337,4,SCO2,2005-01-29,Partick Thistle,Raith Rovers,4,1,3,W
84338,4,SCO2,2005-01-29,Queen of the South,St Mirren,0,0,0,D
84339,4,SCO2,2005-01-29,Ross County,Falkirk,0,1,-1,L
84340,4,SCO2,2005-02-12,Falkirk,Hamilton Academical,1,1,0,D
84341,4,SCO2,2005-02-12,Partick Thistle,Airdrie United,1,1,0,D
84342,4,SCO2,2005-02-12,Raith Rovers,Clyde,3,3,0,D
84343,4,SCO2,2005-02-12,St Johnstone,Queen of the South,0,0,0,D
84344,4,SCO2,2005-02-19,Airdrie United,Raith Rovers,2,1,1,W
84345,4,SCO2,2005-02-19,Clyde,Ross County,1,0,1,W
84346,4,SCO2,2005-02-19,Hamilton Academical,Partick Thistle,1,0,1,W
84347,4,SCO2,2005-02-19,Queen of the South,Falkirk,1,1,0,D
84348,4,SCO2,2005-02-19,St Mirren,St Johnstone,1,1,0,D
84349,4,SCO2,2005-03-01,Ross County,St Mirren,0,1,-1,L
84350,4,SCO2,2005-03-02,Queen of the South,Clyde,0,1,-1,L
84351,4,SCO2,2005-03-05,Falkirk,Partick Thistle,2,1,1,W
84352,4,SCO2,2005-03-05,Queen of the South,Airdrie United,0,0,0,D
84353,4,SCO2,2005-03-05,Ross County,Raith Rovers,2,0,2,W
84354,4,SCO2,2005-03-05,St Johnstone,Hamilton Academical,0,2,-2,L
84355,4,SCO2,2005-03-05,St Mirren,Clyde,0,0,0,D
84356,4,SCO2,2005-03-08,Airdrie United,Hamilton Academical,1,0,1,W
84357,4,SCO2,2005-03-08,Clyde,St Mirren,0,0,0,D
84358,4,SCO2,2005-03-12,Airdrie United,Falkirk,2,2,0,D
84359,4,SCO2,2005-03-12,Clyde,Queen of the South,0,1,-1,L
84360,4,SCO2,2005-03-12,Hamilton Academical,St Mirren,0,0,0,D
84361,4,SCO2,2005-03-12,Partick Thistle,Ross County,0,0,0,D
84362,4,SCO2,2005-03-12,Raith Rovers,St Johnstone,1,2,-1,L
84363,4,SCO2,2005-03-15,Falkirk,Clyde,0,0,0,D
84364,4,SCO2,2005-03-19,Airdrie United,Clyde,2,4,-2,L
84365,4,SCO2,2005-03-19,Hamilton Academical,Queen of the South,1,1,0,D
84366,4,SCO2,2005-03-19,Partick Thistle,St Mirren,0,0,0,D
84367,4,SCO2,2005-03-19,Raith Rovers,Falkirk,3,3,0,D
84368,4,SCO2,2005-03-19,St Johnstone,Ross County,0,2,-2,L
84369,4,SCO2,2005-03-22,Clyde,St Johnstone,1,1,0,D
84370,4,SCO2,2005-04-02,Clyde,Hamilton Academical,1,3,-2,L
84371,4,SCO2,2005-04-02,Falkirk,St Johnstone,3,0,3,W
84372,4,SCO2,2005-04-02,Queen of the South,Partick Thistle,3,1,2,W
84373,4,SCO2,2005-04-02,Ross County,Airdrie United,3,1,2,W
84374,4,SCO2,2005-04-02,St Mirren,Raith Rovers,3,0,3,W
84375,4,SCO2,2005-04-09,Falkirk,Ross County,1,0,1,W
84376,4,SCO2,2005-04-09,Hamilton Academical,Airdrie United,1,1,0,D
84377,4,SCO2,2005-04-09,Raith Rovers,Partick Thistle,2,1,1,W
84378,4,SCO2,2005-04-09,St Johnstone,Clyde,0,0,0,D
84379,4,SCO2,2005-04-09,St Mirren,Queen of the South,3,0,3,W
84380,4,SCO2,2005-04-16,Airdrie United,St Mirren,0,2,-2,L
84381,4,SCO2,2005-04-16,Clyde,Falkirk,0,1,-1,L
84382,4,SCO2,2005-04-16,Partick Thistle,St Johnstone,0,4,-4,L
84383,4,SCO2,2005-04-16,Queen of the South,Raith Rovers,1,1,0,D
84384,4,SCO2,2005-04-16,Ross County,Hamilton Academical,2,1,1,W
84385,4,SCO2,2005-04-23,Falkirk,St Mirren,1,2,-1,L
84386,4,SCO2,2005-04-23,Partick Thistle,Clyde,1,0,1,W
84387,4,SCO2,2005-04-23,Raith Rovers,Hamilton Academical,0,2,-2,L
84388,4,SCO2,2005-04-23,Ross County,Queen of the South,1,1,0,D
84389,4,SCO2,2005-04-23,St Johnstone,Airdrie United,1,2,-1,L
84390,4,SCO2,2005-04-30,Airdrie United,Partick Thistle,0,1,-1,L
84391,4,SCO2,2005-04-30,Clyde,Raith Rovers,1,0,1,W
84392,4,SCO2,2005-04-30,Hamilton Academical,Falkirk,1,0,1,W
84393,4,SCO2,2005-04-30,Queen of the South,St Johnstone,2,0,2,W
84394,4,SCO2,2005-04-30,St Mirren,Ross County,1,0,1,W
84395,4,SCO2,2005-05-07,Falkirk,Queen of the South,1,2,-1,L
84396,4,SCO2,2005-05-07,Partick Thistle,Hamilton Academical,1,1,0,D
84397,4,SCO2,2005-05-07,Raith Rovers,Airdrie United,0,1,-1,L
84398,4,SCO2,2005-05-07,Ross County,Clyde,1,1,0,D
84399,4,SCO2,2005-05-07,St Johnstone,St Mirren,0,0,0,D
84400,5,SCO2,2005-08-06,Brechin City,Hamilton Academical,1,2,-1,L
84401,5,SCO2,2005-08-06,FC Dundee,St Mirren,3,2,1,W
84402,5,SCO2,2005-08-06,Ross County,Clyde,3,1,2,W
84403,5,SCO2,2005-08-06,St Johnstone,Queen of the South,4,0,4,W
84404,5,SCO2,2005-08-06,Stranraer,Airdrie United,1,0,1,W
84405,5,SCO2,2005-08-13,Airdrie United,Ross County,0,1,-1,L
84406,5,SCO2,2005-08-13,Clyde,FC Dundee,1,1,0,D
84407,5,SCO2,2005-08-13,Hamilton Academical,St Johnstone,0,1,-1,L
84408,5,SCO2,2005-08-13,Queen of the South,Brechin City,0,0,0,D
84409,5,SCO2,2005-08-13,St Mirren,Stranraer,0,0,0,D
84410,5,SCO2,2005-08-20,Brechin City,Airdrie United,1,1,0,D
84411,5,SCO2,2005-08-20,FC Dundee,Queen of the South,3,1,2,W
84412,5,SCO2,2005-08-20,Ross County,Hamilton Academical,0,0,0,D
84413,5,SCO2,2005-08-20,St Johnstone,St Mirren,1,2,-1,L
84414,5,SCO2,2005-08-20,Stranraer,Clyde,1,2,-1,L
84415,5,SCO2,2005-08-27,Airdrie United,St Johnstone,3,1,2,W
84416,5,SCO2,2005-08-27,Clyde,Queen of the South,1,0,1,W
84417,5,SCO2,2005-08-27,Hamilton Academical,FC Dundee,1,1,0,D
84418,5,SCO2,2005-08-27,Ross County,Stranraer,2,1,1,W
84419,5,SCO2,2005-08-27,St Mirren,Brechin City,1,0,1,W
84420,5,SCO2,2005-09-10,Brechin City,Clyde,1,1,0,D
84421,5,SCO2,2005-09-10,FC Dundee,Airdrie United,0,2,-2,L
84422,5,SCO2,2005-09-10,Queen of the South,St Mirren,0,1,-1,L
84423,5,SCO2,2005-09-10,St Johnstone,Ross County,1,1,0,D
84424,5,SCO2,2005-09-10,Stranraer,Hamilton Academical,1,2,-1,L
84425,5,SCO2,2005-09-17,Hamilton Academical,Airdrie United,1,1,0,D
84426,5,SCO2,2005-09-17,Ross County,Brechin City,1,0,1,W
84427,5,SCO2,2005-09-17,St Johnstone,FC Dundee,1,1,0,D
84428,5,SCO2,2005-09-17,St Mirren,Clyde,2,0,2,W
84429,5,SCO2,2005-09-17,Stranraer,Queen of the South,0,0,0,D
84430,5,SCO2,2005-09-24,Airdrie United,St Mirren,0,1,-1,L
84431,5,SCO2,2005-09-24,Brechin City,Stranraer,2,3,-1,L
84432,5,SCO2,2005-09-24,Clyde,St Johnstone,0,1,-1,L
84433,5,SCO2,2005-09-24,FC Dundee,Ross County,0,0,0,D
84434,5,SCO2,2005-09-24,Queen of the South,Hamilton Academical,1,2,-1,L
84435,5,SCO2,2005-10-01,Airdrie United,Clyde,1,3,-2,L
84436,5,SCO2,2005-10-01,Brechin City,FC Dundee,1,3,-2,L
84437,5,SCO2,2005-10-01,Hamilton Academical,St Mirren,3,1,2,W
84438,5,SCO2,2005-10-01,Ross County,Queen of the South,1,1,0,D
84439,5,SCO2,2005-10-01,Stranraer,St Johnstone,1,1,0,D
84440,5,SCO2,2005-10-07,Ross County,Airdrie United,2,2,0,D
84441,5,SCO2,2005-10-15,Clyde,Hamilton Academical,1,1,0,D
84442,5,SCO2,2005-10-15,FC Dundee,Stranraer,1,1,0,D
84443,5,SCO2,2005-10-15,Queen of the South,Airdrie United,1,0,1,W
84444,5,SCO2,2005-10-15,St Johnstone,Brechin City,3,1,2,W
84445,5,SCO2,2005-10-15,St Mirren,Ross County,2,0,2,W
84446,5,SCO2,2005-10-22,Airdrie United,Stranraer,1,0,1,W
84447,5,SCO2,2005-10-22,Clyde,Ross County,1,0,1,W
84448,5,SCO2,2005-10-22,Hamilton Academical,Brechin City,3,0,3,W
84449,5,SCO2,2005-10-22,Queen of the South,St Johnstone,1,3,-2,L
84450,5,SCO2,2005-10-22,St Mirren,FC Dundee,0,0,0,D
84451,5,SCO2,2005-10-25,Brechin City,Queen of the South,1,1,0,D
84452,5,SCO2,2005-10-25,St Johnstone,Hamilton Academical,5,1,4,W
84453,5,SCO2,2005-10-25,Stranraer,St Mirren,1,2,-1,L
84454,5,SCO2,2005-10-26,FC Dundee,Clyde,3,3,0,D
84455,5,SCO2,2005-10-29,Airdrie United,FC Dundee,4,0,4,W
84456,5,SCO2,2005-10-29,Clyde,Brechin City,2,1,1,W
84457,5,SCO2,2005-10-29,Hamilton Academical,Stranraer,2,0,2,W
84458,5,SCO2,2005-10-29,Ross County,St Johnstone,2,1,1,W
84459,5,SCO2,2005-10-29,St Mirren,Queen of the South,2,0,2,W
84460,5,SCO2,2005-11-05,Queen of the South,Clyde,1,2,-1,L
84461,5,SCO2,2005-11-05,St Johnstone,Airdrie United,1,0,1,W
84462,5,SCO2,2005-11-05,Stranraer,Ross County,2,3,-1,L
84463,5,SCO2,2005-11-12,Airdrie United,Hamilton Academical,2,2,0,D
84464,5,SCO2,2005-11-12,Brechin City,Ross County,1,4,-3,L
84465,5,SCO2,2005-11-12,Clyde,St Mirren,1,2,-1,L
84466,5,SCO2,2005-11-12,FC Dundee,St Johnstone,2,1,1,W
84467,5,SCO2,2005-11-12,Queen of the South,Stranraer,1,1,0,D
84468,5,SCO2,2005-11-15,Brechin City,St Mirren,2,3,-1,L
84469,5,SCO2,2005-11-15,FC Dundee,Hamilton Academical,1,1,0,D
84470,5,SCO2,2005-11-19,Hamilton Academical,Queen of the South,5,2,3,W
84471,5,SCO2,2005-11-19,Ross County,FC Dundee,3,0,3,W
84472,5,SCO2,2005-11-19,St Johnstone,Clyde,0,0,0,D
84473,5,SCO2,2005-11-19,Stranraer,Brechin City,1,1,0,D
84474,5,SCO2,2005-11-26,Clyde,Airdrie United,1,0,1,W
84475,5,SCO2,2005-11-26,FC Dundee,Brechin City,1,0,1,W
84476,5,SCO2,2005-11-26,Queen of the South,Ross County,2,3,-1,L
84477,5,SCO2,2005-11-26,St Johnstone,Stranraer,1,1,0,D
84478,5,SCO2,2005-11-26,St Mirren,Hamilton Academical,2,1,1,W
84479,5,SCO2,2005-11-29,St Mirren,Airdrie United,1,1,0,D
84480,5,SCO2,2005-12-03,Airdrie United,Queen of the South,4,0,4,W
84481,5,SCO2,2005-12-03,Brechin City,St Johnstone,1,4,-3,L
84482,5,SCO2,2005-12-03,Hamilton Academical,Clyde,1,1,0,D
84483,5,SCO2,2005-12-03,Ross County,St Mirren,0,4,-4,L
84484,5,SCO2,2005-12-03,Stranraer,FC Dundee,0,0,0,D
84485,5,SCO2,2005-12-10,Brechin City,Hamilton Academical,0,1,-1,L
84486,5,SCO2,2005-12-10,FC Dundee,St Mirren,4,0,4,W
84487,5,SCO2,2005-12-10,Ross County,Clyde,0,1,-1,L
84488,5,SCO2,2005-12-10,St Johnstone,Queen of the South,2,1,1,W
84489,5,SCO2,2005-12-10,Stranraer,Airdrie United,1,1,0,D
84490,5,SCO2,2005-12-17,Airdrie United,Brechin City,6,0,6,W
84491,5,SCO2,2005-12-17,Clyde,Stranraer,1,0,1,W
84492,5,SCO2,2005-12-17,Hamilton Academical,Ross County,2,1,1,W
84493,5,SCO2,2005-12-17,St Mirren,St Johnstone,0,0,0,D
84494,5,SCO2,2005-12-26,Brechin City,Clyde,3,1,2,W
84495,5,SCO2,2005-12-26,FC Dundee,Airdrie United,2,3,-1,L
84496,5,SCO2,2005-12-26,Queen of the South,St Mirren,0,0,0,D
84497,5,SCO2,2005-12-26,St Johnstone,Ross County,1,1,0,D
84498,5,SCO2,2005-12-26,Stranraer,Hamilton Academical,5,4,1,W
84499,5,SCO2,2005-12-31,Airdrie United,St Johnstone,2,1,1,W
84500,5,SCO2,2005-12-31,Clyde,Queen of the South,3,0,3,W
84501,5,SCO2,2005-12-31,Hamilton Academical,FC Dundee,0,0,0,D
84502,5,SCO2,2005-12-31,St Mirren,Brechin City,3,2,1,W
84503,5,SCO2,2006-01-02,Hamilton Academical,Airdrie United,1,0,1,W
84504,5,SCO2,2006-01-02,Ross County,Brechin City,2,0,2,W
84505,5,SCO2,2006-01-02,St Johnstone,FC Dundee,0,0,0,D
84506,5,SCO2,2006-01-02,St Mirren,Clyde,2,1,1,W
84507,5,SCO2,2006-01-02,Stranraer,Queen of the South,1,0,1,W
84508,5,SCO2,2006-01-14,Airdrie United,St Mirren,1,4,-3,L
84509,5,SCO2,2006-01-14,Brechin City,Stranraer,0,0,0,D
84510,5,SCO2,2006-01-14,Clyde,St Johnstone,2,3,-1,L
84511,5,SCO2,2006-01-14,FC Dundee,Ross County,0,0,0,D
84512,5,SCO2,2006-01-14,Queen of the South,Hamilton Academical,1,1,0,D
84513,5,SCO2,2006-01-21,Airdrie United,Clyde,1,1,0,D
84514,5,SCO2,2006-01-21,Brechin City,FC Dundee,0,3,-3,L
84515,5,SCO2,2006-01-21,Hamilton Academical,St Mirren,0,0,0,D
84516,5,SCO2,2006-01-21,Ross County,Queen of the South,3,1,2,W
84517,5,SCO2,2006-01-21,Stranraer,St Johnstone,0,2,-2,L
84518,5,SCO2,2006-01-28,Clyde,Hamilton Academical,2,2,0,D
84519,5,SCO2,2006-01-28,FC Dundee,Stranraer,2,1,1,W
84520,5,SCO2,2006-01-28,Queen of the South,Airdrie United,2,0,2,W
84521,5,SCO2,2006-01-28,St Johnstone,Brechin City,3,0,3,W
84522,5,SCO2,2006-01-28,St Mirren,Ross County,0,1,-1,L
84523,5,SCO2,2006-02-11,Brechin City,Airdrie United,0,0,0,D
84524,5,SCO2,2006-02-11,FC Dundee,Queen of the South,2,3,-1,L
84525,5,SCO2,2006-02-11,Ross County,Hamilton Academical,2,1,1,W
84526,5,SCO2,2006-02-11,St Johnstone,St Mirren,0,0,0,D
84527,5,SCO2,2006-02-11,Stranraer,Clyde,0,5,-5,L
84528,5,SCO2,2006-02-18,Airdrie United,Ross County,2,3,-1,L
84529,5,SCO2,2006-02-18,Clyde,FC Dundee,3,3,0,D
84530,5,SCO2,2006-02-18,Hamilton Academical,St Johnstone,1,2,-1,L
84531,5,SCO2,2006-02-18,Queen of the South,Brechin City,0,0,0,D
84532,5,SCO2,2006-02-18,St Mirren,Stranraer,3,1,2,W
84533,5,SCO2,2006-02-25,Ross County,Stranraer,1,1,0,D
84534,5,SCO2,2006-02-28,Queen of the South,FC Dundee,0,0,0,D
84535,5,SCO2,2006-03-04,FC Dundee,Hamilton Academical,2,4,-2,L
84536,5,SCO2,2006-03-04,Queen of the South,Clyde,2,1,1,W
84537,5,SCO2,2006-03-04,St Johnstone,Airdrie United,2,2,0,D
84538,5,SCO2,2006-03-11,Airdrie United,FC Dundee,7,0,7,W
84539,5,SCO2,2006-03-11,Clyde,Brechin City,5,1,4,W
84540,5,SCO2,2006-03-11,Ross County,St Johnstone,2,2,0,D
84541,5,SCO2,2006-03-11,St Mirren,Queen of the South,1,0,1,W
84542,5,SCO2,2006-03-18,Airdrie United,Hamilton Academical,0,0,0,D
84543,5,SCO2,2006-03-18,Brechin City,Ross County,3,3,0,D
84544,5,SCO2,2006-03-18,Clyde,St Mirren,0,1,-1,L
84545,5,SCO2,2006-03-18,FC Dundee,St Johnstone,0,1,-1,L
84546,5,SCO2,2006-03-18,Queen of the South,Stranraer,1,0,1,W
84547,5,SCO2,2006-03-21,Brechin City,St Mirren,0,3,-3,L
84548,5,SCO2,2006-03-21,Stranraer,Ross County,2,2,0,D
84549,5,SCO2,2006-03-25,Hamilton Academical,Queen of the South,0,2,-2,L
84550,5,SCO2,2006-03-25,St Johnstone,Clyde,1,0,1,W
84551,5,SCO2,2006-03-25,St Mirren,Airdrie United,2,1,1,W
84552,5,SCO2,2006-03-25,Stranraer,Brechin City,2,0,2,W
84553,5,SCO2,2006-03-28,Hamilton Academical,Stranraer,1,0,1,W
84554,5,SCO2,2006-04-01,Clyde,Airdrie United,3,1,2,W
84555,5,SCO2,2006-04-01,Queen of the South,Ross County,0,0,0,D
84556,5,SCO2,2006-04-01,St Johnstone,Stranraer,3,2,1,W
84557,5,SCO2,2006-04-01,St Mirren,Hamilton Academical,0,2,-2,L
84558,5,SCO2,2006-04-04,Ross County,FC Dundee,0,0,0,D
84559,5,SCO2,2006-04-08,Airdrie United,Queen of the South,1,1,0,D
84560,5,SCO2,2006-04-08,Brechin City,St Johnstone,0,2,-2,L
84561,5,SCO2,2006-04-08,Hamilton Academical,Clyde,2,0,2,W
84562,5,SCO2,2006-04-08,Ross County,St Mirren,0,2,-2,L
84563,5,SCO2,2006-04-08,Stranraer,FC Dundee,1,1,0,D
84564,5,SCO2,2006-04-11,FC Dundee,Brechin City,0,1,-1,L
84565,5,SCO2,2006-04-15,Airdrie United,Stranraer,3,0,3,W
84566,5,SCO2,2006-04-15,Clyde,Ross County,2,0,2,W
84567,5,SCO2,2006-04-15,Hamilton Academical,Brechin City,2,0,2,W
84568,5,SCO2,2006-04-15,Queen of the South,St Johnstone,3,2,1,W
84569,5,SCO2,2006-04-15,St Mirren,FC Dundee,2,1,1,W
84570,5,SCO2,2006-04-22,Brechin City,Queen of the South,1,1,0,D
84571,5,SCO2,2006-04-22,FC Dundee,Clyde,0,1,-1,L
84572,5,SCO2,2006-04-22,Ross County,Airdrie United,0,1,-1,L
84573,5,SCO2,2006-04-22,St Johnstone,Hamilton Academical,1,1,0,D
84574,5,SCO2,2006-04-22,Stranraer,St Mirren,0,1,-1,L
84575,5,SCO2,2006-04-29,Airdrie United,Brechin City,3,3,0,D
84576,5,SCO2,2006-04-29,Clyde,Stranraer,1,1,0,D
84577,5,SCO2,2006-04-29,Hamilton Academical,Ross County,0,0,0,D
84578,5,SCO2,2006-04-29,Queen of the South,FC Dundee,1,3,-2,L
84579,5,SCO2,2006-04-29,St Mirren,St Johnstone,0,1,-1,L
84580,6,SCO2,2006-08-05,Airdrie United,Ross County,0,2,-2,L
84581,6,SCO2,2006-08-05,FC Dundee,Partick Thistle,0,1,-1,L
84582,6,SCO2,2006-08-05,Gretna,Hamilton Academical,6,0,6,W
84583,6,SCO2,2006-08-05,Livingston,Queen of the South,2,0,2,W
84584,6,SCO2,2006-08-05,St Johnstone,Clyde,0,0,0,D
84585,6,SCO2,2006-08-12,Hamilton Academical,FC Dundee,1,0,1,W
84586,6,SCO2,2006-08-12,Partick Thistle,Airdrie United,4,2,2,W
84587,6,SCO2,2006-08-12,Queen of the South,St Johnstone,0,1,-1,L
84588,6,SCO2,2006-08-12,Ross County,Livingston,0,3,-3,L
84589,6,SCO2,2006-08-13,Clyde,Gretna,1,2,-1,L
84590,6,SCO2,2006-08-19,Airdrie United,Queen of the South,2,2,0,D
84591,6,SCO2,2006-08-19,Gretna,Ross County,2,1,1,W
84592,6,SCO2,2006-08-19,Livingston,Partick Thistle,2,2,0,D
84593,6,SCO2,2006-08-19,St Johnstone,Hamilton Academical,0,0,0,D
84594,6,SCO2,2006-08-20,FC Dundee,Clyde,3,0,3,W
84595,6,SCO2,2006-08-26,Airdrie United,Hamilton Academical,1,2,-1,L
84596,6,SCO2,2006-08-26,Clyde,Partick Thistle,0,0,0,D
84597,6,SCO2,2006-08-26,FC Dundee,Livingston,0,1,-1,L
84598,6,SCO2,2006-08-26,St Johnstone,Ross County,3,1,2,W
84599,6,SCO2,2006-08-27,Queen of the South,Gretna,0,3,-3,L
84600,6,SCO2,2006-09-09,Gretna,FC Dundee,0,4,-4,L
84601,6,SCO2,2006-09-09,Livingston,Airdrie United,3,0,3,W
84602,6,SCO2,2006-09-09,Partick Thistle,St Johnstone,1,5,-4,L
84603,6,SCO2,2006-09-09,Ross County,Queen of the South,1,0,1,W
84604,6,SCO2,2006-09-16,Clyde,Ross County,3,0,3,W
84605,6,SCO2,2006-09-16,FC Dundee,Queen of the South,2,1,1,W
84606,6,SCO2,2006-09-16,Gretna,Livingston,1,1,0,D
84607,6,SCO2,2006-09-16,Hamilton Academical,Partick Thistle,1,2,-1,L
84608,6,SCO2,2006-09-16,St Johnstone,Airdrie United,1,0,1,W
84609,6,SCO2,2006-09-23,Airdrie United,FC Dundee,0,1,-1,L
84610,6,SCO2,2006-09-23,Livingston,St Johnstone,1,1,0,D
84611,6,SCO2,2006-09-23,Partick Thistle,Gretna,0,6,-6,L
84612,6,SCO2,2006-09-23,Queen of the South,Clyde,0,2,-2,L
84613,6,SCO2,2006-09-23,Ross County,Hamilton Academical,0,1,-1,L
84614,6,SCO2,2006-09-30,Clyde,Livingston,1,1,0,D
84615,6,SCO2,2006-09-30,FC Dundee,St Johnstone,1,1,0,D
84616,6,SCO2,2006-09-30,Gretna,Airdrie United,0,2,-2,L
84617,6,SCO2,2006-09-30,Hamilton Academical,Queen of the South,1,1,0,D
84618,6,SCO2,2006-09-30,Partick Thistle,Ross County,3,2,1,W
84619,6,SCO2,2006-10-13,Livingston,Hamilton Academical,0,1,-1,L
84620,6,SCO2,2006-10-14,Airdrie United,Clyde,2,1,1,W
84621,6,SCO2,2006-10-14,Queen of the South,Partick Thistle,0,2,-2,L
84622,6,SCO2,2006-10-14,Ross County,FC Dundee,1,0,1,W
84623,6,SCO2,2006-10-14,St Johnstone,Gretna,3,3,0,D
84624,6,SCO2,2006-10-17,Hamilton Academical,Clyde,3,1,2,W
84625,6,SCO2,2006-10-21,Airdrie United,Partick Thistle,1,2,-1,L
84626,6,SCO2,2006-10-21,FC Dundee,Hamilton Academical,1,1,0,D
84627,6,SCO2,2006-10-21,Gretna,Clyde,3,3,0,D
84628,6,SCO2,2006-10-21,Livingston,Ross County,0,0,0,D
84629,6,SCO2,2006-10-21,St Johnstone,Queen of the South,5,0,5,W
84630,6,SCO2,2006-10-28,Clyde,St Johnstone,1,0,1,W
84631,6,SCO2,2006-10-28,Hamilton Academical,Gretna,3,1,2,W
84632,6,SCO2,2006-10-28,Partick Thistle,FC Dundee,3,1,2,W
84633,6,SCO2,2006-10-28,Queen of the South,Livingston,2,0,2,W
84634,6,SCO2,2006-10-28,Ross County,Airdrie United,2,1,1,W
84635,6,SCO2,2006-11-04,Airdrie United,Livingston,0,1,-1,L
84636,6,SCO2,2006-11-04,Clyde,Hamilton Academical,2,1,1,W
84637,6,SCO2,2006-11-04,FC Dundee,Gretna,1,3,-2,L
84638,6,SCO2,2006-11-04,Queen of the South,Ross County,2,0,2,W
84639,6,SCO2,2006-11-04,St Johnstone,Partick Thistle,2,0,2,W
84640,6,SCO2,2006-11-11,Gretna,Queen of the South,5,0,5,W
84641,6,SCO2,2006-11-11,Hamilton Academical,Airdrie United,2,1,1,W
84642,6,SCO2,2006-11-11,Livingston,FC Dundee,2,3,-1,L
84643,6,SCO2,2006-11-18,Airdrie United,St Johnstone,2,1,1,W
84644,6,SCO2,2006-11-18,Livingston,Gretna,1,2,-1,L
84645,6,SCO2,2006-11-18,Partick Thistle,Hamilton Academical,3,1,2,W
84646,6,SCO2,2006-11-18,Queen of the South,FC Dundee,2,0,2,W
84647,6,SCO2,2006-11-18,Ross County,Clyde,1,1,0,D
84648,6,SCO2,2006-11-22,Partick Thistle,Clyde,1,1,0,D
84649,6,SCO2,2006-11-22,Ross County,St Johnstone,2,2,0,D
84650,6,SCO2,2006-11-25,Clyde,Queen of the South,4,0,4,W
84651,6,SCO2,2006-11-25,FC Dundee,Airdrie United,1,0,1,W
84652,6,SCO2,2006-11-25,Gretna,Partick Thistle,4,0,4,W
84653,6,SCO2,2006-11-25,Hamilton Academical,Ross County,0,0,0,D
84654,6,SCO2,2006-11-25,St Johnstone,Livingston,1,2,-1,L
84655,6,SCO2,2006-12-02,Clyde,Airdrie United,0,0,0,D
84656,6,SCO2,2006-12-02,FC Dundee,Ross County,3,1,2,W
84657,6,SCO2,2006-12-02,Gretna,St Johnstone,2,0,2,W
84658,6,SCO2,2006-12-02,Hamilton Academical,Livingston,1,1,0,D
84659,6,SCO2,2006-12-02,Partick Thistle,Queen of the South,1,1,0,D
84660,6,SCO2,2006-12-09,Airdrie United,Gretna,4,2,2,W
84661,6,SCO2,2006-12-09,Livingston,Clyde,1,1,0,D
84662,6,SCO2,2006-12-09,Queen of the South,Hamilton Academical,1,1,0,D
84663,6,SCO2,2006-12-09,Ross County,Partick Thistle,2,5,-3,L
84664,6,SCO2,2006-12-09,St Johnstone,FC Dundee,2,1,1,W
84665,6,SCO2,2006-12-16,Clyde,FC Dundee,2,1,1,W
84666,6,SCO2,2006-12-16,Hamilton Academical,St Johnstone,2,2,0,D
84667,6,SCO2,2006-12-16,Partick Thistle,Livingston,2,3,-1,L
84668,6,SCO2,2006-12-16,Queen of the South,Airdrie United,1,1,0,D
84669,6,SCO2,2006-12-16,Ross County,Gretna,0,1,-1,L
84670,6,SCO2,2006-12-23,Gretna,Hamilton Academical,1,0,1,W
84671,6,SCO2,2006-12-23,Livingston,Queen of the South,0,1,-1,L
84672,6,SCO2,2006-12-26,Airdrie United,Ross County,0,1,-1,L
84673,6,SCO2,2006-12-26,FC Dundee,Partick Thistle,3,1,2,W
84674,6,SCO2,2006-12-26,St Johnstone,Clyde,2,1,1,W
84675,6,SCO2,2006-12-30,Gretna,FC Dundee,1,0,1,W
84676,6,SCO2,2006-12-30,Hamilton Academical,Clyde,1,1,0,D
84677,6,SCO2,2006-12-30,Livingston,Airdrie United,1,3,-2,L
84678,6,SCO2,2006-12-30,Ross County,Queen of the South,1,0,1,W
84679,6,SCO2,2007-01-02,Airdrie United,Hamilton Academical,1,0,1,W
84680,6,SCO2,2007-01-02,Clyde,Partick Thistle,2,0,2,W
84681,6,SCO2,2007-01-02,FC Dundee,Livingston,2,0,2,W
84682,6,SCO2,2007-01-02,Queen of the South,Gretna,0,4,-4,L
84683,6,SCO2,2007-01-02,St Johnstone,Ross County,2,1,1,W
84684,6,SCO2,2007-01-13,Livingston,St Johnstone,3,2,1,W
84685,6,SCO2,2007-01-13,Partick Thistle,Gretna,2,2,0,D
84686,6,SCO2,2007-01-20,Clyde,Ross County,2,4,-2,L
84687,6,SCO2,2007-01-20,FC Dundee,Queen of the South,1,0,1,W
84688,6,SCO2,2007-01-20,Gretna,Livingston,4,1,3,W
84689,6,SCO2,2007-01-20,Hamilton Academical,Partick Thistle,2,1,1,W
84690,6,SCO2,2007-01-20,St Johnstone,Airdrie United,4,3,1,W
84691,6,SCO2,2007-01-27,Airdrie United,Clyde,1,0,1,W
84692,6,SCO2,2007-01-27,Livingston,Hamilton Academical,1,2,-1,L
84693,6,SCO2,2007-01-27,Queen of the South,Partick Thistle,4,3,1,W
84694,6,SCO2,2007-01-27,Ross County,FC Dundee,0,0,0,D
84695,6,SCO2,2007-01-27,St Johnstone,Gretna,2,1,1,W
84696,6,SCO2,2007-02-03,Airdrie United,FC Dundee,0,3,-3,L
84697,6,SCO2,2007-02-10,Clyde,Livingston,0,1,-1,L
84698,6,SCO2,2007-02-10,FC Dundee,St Johnstone,2,1,1,W
84699,6,SCO2,2007-02-10,Gretna,Airdrie United,0,0,0,D
84700,6,SCO2,2007-02-10,Hamilton Academical,Queen of the South,2,2,0,D
84701,6,SCO2,2007-02-10,Partick Thistle,Ross County,1,1,0,D
84702,6,SCO2,2007-02-17,Airdrie United,Queen of the South,0,3,-3,L
84703,6,SCO2,2007-02-17,FC Dundee,Clyde,1,4,-3,L
84704,6,SCO2,2007-02-17,Gretna,Ross County,4,1,3,W
84705,6,SCO2,2007-02-17,Livingston,Partick Thistle,0,1,-1,L
84706,6,SCO2,2007-02-17,St Johnstone,Hamilton Academical,4,2,2,W
84707,6,SCO2,2007-02-24,Clyde,Gretna,2,0,2,W
84708,6,SCO2,2007-02-24,Hamilton Academical,FC Dundee,1,0,1,W
84709,6,SCO2,2007-02-24,Ross County,Livingston,0,2,-2,L
84710,6,SCO2,2007-03-03,Gretna,Queen of the South,0,3,-3,L
84711,6,SCO2,2007-03-03,Hamilton Academical,Airdrie United,3,0,3,W
84712,6,SCO2,2007-03-03,Livingston,FC Dundee,1,3,-2,L
84713,6,SCO2,2007-03-03,Partick Thistle,Clyde,0,4,-4,L
84714,6,SCO2,2007-03-03,Ross County,St Johnstone,1,1,0,D
84715,6,SCO2,2007-03-06,Queen of the South,St Johnstone,1,0,1,W
84716,6,SCO2,2007-03-10,Airdrie United,Livingston,3,1,2,W
84717,6,SCO2,2007-03-10,Clyde,Hamilton Academical,3,0,3,W
84718,6,SCO2,2007-03-10,Queen of the South,Ross County,2,0,2,W
84719,6,SCO2,2007-03-10,St Johnstone,Partick Thistle,2,0,2,W
84720,6,SCO2,2007-03-11,FC Dundee,Gretna,0,1,-1,L
84721,6,SCO2,2007-03-13,Partick Thistle,St Johnstone,2,0,2,W
84722,6,SCO2,2007-03-13,Ross County,Hamilton Academical,4,1,3,W
84723,6,SCO2,2007-03-17,Airdrie United,St Johnstone,1,2,-1,L
84724,6,SCO2,2007-03-17,Livingston,Gretna,1,1,0,D
84725,6,SCO2,2007-03-17,Partick Thistle,Hamilton Academical,0,2,-2,L
84726,6,SCO2,2007-03-17,Queen of the South,FC Dundee,2,2,0,D
84727,6,SCO2,2007-03-17,Ross County,Clyde,2,2,0,D
84728,6,SCO2,2007-03-25,Partick Thistle,Airdrie United,0,1,-1,L
84729,6,SCO2,2007-03-25,Queen of the South,Clyde,0,0,0,D
84730,6,SCO2,2007-03-25,St Johnstone,FC Dundee,2,0,2,W
84731,6,SCO2,2007-03-31,Clyde,Queen of the South,0,1,-1,L
84732,6,SCO2,2007-03-31,Gretna,Partick Thistle,2,0,2,W
84733,6,SCO2,2007-03-31,Hamilton Academical,Ross County,1,0,1,W
84734,6,SCO2,2007-03-31,St Johnstone,Livingston,1,2,-1,L
84735,6,SCO2,2007-04-01,FC Dundee,Airdrie United,2,1,1,W
84736,6,SCO2,2007-04-03,Queen of the South,Hamilton Academical,1,1,0,D
84737,6,SCO2,2007-04-03,Ross County,Partick Thistle,2,1,1,W
84738,6,SCO2,2007-04-04,Airdrie United,Gretna,0,0,0,D
84739,6,SCO2,2007-04-04,Livingston,Clyde,0,0,0,D
84740,6,SCO2,2007-04-07,Clyde,Airdrie United,0,1,-1,L
84741,6,SCO2,2007-04-07,FC Dundee,Ross County,3,2,1,W
84742,6,SCO2,2007-04-07,Gretna,St Johnstone,0,2,-2,L
84743,6,SCO2,2007-04-07,Hamilton Academical,Livingston,3,0,3,W
84744,6,SCO2,2007-04-07,Partick Thistle,Queen of the South,0,0,0,D
84745,6,SCO2,2007-04-14,Hamilton Academical,Gretna,0,0,0,D
84746,6,SCO2,2007-04-14,Partick Thistle,FC Dundee,2,1,1,W
84747,6,SCO2,2007-04-14,Queen of the South,Livingston,1,1,0,D
84748,6,SCO2,2007-04-14,Ross County,Airdrie United,1,1,0,D
84749,6,SCO2,2007-04-17,Clyde,St Johnstone,0,1,-1,L
84750,6,SCO2,2007-04-21,Airdrie United,Partick Thistle,1,1,0,D
84751,6,SCO2,2007-04-21,FC Dundee,Hamilton Academical,1,0,1,W
84752,6,SCO2,2007-04-21,Gretna,Clyde,0,0,0,D
84753,6,SCO2,2007-04-21,Livingston,Ross County,1,1,0,D
84754,6,SCO2,2007-04-21,St Johnstone,Queen of the South,3,0,3,W
84755,6,SCO2,2007-04-28,Clyde,FC Dundee,1,1,0,D
84756,6,SCO2,2007-04-28,Hamilton Academical,St Johnstone,3,4,-1,L
84757,6,SCO2,2007-04-28,Partick Thistle,Livingston,0,0,0,D
84758,6,SCO2,2007-04-28,Queen of the South,Airdrie United,0,3,-3,L
84759,6,SCO2,2007-04-28,Ross County,Gretna,2,3,-1,L
84760,7,SCO2,2007-08-04,Hamilton Academical,Dunfermline Athletic,2,1,1,W
84761,7,SCO2,2007-08-04,Livingston,FC Dundee,0,2,-2,L
84762,7,SCO2,2007-08-04,Greenock Morton,Clyde,3,2,1,W
84763,7,SCO2,2007-08-04,Queen of the South,St Johnstone,3,3,0,D
84764,7,SCO2,2007-08-04,Stirling Albion,Partick Thistle,1,1,0,D
84765,7,SCO2,2007-08-11,Clyde,Hamilton Academical,0,2,-2,L
84766,7,SCO2,2007-08-11,FC Dundee,Queen of the South,2,1,1,W
84767,7,SCO2,2007-08-11,Dunfermline Athletic,Greenock Morton,0,1,-1,L
84768,7,SCO2,2007-08-11,Partick Thistle,Livingston,3,0,3,W
84769,7,SCO2,2007-08-11,St Johnstone,Stirling Albion,2,2,0,D
84770,7,SCO2,2007-08-18,Hamilton Academical,Queen of the South,1,0,1,W
84771,7,SCO2,2007-08-18,Partick Thistle,Clyde,4,0,4,W
84772,7,SCO2,2007-08-18,St Johnstone,FC Dundee,1,1,0,D
84773,7,SCO2,2007-08-18,Stirling Albion,Greenock Morton,0,0,0,D
84774,7,SCO2,2007-08-19,Livingston,Dunfermline Athletic,1,1,0,D
84775,7,SCO2,2007-08-25,Clyde,St Johnstone,1,0,1,W
84776,7,SCO2,2007-08-25,FC Dundee,Partick Thistle,3,0,3,W
84777,7,SCO2,2007-08-25,Dunfermline Athletic,Stirling Albion,2,1,1,W
84778,7,SCO2,2007-08-25,Greenock Morton,Hamilton Academical,0,2,-2,L
84779,7,SCO2,2007-08-25,Queen of the South,Livingston,1,0,1,W
84780,7,SCO2,2007-09-01,Clyde,FC Dundee,1,2,-1,L
84781,7,SCO2,2007-09-01,Greenock Morton,Queen of the South,0,1,-1,L
84782,7,SCO2,2007-09-01,Partick Thistle,Hamilton Academical,0,3,-3,L
84783,7,SCO2,2007-09-01,Stirling Albion,Livingston,3,3,0,D
84784,7,SCO2,2007-09-02,Dunfermline Athletic,St Johnstone,0,0,0,D
84785,7,SCO2,2007-09-15,FC Dundee,Dunfermline Athletic,1,1,0,D
84786,7,SCO2,2007-09-15,Hamilton Academical,Stirling Albion,4,0,4,W
84787,7,SCO2,2007-09-15,Livingston,Greenock Morton,4,0,4,W
84788,7,SCO2,2007-09-15,Queen of the South,Clyde,1,1,0,D
84789,7,SCO2,2007-09-15,St Johnstone,Partick Thistle,2,1,1,W
84790,7,SCO2,2007-09-22,Clyde,Dunfermline Athletic,2,1,1,W
84791,7,SCO2,2007-09-22,Hamilton Academical,Livingston,1,1,0,D
84792,7,SCO2,2007-09-22,Greenock Morton,St Johnstone,2,2,0,D
84793,7,SCO2,2007-09-22,Partick Thistle,Queen of the South,2,0,2,W
84794,7,SCO2,2007-09-22,Stirling Albion,FC Dundee,2,2,0,D
84795,7,SCO2,2007-09-29,FC Dundee,Greenock Morton,2,1,1,W
84796,7,SCO2,2007-09-29,Dunfermline Athletic,Partick Thistle,1,0,1,W
84797,7,SCO2,2007-09-29,Livingston,Clyde,4,2,2,W
84798,7,SCO2,2007-09-29,Queen of the South,Stirling Albion,2,2,0,D
84799,7,SCO2,2007-09-29,St Johnstone,Hamilton Academical,4,1,3,W
84800,7,SCO2,2007-10-06,Hamilton Academical,FC Dundee,2,0,2,W
84801,7,SCO2,2007-10-06,Livingston,St Johnstone,0,2,-2,L
84802,7,SCO2,2007-10-06,Greenock Morton,Partick Thistle,4,2,2,W
84803,7,SCO2,2007-10-06,Queen of the South,Dunfermline Athletic,0,1,-1,L
84804,7,SCO2,2007-10-06,Stirling Albion,Clyde,0,2,-2,L
84805,7,SCO2,2007-10-20,Clyde,Greenock Morton,0,1,-1,L
84806,7,SCO2,2007-10-20,FC Dundee,Livingston,4,1,3,W
84807,7,SCO2,2007-10-20,Dunfermline Athletic,Hamilton Academical,0,5,-5,L
84808,7,SCO2,2007-10-20,Partick Thistle,Stirling Albion,1,1,0,D
84809,7,SCO2,2007-10-20,St Johnstone,Queen of the South,2,0,2,W
84810,7,SCO2,2007-10-27,Hamilton Academical,Greenock Morton,1,0,1,W
84811,7,SCO2,2007-10-27,Livingston,Queen of the South,2,2,0,D
84812,7,SCO2,2007-10-27,Partick Thistle,FC Dundee,1,1,0,D
84813,7,SCO2,2007-10-27,St Johnstone,Clyde,1,1,0,D
84814,7,SCO2,2007-10-27,Stirling Albion,Dunfermline Athletic,3,0,3,W
84815,7,SCO2,2007-11-03,Clyde,Partick Thistle,1,2,-1,L
84816,7,SCO2,2007-11-03,FC Dundee,St Johnstone,2,1,1,W
84817,7,SCO2,2007-11-03,Dunfermline Athletic,Livingston,0,4,-4,L
84818,7,SCO2,2007-11-03,Greenock Morton,Stirling Albion,1,1,0,D
84819,7,SCO2,2007-11-03,Queen of the South,Hamilton Academical,2,1,1,W
84820,7,SCO2,2007-11-10,Hamilton Academical,Partick Thistle,2,0,2,W
84821,7,SCO2,2007-11-10,Livingston,Stirling Albion,4,3,1,W
84822,7,SCO2,2007-11-10,Queen of the South,Greenock Morton,1,3,-2,L
84823,7,SCO2,2007-11-10,St Johnstone,Dunfermline Athletic,0,0,0,D
84824,7,SCO2,2007-11-11,FC Dundee,Clyde,0,1,-1,L
84825,7,SCO2,2007-11-14,Livingston,Partick Thistle,0,4,-4,L
84826,7,SCO2,2007-11-24,FC Dundee,Hamilton Academical,1,0,1,W
84827,7,SCO2,2007-12-01,Clyde,Queen of the South,0,0,0,D
84828,7,SCO2,2007-12-01,Dunfermline Athletic,FC Dundee,0,1,-1,L
84829,7,SCO2,2007-12-01,Greenock Morton,Livingston,2,2,0,D
84830,7,SCO2,2007-12-01,Partick Thistle,St Johnstone,2,2,0,D
84831,7,SCO2,2007-12-01,Stirling Albion,Hamilton Academical,2,4,-2,L
84832,7,SCO2,2007-12-08,FC Dundee,Stirling Albion,3,1,2,W
84833,7,SCO2,2007-12-08,Dunfermline Athletic,Clyde,1,1,0,D
84834,7,SCO2,2007-12-08,Livingston,Hamilton Academical,2,0,2,W
84835,7,SCO2,2007-12-08,Queen of the South,Partick Thistle,1,2,-1,L
84836,7,SCO2,2007-12-08,St Johnstone,Greenock Morton,2,2,0,D
84837,7,SCO2,2007-12-15,Clyde,Livingston,2,1,1,W
84838,7,SCO2,2007-12-15,Hamilton Academical,St Johnstone,1,0,1,W
84839,7,SCO2,2007-12-15,Greenock Morton,FC Dundee,0,2,-2,L
84840,7,SCO2,2007-12-15,Partick Thistle,Dunfermline Athletic,1,1,0,D
84841,7,SCO2,2007-12-15,Stirling Albion,Queen of the South,1,3,-2,L
84842,7,SCO2,2007-12-22,Dunfermline Athletic,Queen of the South,2,0,2,W
84843,7,SCO2,2007-12-22,Partick Thistle,Greenock Morton,1,1,0,D
84844,7,SCO2,2007-12-22,St Johnstone,Livingston,5,2,3,W
84845,7,SCO2,2007-12-26,Hamilton Academical,Clyde,0,0,0,D
84846,7,SCO2,2007-12-26,Greenock Morton,Dunfermline Athletic,0,1,-1,L
84847,7,SCO2,2007-12-26,Queen of the South,FC Dundee,2,1,1,W
84848,7,SCO2,2007-12-26,Stirling Albion,St Johnstone,0,0,0,D
84849,7,SCO2,2007-12-29,Clyde,St Johnstone,1,3,-2,L
84850,7,SCO2,2007-12-29,FC Dundee,Partick Thistle,1,0,1,W
84851,7,SCO2,2007-12-29,Dunfermline Athletic,Stirling Albion,2,1,1,W
84852,7,SCO2,2007-12-29,Greenock Morton,Hamilton Academical,1,3,-2,L
84853,7,SCO2,2007-12-29,Queen of the South,Livingston,1,0,1,W
84854,7,SCO2,2008-01-02,Hamilton Academical,Queen of the South,1,0,1,W
84855,7,SCO2,2008-01-02,Livingston,Dunfermline Athletic,0,2,-2,L
84856,7,SCO2,2008-01-02,Partick Thistle,Clyde,1,1,0,D
84857,7,SCO2,2008-01-02,St Johnstone,FC Dundee,1,1,0,D
84858,7,SCO2,2008-01-02,Stirling Albion,Greenock Morton,1,2,-1,L
84859,7,SCO2,2008-01-05,FC Dundee,Dunfermline Athletic,0,0,0,D
84860,7,SCO2,2008-01-05,Hamilton Academical,Stirling Albion,0,0,0,D
84861,7,SCO2,2008-01-05,Livingston,Greenock Morton,6,1,5,W
84862,7,SCO2,2008-01-05,Queen of the South,Clyde,3,1,2,W
84863,7,SCO2,2008-01-05,St Johnstone,Partick Thistle,2,0,2,W
84864,7,SCO2,2008-01-19,Clyde,FC Dundee,1,1,0,D
84865,7,SCO2,2008-01-19,Dunfermline Athletic,St Johnstone,0,1,-1,L
84866,7,SCO2,2008-01-19,Greenock Morton,Queen of the South,0,3,-3,L
84867,7,SCO2,2008-01-19,Partick Thistle,Hamilton Academical,3,0,3,W
84868,7,SCO2,2008-01-19,Stirling Albion,Livingston,1,4,-3,L
84869,7,SCO2,2008-01-26,Clyde,Hamilton Academical,2,3,-1,L
84870,7,SCO2,2008-01-26,FC Dundee,Queen of the South,2,3,-1,L
84871,7,SCO2,2008-01-26,Dunfermline Athletic,Greenock Morton,2,0,2,W
84872,7,SCO2,2008-01-26,St Johnstone,Stirling Albion,2,1,1,W
84873,7,SCO2,2008-02-02,Clyde,Stirling Albion,1,3,-2,L
84874,7,SCO2,2008-02-09,Hamilton Academical,Dunfermline Athletic,3,0,3,W
84875,7,SCO2,2008-02-09,Livingston,FC Dundee,1,1,0,D
84876,7,SCO2,2008-02-09,Greenock Morton,Clyde,1,2,-1,L
84877,7,SCO2,2008-02-09,Queen of the South,St Johnstone,3,1,2,W
84878,7,SCO2,2008-02-09,Stirling Albion,Partick Thistle,1,0,1,W
84879,7,SCO2,2008-02-16,FC Dundee,Greenock Morton,2,0,2,W
84880,7,SCO2,2008-02-16,Dunfermline Athletic,Partick Thistle,1,1,0,D
84881,7,SCO2,2008-02-16,Queen of the South,Stirling Albion,3,1,2,W
84882,7,SCO2,2008-02-16,St Johnstone,Hamilton Academical,2,1,1,W
84883,7,SCO2,2008-02-23,Clyde,Dunfermline Athletic,1,2,-1,L
84884,7,SCO2,2008-02-23,Hamilton Academical,Livingston,3,1,2,W
84885,7,SCO2,2008-02-23,Greenock Morton,St Johnstone,1,2,-1,L
84886,7,SCO2,2008-02-23,Partick Thistle,Queen of the South,0,0,0,D
84887,7,SCO2,2008-02-23,Stirling Albion,FC Dundee,1,6,-5,L
84888,7,SCO2,2008-03-01,Clyde,Partick Thistle,1,4,-3,L
84889,7,SCO2,2008-03-01,FC Dundee,St Johnstone,3,2,1,W
84890,7,SCO2,2008-03-01,Dunfermline Athletic,Livingston,1,1,0,D
84891,7,SCO2,2008-03-01,Greenock Morton,Stirling Albion,2,1,1,W
84892,7,SCO2,2008-03-01,Queen of the South,Hamilton Academical,2,2,0,D
84893,7,SCO2,2008-03-04,Partick Thistle,Livingston,2,1,1,W
84894,7,SCO2,2008-03-08,Hamilton Academical,Greenock Morton,3,0,3,W
84895,7,SCO2,2008-03-08,Livingston,Clyde,0,0,0,D
84896,7,SCO2,2008-03-11,Clyde,Greenock Morton,1,1,0,D
84897,7,SCO2,2008-03-11,FC Dundee,Livingston,2,0,2,W
84898,7,SCO2,2008-03-11,Dunfermline Athletic,Hamilton Academical,1,1,0,D
84899,7,SCO2,2008-03-11,St Johnstone,Queen of the South,2,1,1,W
84900,7,SCO2,2008-03-15,Hamilton Academical,FC Dundee,1,0,1,W
84901,7,SCO2,2008-03-15,Livingston,St Johnstone,0,2,-2,L
84902,7,SCO2,2008-03-15,Greenock Morton,Partick Thistle,0,0,0,D
84903,7,SCO2,2008-03-15,Queen of the South,Dunfermline Athletic,1,1,0,D
84904,7,SCO2,2008-03-15,Stirling Albion,Clyde,1,1,0,D
84905,7,SCO2,2008-03-22,Clyde,Queen of the South,1,4,-3,L
84906,7,SCO2,2008-03-22,Dunfermline Athletic,FC Dundee,0,1,-1,L
84907,7,SCO2,2008-03-22,Greenock Morton,Livingston,1,1,0,D
84908,7,SCO2,2008-03-22,Partick Thistle,St Johnstone,0,0,0,D
84909,7,SCO2,2008-03-22,Stirling Albion,Hamilton Academical,0,1,-1,L
84910,7,SCO2,2008-03-25,St Johnstone,Clyde,1,2,-1,L
84911,7,SCO2,2008-03-25,Stirling Albion,Dunfermline Athletic,2,3,-1,L
84912,7,SCO2,2008-03-29,FC Dundee,Clyde,2,0,2,W
84913,7,SCO2,2008-03-29,Hamilton Academical,Partick Thistle,0,0,0,D
84914,7,SCO2,2008-03-29,Livingston,Stirling Albion,2,1,1,W
84915,7,SCO2,2008-03-29,Queen of the South,Greenock Morton,0,0,0,D
84916,7,SCO2,2008-03-29,St Johnstone,Dunfermline Athletic,1,1,0,D
84917,7,SCO2,2008-04-01,Livingston,Queen of the South,1,0,1,W
84918,7,SCO2,2008-04-01,Partick Thistle,FC Dundee,1,0,1,W
84919,7,SCO2,2008-04-05,Clyde,Livingston,3,2,1,W
84920,7,SCO2,2008-04-05,Hamilton Academical,St Johnstone,2,0,2,W
84921,7,SCO2,2008-04-05,Greenock Morton,FC Dundee,1,2,-1,L
84922,7,SCO2,2008-04-05,Partick Thistle,Dunfermline Athletic,0,1,-1,L
84923,7,SCO2,2008-04-05,Stirling Albion,Queen of the South,0,0,0,D
84924,7,SCO2,2008-04-08,Partick Thistle,Stirling Albion,1,0,1,W
84925,7,SCO2,2008-04-12,FC Dundee,Stirling Albion,3,0,3,W
84926,7,SCO2,2008-04-12,Dunfermline Athletic,Clyde,2,1,1,W
84927,7,SCO2,2008-04-12,Livingston,Hamilton Academical,1,3,-2,L
84928,7,SCO2,2008-04-12,St Johnstone,Greenock Morton,3,2,1,W
84929,7,SCO2,2008-04-16,Queen of the South,Partick Thistle,2,0,2,W
84930,7,SCO2,2008-04-19,Hamilton Academical,Clyde,2,0,2,W
84931,7,SCO2,2008-04-19,Livingston,Partick Thistle,1,0,1,W
84932,7,SCO2,2008-04-19,Greenock Morton,Dunfermline Athletic,3,0,3,W
84933,7,SCO2,2008-04-19,Queen of the South,FC Dundee,1,0,1,W
84934,7,SCO2,2008-04-23,Stirling Albion,St Johnstone,3,1,2,W
84935,7,SCO2,2008-04-26,Clyde,Stirling Albion,3,0,3,W
84936,7,SCO2,2008-04-26,FC Dundee,Hamilton Academical,1,1,0,D
84937,7,SCO2,2008-04-26,Dunfermline Athletic,Queen of the South,4,0,4,W
84938,7,SCO2,2008-04-26,Partick Thistle,Greenock Morton,0,3,-3,L
84939,7,SCO2,2008-04-26,St Johnstone,Livingston,5,2,3,W
84940,8,SCO2,2008-08-02,Clyde,Greenock Morton,1,1,0,D
84941,8,SCO2,2008-08-02,Partick Thistle,Dunfermline Athletic,1,0,1,W
84942,8,SCO2,2008-08-02,Queen of the South,Airdrie United,0,0,0,D
84943,8,SCO2,2008-08-02,Ross County,FC Dundee,1,2,-1,L
84944,8,SCO2,2008-08-02,St Johnstone,Livingston,2,0,2,W
84945,8,SCO2,2008-08-09,Airdrie United,Partick Thistle,0,1,-1,L
84946,8,SCO2,2008-08-09,FC Dundee,Clyde,1,0,1,W
84947,8,SCO2,2008-08-09,Dunfermline Athletic,Queen of the South,2,1,1,W
84948,8,SCO2,2008-08-09,Livingston,Ross County,2,0,2,W
84949,8,SCO2,2008-08-09,Greenock Morton,St Johnstone,2,2,0,D
84950,8,SCO2,2008-08-16,Airdrie United,FC Dundee,0,0,0,D
84951,8,SCO2,2008-08-16,Clyde,Ross County,2,2,0,D
84952,8,SCO2,2008-08-16,Greenock Morton,Livingston,1,2,-1,L
84953,8,SCO2,2008-08-16,St Johnstone,Dunfermline Athletic,0,3,-3,L
84954,8,SCO2,2008-08-17,Queen of the South,Partick Thistle,2,0,2,W
84955,8,SCO2,2008-08-23,FC Dundee,Greenock Morton,1,0,1,W
84956,8,SCO2,2008-08-23,Dunfermline Athletic,Airdrie United,0,0,0,D
84957,8,SCO2,2008-08-23,Livingston,Clyde,2,1,1,W
84958,8,SCO2,2008-08-23,Partick Thistle,St Johnstone,4,0,4,W
84959,8,SCO2,2008-08-30,Airdrie United,Greenock Morton,5,0,5,W
84960,8,SCO2,2008-08-30,Dunfermline Athletic,Livingston,1,2,-1,L
84961,8,SCO2,2008-08-30,Partick Thistle,Ross County,0,1,-1,L
84962,8,SCO2,2008-08-30,Queen of the South,FC Dundee,3,1,2,W
84963,8,SCO2,2008-08-30,St Johnstone,Clyde,2,3,-1,L
84964,8,SCO2,2008-09-03,Queen of the South,Ross County,1,0,1,W
84965,8,SCO2,2008-09-13,Clyde,Partick Thistle,1,1,0,D
84966,8,SCO2,2008-09-13,FC Dundee,Dunfermline Athletic,0,0,0,D
84967,8,SCO2,2008-09-13,Livingston,Airdrie United,1,2,-1,L
84968,8,SCO2,2008-09-13,Greenock Morton,Queen of the South,0,0,0,D
84969,8,SCO2,2008-09-13,Ross County,St Johnstone,1,2,-1,L
84970,8,SCO2,2008-09-20,Airdrie United,Clyde,0,2,-2,L
84971,8,SCO2,2008-09-20,FC Dundee,Livingston,0,3,-3,L
84972,8,SCO2,2008-09-20,Dunfermline Athletic,Ross County,3,1,2,W
84973,8,SCO2,2008-09-20,Partick Thistle,Greenock Morton,2,1,1,W
84974,8,SCO2,2008-09-20,Queen of the South,St Johnstone,2,2,0,D
84975,8,SCO2,2008-09-27,Clyde,Queen of the South,0,2,-2,L
84976,8,SCO2,2008-09-27,Livingston,Partick Thistle,3,1,2,W
84977,8,SCO2,2008-09-27,Greenock Morton,Dunfermline Athletic,1,1,0,D
84978,8,SCO2,2008-09-27,Ross County,Airdrie United,2,0,2,W
84979,8,SCO2,2008-09-27,St Johnstone,FC Dundee,2,0,2,W
84980,8,SCO2,2008-10-04,Clyde,Dunfermline Athletic,0,2,-2,L
84981,8,SCO2,2008-10-04,Partick Thistle,FC Dundee,0,0,0,D
84982,8,SCO2,2008-10-04,Queen of the South,Livingston,6,1,5,W
84983,8,SCO2,2008-10-04,Ross County,Greenock Morton,3,0,3,W
84984,8,SCO2,2008-10-04,St Johnstone,Airdrie United,3,1,2,W
84985,8,SCO2,2008-10-18,Airdrie United,Queen of the South,2,0,2,W
84986,8,SCO2,2008-10-18,FC Dundee,Ross County,1,2,-1,L
84987,8,SCO2,2008-10-18,Dunfermline Athletic,Partick Thistle,1,0,1,W
84988,8,SCO2,2008-10-18,Livingston,St Johnstone,0,1,-1,L
84989,8,SCO2,2008-10-18,Greenock Morton,Clyde,1,0,1,W
84990,8,SCO2,2008-10-25,Clyde,Livingston,2,1,1,W
84991,8,SCO2,2008-10-25,Greenock Morton,FC Dundee,2,0,2,W
84992,8,SCO2,2008-10-25,Ross County,Queen of the South,0,2,-2,L
84993,8,SCO2,2008-10-25,St Johnstone,Partick Thistle,3,0,3,W
84994,8,SCO2,2008-11-01,FC Dundee,Airdrie United,1,1,0,D
84995,8,SCO2,2008-11-01,Dunfermline Athletic,St Johnstone,1,2,-1,L
84996,8,SCO2,2008-11-01,Livingston,Greenock Morton,1,0,1,W
84997,8,SCO2,2008-11-01,Partick Thistle,Queen of the South,2,0,2,W
84998,8,SCO2,2008-11-01,Ross County,Clyde,3,0,3,W
84999,8,SCO2,2008-11-04,Airdrie United,Dunfermline Athletic,1,3,-2,L
85000,8,SCO2,2008-11-08,Airdrie United,Livingston,0,0,0,D
85001,8,SCO2,2008-11-08,Dunfermline Athletic,FC Dundee,0,1,-1,L
85002,8,SCO2,2008-11-08,Partick Thistle,Clyde,2,0,2,W
85003,8,SCO2,2008-11-08,Queen of the South,Greenock Morton,1,4,-3,L
85004,8,SCO2,2008-11-08,St Johnstone,Ross County,2,1,1,W
85005,8,SCO2,2008-11-15,Clyde,St Johnstone,2,2,0,D
85006,8,SCO2,2008-11-15,FC Dundee,Queen of the South,2,0,2,W
85007,8,SCO2,2008-11-15,Livingston,Dunfermline Athletic,2,3,-1,L
85008,8,SCO2,2008-11-22,Airdrie United,Ross County,0,2,-2,L
85009,8,SCO2,2008-11-22,Dunfermline Athletic,Greenock Morton,0,1,-1,L
85010,8,SCO2,2008-11-22,Partick Thistle,Livingston,2,1,1,W
85011,8,SCO2,2008-11-22,Queen of the South,Clyde,0,2,-2,L
85012,8,SCO2,2008-11-25,Greenock Morton,Airdrie United,2,0,2,W
85013,8,SCO2,2008-11-25,Ross County,Partick Thistle,1,0,1,W
85014,8,SCO2,2008-11-29,FC Dundee,St Johnstone,1,1,0,D
85015,8,SCO2,2008-12-06,St Johnstone,Queen of the South,0,0,0,D
85016,8,SCO2,2008-12-13,Clyde,FC Dundee,1,0,1,W
85017,8,SCO2,2008-12-13,Partick Thistle,Airdrie United,2,1,1,W
85018,8,SCO2,2008-12-13,Queen of the South,Dunfermline Athletic,1,2,-1,L
85019,8,SCO2,2008-12-13,Ross County,Livingston,1,4,-3,L
85020,8,SCO2,2008-12-13,St Johnstone,Greenock Morton,1,0,1,W
85021,8,SCO2,2008-12-16,Clyde,Airdrie United,1,0,1,W
85022,8,SCO2,2008-12-20,Airdrie United,St Johnstone,1,1,0,D
85023,8,SCO2,2008-12-20,FC Dundee,Partick Thistle,0,0,0,D
85024,8,SCO2,2008-12-20,Dunfermline Athletic,Clyde,4,4,0,D
85025,8,SCO2,2008-12-20,Livingston,Queen of the South,2,0,2,W
85026,8,SCO2,2008-12-20,Greenock Morton,Ross County,2,1,1,W
85027,8,SCO2,2008-12-27,Airdrie United,Greenock Morton,1,0,1,W
85028,8,SCO2,2008-12-27,Partick Thistle,Ross County,0,2,-2,L
85029,8,SCO2,2008-12-27,Queen of the South,FC Dundee,0,1,-1,L
85030,8,SCO2,2008-12-27,St Johnstone,Clyde,1,0,1,W
85031,8,SCO2,2008-12-30,Dunfermline Athletic,Livingston,1,0,1,W
85032,8,SCO2,2008-12-30,Greenock Morton,Partick Thistle,2,0,2,W
85033,8,SCO2,2009-01-03,Clyde,Partick Thistle,2,4,-2,L
85034,8,SCO2,2009-01-03,FC Dundee,Dunfermline Athletic,1,0,1,W
85035,8,SCO2,2009-01-03,Livingston,Airdrie United,1,1,0,D
85036,8,SCO2,2009-01-03,Greenock Morton,Queen of the South,2,2,0,D
85037,8,SCO2,2009-01-17,FC Dundee,Greenock Morton,0,0,0,D
85038,8,SCO2,2009-01-17,Dunfermline Athletic,Airdrie United,1,1,0,D
85039,8,SCO2,2009-01-17,Livingston,Clyde,1,1,0,D
85040,8,SCO2,2009-01-17,Partick Thistle,St Johnstone,0,0,0,D
85041,8,SCO2,2009-01-17,Ross County,Queen of the South,1,0,1,W
85042,8,SCO2,2009-01-24,Airdrie United,FC Dundee,1,0,1,W
85043,8,SCO2,2009-01-24,Clyde,Ross County,2,0,2,W
85044,8,SCO2,2009-01-24,Greenock Morton,Livingston,2,2,0,D
85045,8,SCO2,2009-01-24,Queen of the South,Partick Thistle,2,2,0,D
85046,8,SCO2,2009-01-31,Airdrie United,Partick Thistle,0,1,-1,L
85047,8,SCO2,2009-01-31,FC Dundee,Clyde,2,1,1,W
85048,8,SCO2,2009-01-31,Dunfermline Athletic,Queen of the South,0,2,-2,L
85049,8,SCO2,2009-01-31,Livingston,Ross County,4,2,2,W
85050,8,SCO2,2009-01-31,Greenock Morton,St Johnstone,0,0,0,D
85051,8,SCO2,2009-02-07,Livingston,FC Dundee,1,2,-1,L
85052,8,SCO2,2009-02-07,Ross County,St Johnstone,2,2,0,D
85053,8,SCO2,2009-02-14,Partick Thistle,Dunfermline Athletic,2,3,-1,L
85054,8,SCO2,2009-02-14,Queen of the South,Airdrie United,4,0,4,W
85055,8,SCO2,2009-02-14,St Johnstone,Livingston,1,0,1,W
85056,8,SCO2,2009-02-21,FC Dundee,Livingston,4,1,3,W
85057,8,SCO2,2009-02-21,Dunfermline Athletic,Ross County,1,2,-1,L
85058,8,SCO2,2009-02-21,Partick Thistle,Greenock Morton,1,0,1,W
85059,8,SCO2,2009-02-21,Queen of the South,St Johnstone,3,3,0,D
85060,8,SCO2,2009-02-22,Airdrie United,Clyde,1,0,1,W
85061,8,SCO2,2009-02-28,Clyde,Queen of the South,1,1,0,D
85062,8,SCO2,2009-02-28,Livingston,Partick Thistle,2,4,-2,L
85063,8,SCO2,2009-02-28,Greenock Morton,Dunfermline Athletic,2,1,1,W
85064,8,SCO2,2009-02-28,Ross County,Airdrie United,0,0,0,D
85065,8,SCO2,2009-02-28,St Johnstone,FC Dundee,0,0,0,D
85066,8,SCO2,2009-03-03,Clyde,Greenock Morton,2,4,-2,L
85067,8,SCO2,2009-03-07,Airdrie United,Livingston,4,4,0,D
85068,8,SCO2,2009-03-07,Partick Thistle,Clyde,0,1,-1,L
85069,8,SCO2,2009-03-07,Queen of the South,Greenock Morton,1,1,0,D
85070,8,SCO2,2009-03-07,St Johnstone,Ross County,0,0,0,D
85071,8,SCO2,2009-03-10,Clyde,St Johnstone,1,3,-2,L
85072,8,SCO2,2009-03-10,FC Dundee,Queen of the South,2,3,-1,L
85073,8,SCO2,2009-03-10,Livingston,Dunfermline Athletic,4,2,2,W
85074,8,SCO2,2009-03-10,Greenock Morton,Airdrie United,0,0,0,D
85075,8,SCO2,2009-03-10,Ross County,Partick Thistle,0,2,-2,L
85076,8,SCO2,2009-03-14,Airdrie United,Queen of the South,2,0,2,W
85077,8,SCO2,2009-03-14,FC Dundee,Ross County,2,0,2,W
85078,8,SCO2,2009-03-14,Dunfermline Athletic,Partick Thistle,0,1,-1,L
85079,8,SCO2,2009-03-14,Livingston,St Johnstone,1,0,1,W
85080,8,SCO2,2009-03-14,Greenock Morton,Clyde,2,0,2,W
85081,8,SCO2,2009-03-21,Clyde,Dunfermline Athletic,1,4,-3,L
85082,8,SCO2,2009-03-21,Queen of the South,Livingston,3,3,0,D
85083,8,SCO2,2009-03-21,Ross County,Greenock Morton,1,1,0,D
85084,8,SCO2,2009-03-21,St Johnstone,Airdrie United,3,0,3,W
85085,8,SCO2,2009-03-22,Partick Thistle,FC Dundee,1,1,0,D
85086,8,SCO2,2009-03-24,Ross County,Dunfermline Athletic,2,1,1,W
85087,8,SCO2,2009-03-28,Ross County,FC Dundee,1,1,0,D
85088,8,SCO2,2009-03-31,Dunfermline Athletic,FC Dundee,1,1,0,D
85089,8,SCO2,2009-04-04,Airdrie United,Dunfermline Athletic,1,1,0,D
85090,8,SCO2,2009-04-04,Clyde,Livingston,0,1,-1,L
85091,8,SCO2,2009-04-04,Greenock Morton,FC Dundee,2,0,2,W
85092,8,SCO2,2009-04-04,Queen of the South,Ross County,1,2,-1,L
85093,8,SCO2,2009-04-04,St Johnstone,Partick Thistle,1,1,0,D
85094,8,SCO2,2009-04-07,St Johnstone,Dunfermline Athletic,0,0,0,D
85095,8,SCO2,2009-04-11,FC Dundee,Airdrie United,0,1,-1,L
85096,8,SCO2,2009-04-11,Dunfermline Athletic,St Johnstone,1,3,-2,L
85097,8,SCO2,2009-04-11,Livingston,Greenock Morton,0,2,-2,L
85098,8,SCO2,2009-04-11,Partick Thistle,Queen of the South,0,2,-2,L
85099,8,SCO2,2009-04-11,Ross County,Clyde,0,0,0,D
85100,8,SCO2,2009-04-18,Clyde,Airdrie United,3,0,3,W
85101,8,SCO2,2009-04-18,Livingston,FC Dundee,0,1,-1,L
85102,8,SCO2,2009-04-18,Greenock Morton,Partick Thistle,0,1,-1,L
85103,8,SCO2,2009-04-18,Ross County,Dunfermline Athletic,1,3,-2,L
85104,8,SCO2,2009-04-19,St Johnstone,Queen of the South,2,3,-1,L
85105,8,SCO2,2009-04-25,Airdrie United,Ross County,1,0,1,W
85106,8,SCO2,2009-04-25,FC Dundee,St Johnstone,0,1,-1,L
85107,8,SCO2,2009-04-25,Partick Thistle,Livingston,1,0,1,W
85108,8,SCO2,2009-04-25,Queen of the South,Clyde,7,1,6,W
85109,8,SCO2,2009-05-02,Clyde,FC Dundee,2,0,2,W
85110,8,SCO2,2009-05-02,Partick Thistle,Airdrie United,0,1,-1,L
85111,8,SCO2,2009-05-02,Queen of the South,Dunfermline Athletic,0,3,-3,L
85112,8,SCO2,2009-05-02,Ross County,Livingston,2,2,0,D
85113,8,SCO2,2009-05-02,St Johnstone,Greenock Morton,3,1,2,W
85114,8,SCO2,2009-05-05,Dunfermline Athletic,Greenock Morton,2,1,1,W
85115,8,SCO2,2009-05-09,FC Dundee,Partick Thistle,4,0,4,W
85116,8,SCO2,2009-05-09,Dunfermline Athletic,Clyde,1,1,0,D
85117,8,SCO2,2009-05-09,Livingston,Queen of the South,2,2,0,D
85118,8,SCO2,2009-05-09,Greenock Morton,Ross County,0,2,-2,L
85119,8,SCO2,2009-05-11,Airdrie United,St Johnstone,0,4,-4,L
85120,9,SCO2,2009-08-08,Ayr United,Partick Thistle,1,1,0,D
85121,9,SCO2,2009-08-08,FC Dundee,Greenock Morton,1,0,1,W
85122,9,SCO2,2009-08-08,Dunfermline Athletic,Inverness CT,0,1,-1,L
85123,9,SCO2,2009-08-08,Queen of the South,Raith Rovers,1,1,0,D
85124,9,SCO2,2009-08-08,Ross County,Airdrie United,2,1,1,W
85125,9,SCO2,2009-08-15,Airdrie United,Queen of the South,1,1,0,D
85126,9,SCO2,2009-08-15,Inverness CT,Ayr United,0,0,0,D
85127,9,SCO2,2009-08-15,Greenock Morton,Dunfermline Athletic,0,2,-2,L
85128,9,SCO2,2009-08-15,Partick Thistle,Ross County,0,0,0,D
85129,9,SCO2,2009-08-15,Raith Rovers,FC Dundee,2,2,0,D
85130,9,SCO2,2009-08-22,Ayr United,Greenock Morton,0,2,-2,L
85131,9,SCO2,2009-08-22,FC Dundee,Inverness CT,2,2,0,D
85132,9,SCO2,2009-08-22,Dunfermline Athletic,Airdrie United,2,0,2,W
85133,9,SCO2,2009-08-22,Queen of the South,Partick Thistle,1,0,1,W
85134,9,SCO2,2009-08-22,Ross County,Raith Rovers,0,1,-1,L
85135,9,SCO2,2009-08-29,Airdrie United,FC Dundee,1,1,0,D
85136,9,SCO2,2009-08-29,Dunfermline Athletic,Raith Rovers,0,2,-2,L
85137,9,SCO2,2009-08-29,Inverness CT,Ross County,1,3,-2,L
85138,9,SCO2,2009-08-29,Partick Thistle,Greenock Morton,5,0,5,W
85139,9,SCO2,2009-08-29,Queen of the South,Ayr United,2,0,2,W
85140,9,SCO2,2009-09-12,Ayr United,Airdrie United,1,1,0,D
85141,9,SCO2,2009-09-12,FC Dundee,Dunfermline Athletic,1,0,1,W
85142,9,SCO2,2009-09-12,Greenock Morton,Inverness CT,0,3,-3,L
85143,9,SCO2,2009-09-12,Raith Rovers,Partick Thistle,1,1,0,D
85144,9,SCO2,2009-09-12,Ross County,Queen of the South,3,2,1,W
85145,9,SCO2,2009-09-19,Airdrie United,Inverness CT,1,1,0,D
85146,9,SCO2,2009-09-19,Partick Thistle,Dunfermline Athletic,2,0,2,W
85147,9,SCO2,2009-09-19,Queen of the South,FC Dundee,2,0,2,W
85148,9,SCO2,2009-09-19,Raith Rovers,Greenock Morton,3,0,3,W
85149,9,SCO2,2009-09-19,Ross County,Ayr United,2,1,1,W
85150,9,SCO2,2009-09-26,Ayr United,Raith Rovers,1,0,1,W
85151,9,SCO2,2009-09-26,FC Dundee,Ross County,2,0,2,W
85152,9,SCO2,2009-09-26,Dunfermline Athletic,Queen of the South,1,4,-3,L
85153,9,SCO2,2009-09-26,Inverness CT,Partick Thistle,2,3,-1,L
85154,9,SCO2,2009-09-26,Greenock Morton,Airdrie United,1,0,1,W
85155,9,SCO2,2009-10-03,Partick Thistle,Airdrie United,2,0,2,W
85156,9,SCO2,2009-10-03,Queen of the South,Greenock Morton,2,3,-1,L
85157,9,SCO2,2009-10-10,Airdrie United,Raith Rovers,1,2,-1,L
85158,9,SCO2,2009-10-10,FC Dundee,Partick Thistle,2,0,2,W
85159,9,SCO2,2009-10-10,Dunfermline Athletic,Ayr United,3,1,2,W
85160,9,SCO2,2009-10-10,Inverness CT,Queen of the South,1,3,-2,L
85161,9,SCO2,2009-10-10,Greenock Morton,Ross County,0,1,-1,L
85162,9,SCO2,2009-10-13,Raith Rovers,Inverness CT,0,1,-1,L
85163,9,SCO2,2009-10-13,Ross County,Dunfermline Athletic,0,0,0,D
85164,9,SCO2,2009-10-14,Ayr United,FC Dundee,2,2,0,D
85165,9,SCO2,2009-10-17,Airdrie United,Ross County,0,1,-1,L
85166,9,SCO2,2009-10-17,Inverness CT,Dunfermline Athletic,1,1,0,D
85167,9,SCO2,2009-10-17,Greenock Morton,FC Dundee,0,1,-1,L
85168,9,SCO2,2009-10-17,Partick Thistle,Ayr United,2,0,2,W
85169,9,SCO2,2009-10-17,Raith Rovers,Queen of the South,1,0,1,W
85170,9,SCO2,2009-10-24,Ayr United,Inverness CT,1,5,-4,L
85171,9,SCO2,2009-10-24,FC Dundee,Raith Rovers,2,1,1,W
85172,9,SCO2,2009-10-24,Dunfermline Athletic,Greenock Morton,3,1,2,W
85173,9,SCO2,2009-10-24,Queen of the South,Airdrie United,3,0,3,W
85174,9,SCO2,2009-10-24,Ross County,Partick Thistle,2,2,0,D
85175,9,SCO2,2009-10-31,Airdrie United,Ayr United,3,1,2,W
85176,9,SCO2,2009-10-31,Dunfermline Athletic,FC Dundee,1,1,0,D
85177,9,SCO2,2009-10-31,Inverness CT,Greenock Morton,4,1,3,W
85178,9,SCO2,2009-10-31,Partick Thistle,Raith Rovers,1,2,-1,L
85179,9,SCO2,2009-10-31,Queen of the South,Ross County,2,0,2,W
85180,9,SCO2,2009-11-07,Ayr United,Queen of the South,0,1,-1,L
85181,9,SCO2,2009-11-07,FC Dundee,Airdrie United,2,1,1,W
85182,9,SCO2,2009-11-07,Greenock Morton,Partick Thistle,0,2,-2,L
85183,9,SCO2,2009-11-07,Raith Rovers,Dunfermline Athletic,1,2,-1,L
85184,9,SCO2,2009-11-07,Ross County,Inverness CT,2,1,1,W
85185,9,SCO2,2009-11-14,Ayr United,Ross County,1,1,0,D
85186,9,SCO2,2009-11-14,FC Dundee,Queen of the South,0,0,0,D
85187,9,SCO2,2009-11-14,Dunfermline Athletic,Partick Thistle,3,1,2,W
85188,9,SCO2,2009-11-14,Inverness CT,Airdrie United,2,0,2,W
85189,9,SCO2,2009-11-14,Greenock Morton,Raith Rovers,5,0,5,W
85190,9,SCO2,2009-11-21,Airdrie United,Greenock Morton,2,4,-2,L
85191,9,SCO2,2009-11-21,Raith Rovers,Ayr United,0,0,0,D
85192,9,SCO2,2009-11-28,Partick Thistle,Inverness CT,2,1,1,W
85193,9,SCO2,2009-12-01,Queen of the South,Dunfermline Athletic,1,2,-1,L
85194,9,SCO2,2009-12-01,Ross County,FC Dundee,0,1,-1,L
85195,9,SCO2,2009-12-05,Ayr United,Dunfermline Athletic,1,0,1,W
85196,9,SCO2,2009-12-05,Partick Thistle,FC Dundee,0,2,-2,L
85197,9,SCO2,2009-12-05,Queen of the South,Inverness CT,1,1,0,D
85198,9,SCO2,2009-12-08,Ross County,Greenock Morton,3,1,2,W
85199,9,SCO2,2009-12-12,Airdrie United,Partick Thistle,2,5,-3,L
85200,9,SCO2,2009-12-12,FC Dundee,Ayr United,3,1,2,W
85201,9,SCO2,2009-12-12,Dunfermline Athletic,Ross County,3,3,0,D
85202,9,SCO2,2009-12-12,Inverness CT,Raith Rovers,1,0,1,W
85203,9,SCO2,2009-12-12,Greenock Morton,Queen of the South,1,2,-1,L
85204,9,SCO2,2009-12-15,Raith Rovers,Airdrie United,1,1,0,D
85205,9,SCO2,2009-12-19,FC Dundee,Greenock Morton,3,1,2,W
85206,9,SCO2,2009-12-19,Dunfermline Athletic,Inverness CT,0,0,0,D
85207,9,SCO2,2009-12-19,Ross County,Airdrie United,5,3,2,W
85208,9,SCO2,2009-12-26,Inverness CT,FC Dundee,1,1,0,D
85209,9,SCO2,2009-12-26,Partick Thistle,Queen of the South,2,2,0,D
85210,9,SCO2,2010-01-03,FC Dundee,Airdrie United,0,1,-1,L
85211,9,SCO2,2010-01-04,Partick Thistle,Greenock Morton,1,0,1,W
85212,9,SCO2,2010-01-16,Raith Rovers,Partick Thistle,1,0,1,W
85213,9,SCO2,2010-01-17,FC Dundee,Dunfermline Athletic,3,2,1,W
85214,9,SCO2,2010-01-23,Airdrie United,Inverness CT,0,1,-1,L
85215,9,SCO2,2010-01-23,Partick Thistle,Dunfermline Athletic,1,4,-3,L
85216,9,SCO2,2010-01-23,Queen of the South,FC Dundee,1,1,0,D
85217,9,SCO2,2010-01-23,Raith Rovers,Greenock Morton,1,2,-1,L
85218,9,SCO2,2010-01-23,Ross County,Ayr United,1,0,1,W
85219,9,SCO2,2010-01-30,FC Dundee,Ross County,0,1,-1,L
85220,9,SCO2,2010-01-30,Inverness CT,Partick Thistle,2,1,1,W
85221,9,SCO2,2010-02-13,Partick Thistle,Airdrie United,2,0,2,W
85222,9,SCO2,2010-02-13,Queen of the South,Greenock Morton,1,2,-1,L
85223,9,SCO2,2010-02-13,Raith Rovers,Inverness CT,0,4,-4,L
85224,9,SCO2,2010-02-13,Ross County,Dunfermline Athletic,2,2,0,D
85225,9,SCO2,2010-02-16,Queen of the South,Ayr United,3,0,3,W
85226,9,SCO2,2010-02-20,FC Dundee,Partick Thistle,1,0,1,W
85227,9,SCO2,2010-02-20,Dunfermline Athletic,Ayr United,0,1,-1,L
85228,9,SCO2,2010-02-27,Inverness CT,Ayr United,3,3,0,D
85229,9,SCO2,2010-02-27,Greenock Morton,Dunfermline Athletic,1,2,-1,L
85230,9,SCO2,2010-02-27,Partick Thistle,Ross County,2,1,1,W
85231,9,SCO2,2010-03-06,Ayr United,Greenock Morton,2,0,2,W
85232,9,SCO2,2010-03-06,FC Dundee,Inverness CT,2,2,0,D
85233,9,SCO2,2010-03-06,Dunfermline Athletic,Airdrie United,2,0,2,W
85234,9,SCO2,2010-03-06,Queen of the South,Partick Thistle,1,0,1,W
85235,9,SCO2,2010-03-06,Ross County,Raith Rovers,1,0,1,W
85236,9,SCO2,2010-03-09,Airdrie United,Dunfermline Athletic,1,1,0,D
85237,9,SCO2,2010-03-09,Inverness CT,Queen of the South,3,1,2,W
85238,9,SCO2,2010-03-09,Raith Rovers,Ross County,2,1,1,W
85239,9,SCO2,2010-03-10,Ayr United,Partick Thistle,1,0,1,W
85240,9,SCO2,2010-03-13,Airdrie United,Ayr United,1,1,0,D
85241,9,SCO2,2010-03-13,Dunfermline Athletic,Queen of the South,3,1,2,W
85242,9,SCO2,2010-03-13,Inverness CT,Greenock Morton,1,0,1,W
85243,9,SCO2,2010-03-16,Dunfermline Athletic,Raith Rovers,2,1,1,W
85244,9,SCO2,2010-03-17,Ayr United,FC Dundee,1,1,0,D
85245,9,SCO2,2010-03-17,Greenock Morton,Airdrie United,2,1,1,W
85246,9,SCO2,2010-03-20,Airdrie United,FC Dundee,3,0,3,W
85247,9,SCO2,2010-03-20,Ayr United,Queen of the South,3,0,3,W
85248,9,SCO2,2010-03-20,Greenock Morton,Partick Thistle,1,0,1,W
85249,9,SCO2,2010-03-20,Raith Rovers,Dunfermline Athletic,1,2,-1,L
85250,9,SCO2,2010-03-20,Ross County,Inverness CT,0,0,0,D
85251,9,SCO2,2010-03-23,FC Dundee,Queen of the South,1,1,0,D
85252,9,SCO2,2010-03-23,Dunfermline Athletic,Partick Thistle,1,2,-1,L
85253,9,SCO2,2010-03-23,Inverness CT,Airdrie United,4,0,4,W
85254,9,SCO2,2010-03-23,Greenock Morton,Raith Rovers,1,1,0,D
85255,9,SCO2,2010-03-27,Airdrie United,Greenock Morton,3,0,3,W
85256,9,SCO2,2010-03-27,Partick Thistle,Inverness CT,0,1,-1,L
85257,9,SCO2,2010-03-27,Queen of the South,Dunfermline Athletic,2,0,2,W
85258,9,SCO2,2010-03-27,Raith Rovers,Ayr United,1,1,0,D
85259,9,SCO2,2010-03-27,Ross County,FC Dundee,1,1,0,D
85260,9,SCO2,2010-03-30,Dunfermline Athletic,FC Dundee,2,1,1,W
85261,9,SCO2,2010-03-30,Inverness CT,Ross County,3,0,3,W
85262,9,SCO2,2010-03-30,Greenock Morton,Ayr United,1,0,1,W
85263,9,SCO2,2010-04-03,Airdrie United,Partick Thistle,2,0,2,W
85264,9,SCO2,2010-04-03,FC Dundee,Ayr United,3,0,3,W
85265,9,SCO2,2010-04-03,Dunfermline Athletic,Ross County,1,2,-1,L
85266,9,SCO2,2010-04-03,Inverness CT,Raith Rovers,4,3,1,W
85267,9,SCO2,2010-04-03,Greenock Morton,Queen of the South,3,3,0,D
85268,9,SCO2,2010-04-06,Greenock Morton,Inverness CT,0,2,-2,L
85269,9,SCO2,2010-04-06,Ross County,Queen of the South,1,1,0,D
85270,9,SCO2,2010-04-07,Ayr United,Raith Rovers,0,2,-2,L
85271,9,SCO2,2010-04-10,Ayr United,Dunfermline Athletic,1,2,-1,L
85272,9,SCO2,2010-04-10,Partick Thistle,FC Dundee,0,1,-1,L
85273,9,SCO2,2010-04-10,Queen of the South,Inverness CT,1,3,-2,L
85274,9,SCO2,2010-04-12,Airdrie United,Queen of the South,0,1,-1,L
85275,9,SCO2,2010-04-13,Greenock Morton,Ross County,1,1,0,D
85276,9,SCO2,2010-04-14,Airdrie United,Raith Rovers,3,0,3,W
85277,9,SCO2,2010-04-17,Airdrie United,Ross County,1,1,0,D
85278,9,SCO2,2010-04-17,Inverness CT,Dunfermline Athletic,2,0,2,W
85279,9,SCO2,2010-04-17,Greenock Morton,FC Dundee,2,2,0,D
85280,9,SCO2,2010-04-17,Partick Thistle,Ayr United,0,1,-1,L
85281,9,SCO2,2010-04-17,Queen of the South,Raith Rovers,3,0,3,W
85282,9,SCO2,2010-04-19,Partick Thistle,Raith Rovers,0,0,0,D
85283,9,SCO2,2010-04-20,Queen of the South,Ross County,1,0,1,W
85284,9,SCO2,2010-04-21,Ayr United,Airdrie United,1,4,-3,L
85285,9,SCO2,2010-04-21,Raith Rovers,FC Dundee,1,0,1,W
85286,9,SCO2,2010-04-24,Ayr United,Inverness CT,0,7,-7,L
85287,9,SCO2,2010-04-24,FC Dundee,Raith Rovers,2,0,2,W
85288,9,SCO2,2010-04-24,Dunfermline Athletic,Greenock Morton,4,1,3,W
85289,9,SCO2,2010-04-24,Queen of the South,Airdrie United,2,2,0,D
85290,9,SCO2,2010-04-24,Ross County,Partick Thistle,1,2,-1,L
85291,9,SCO2,2010-04-26,Raith Rovers,Airdrie United,0,1,-1,L
85292,9,SCO2,2010-04-26,Ross County,Greenock Morton,2,1,1,W
85293,9,SCO2,2010-04-28,Ayr United,Ross County,0,1,-1,L
85294,9,SCO2,2010-04-28,Raith Rovers,Queen of the South,0,0,0,D
85295,9,SCO2,2010-05-01,Airdrie United,Dunfermline Athletic,0,1,-1,L
85296,9,SCO2,2010-05-01,Inverness CT,FC Dundee,1,0,1,W
85297,9,SCO2,2010-05-01,Greenock Morton,Ayr United,2,1,1,W
85298,9,SCO2,2010-05-01,Partick Thistle,Queen of the South,1,0,1,W
85299,9,SCO2,2010-05-01,Raith Rovers,Ross County,4,1,3,W
85300,10,SCO2,2010-08-07,Cowdenbeath,Ross County,0,2,-2,L
85301,10,SCO2,2010-08-07,FC Dundee,Queen of the South,1,0,1,W
85302,10,SCO2,2010-08-07,Falkirk,Dunfermline Athletic,0,1,-1,L
85303,10,SCO2,2010-08-07,Greenock Morton,Stirling Albion,0,0,0,D
85304,10,SCO2,2010-08-07,Raith Rovers,Partick Thistle,4,0,4,W
85305,10,SCO2,2010-08-14,Dunfermline Athletic,Greenock Morton,2,0,2,W
85306,10,SCO2,2010-08-14,Partick Thistle,FC Dundee,1,0,1,W
85307,10,SCO2,2010-08-14,Queen of the South,Raith Rovers,1,3,-2,L
85308,10,SCO2,2010-08-14,Ross County,Falkirk,0,1,-1,L
85309,10,SCO2,2010-08-14,Stirling Albion,Cowdenbeath,1,3,-2,L
85310,10,SCO2,2010-08-21,FC Dundee,Ross County,0,0,0,D
85311,10,SCO2,2010-08-21,Falkirk,Stirling Albion,3,0,3,W
85312,10,SCO2,2010-08-21,Greenock Morton,Partick Thistle,2,0,2,W
85313,10,SCO2,2010-08-21,Raith Rovers,Dunfermline Athletic,2,0,2,W
85314,10,SCO2,2010-08-22,Cowdenbeath,Queen of the South,1,3,-2,L
85315,10,SCO2,2010-08-28,Cowdenbeath,Partick Thistle,2,1,1,W
85316,10,SCO2,2010-08-28,FC Dundee,Falkirk,2,0,2,W
85317,10,SCO2,2010-08-28,Queen of the South,Ross County,3,0,3,W
85318,10,SCO2,2010-08-28,Raith Rovers,Greenock Morton,1,0,1,W
85319,10,SCO2,2010-08-28,Stirling Albion,Dunfermline Athletic,1,5,-4,L
85320,10,SCO2,2010-09-11,Dunfermline Athletic,FC Dundee,3,1,2,W
85321,10,SCO2,2010-09-11,Falkirk,Queen of the South,3,1,2,W
85322,10,SCO2,2010-09-11,Greenock Morton,Cowdenbeath,1,2,-1,L
85323,10,SCO2,2010-09-11,Partick Thistle,Stirling Albion,1,2,-1,L
85324,10,SCO2,2010-09-11,Ross County,Raith Rovers,0,0,0,D
85325,10,SCO2,2010-09-18,FC Dundee,Raith Rovers,0,0,0,D
85326,10,SCO2,2010-09-18,Dunfermline Athletic,Cowdenbeath,2,1,1,W
85327,10,SCO2,2010-09-18,Falkirk,Greenock Morton,2,1,1,W
85328,10,SCO2,2010-09-18,Queen of the South,Partick Thistle,2,1,1,W
85329,10,SCO2,2010-09-18,Ross County,Stirling Albion,3,1,2,W
85330,10,SCO2,2010-09-25,Cowdenbeath,FC Dundee,2,1,1,W
85331,10,SCO2,2010-09-25,Greenock Morton,Ross County,0,0,0,D
85332,10,SCO2,2010-09-25,Partick Thistle,Dunfermline Athletic,0,2,-2,L
85333,10,SCO2,2010-09-25,Raith Rovers,Falkirk,2,1,1,W
85334,10,SCO2,2010-09-25,Stirling Albion,Queen of the South,0,0,0,D
85335,10,SCO2,2010-10-02,FC Dundee,Greenock Morton,2,1,1,W
85336,10,SCO2,2010-10-02,Falkirk,Cowdenbeath,5,1,4,W
85337,10,SCO2,2010-10-02,Queen of the South,Dunfermline Athletic,2,0,2,W
85338,10,SCO2,2010-10-02,Raith Rovers,Stirling Albion,0,2,-2,L
85339,10,SCO2,2010-10-02,Ross County,Partick Thistle,0,2,-2,L
85340,10,SCO2,2010-10-16,Cowdenbeath,Raith Rovers,1,2,-1,L
85341,10,SCO2,2010-10-16,Dunfermline Athletic,Ross County,3,2,1,W
85342,10,SCO2,2010-10-16,Greenock Morton,Queen of the South,2,0,2,W
85343,10,SCO2,2010-10-16,Partick Thistle,Falkirk,1,0,1,W
85344,10,SCO2,2010-10-16,Stirling Albion,FC Dundee,1,1,0,D
85345,10,SCO2,2010-10-23,Cowdenbeath,Greenock Morton,2,2,0,D
85346,10,SCO2,2010-10-23,FC Dundee,Dunfermline Athletic,2,2,0,D
85347,10,SCO2,2010-10-23,Queen of the South,Falkirk,1,5,-4,L
85348,10,SCO2,2010-10-23,Raith Rovers,Ross County,1,0,1,W
85349,10,SCO2,2010-10-23,Stirling Albion,Partick Thistle,4,2,2,W
85350,10,SCO2,2010-10-30,Dunfermline Athletic,Stirling Albion,3,0,3,W
85351,10,SCO2,2010-10-30,Falkirk,FC Dundee,3,3,0,D
85352,10,SCO2,2010-10-30,Greenock Morton,Raith Rovers,0,1,-1,L
85353,10,SCO2,2010-10-30,Partick Thistle,Cowdenbeath,1,0,1,W
85354,10,SCO2,2010-10-30,Ross County,Queen of the South,1,1,0,D
85355,10,SCO2,2010-11-06,Cowdenbeath,Stirling Albion,5,1,4,W
85356,10,SCO2,2010-11-06,FC Dundee,Partick Thistle,2,1,1,W
85357,10,SCO2,2010-11-06,Falkirk,Ross County,0,1,-1,L
85358,10,SCO2,2010-11-06,Greenock Morton,Dunfermline Athletic,2,1,1,W
85359,10,SCO2,2010-11-06,Raith Rovers,Queen of the South,0,1,-1,L
85360,10,SCO2,2010-11-13,Dunfermline Athletic,Raith Rovers,2,2,0,D
85361,10,SCO2,2010-11-13,Partick Thistle,Greenock Morton,0,0,0,D
85362,10,SCO2,2010-11-13,Queen of the South,Cowdenbeath,3,0,3,W
85363,10,SCO2,2010-11-13,Ross County,FC Dundee,0,3,-3,L
85364,10,SCO2,2010-11-13,Stirling Albion,Falkirk,0,5,-5,L
85365,10,SCO2,2010-12-11,Dunfermline Athletic,Queen of the South,1,0,1,W
85366,10,SCO2,2010-12-11,Greenock Morton,FC Dundee,0,1,-1,L
85367,10,SCO2,2010-12-11,Partick Thistle,Ross County,1,1,0,D
85368,10,SCO2,2010-12-14,FC Dundee,Cowdenbeath,3,0,3,W
85369,10,SCO2,2010-12-14,Dunfermline Athletic,Partick Thistle,0,0,0,D
85370,10,SCO2,2010-12-14,Ross County,Greenock Morton,2,2,0,D
85371,10,SCO2,2010-12-18,FC Dundee,Stirling Albion,2,0,2,W
85372,10,SCO2,2010-12-26,Partick Thistle,Raith Rovers,0,0,0,D
85373,10,SCO2,2010-12-29,Dunfermline Athletic,Cowdenbeath,5,0,5,W
85374,10,SCO2,2010-12-29,Falkirk,Raith Rovers,0,0,0,D
85375,10,SCO2,2011-01-02,FC Dundee,Ross County,2,0,2,W
85376,10,SCO2,2011-01-02,Falkirk,Stirling Albion,4,2,2,W
85377,10,SCO2,2011-01-02,Raith Rovers,Dunfermline Athletic,2,1,1,W
85378,10,SCO2,2011-01-15,Dunfermline Athletic,FC Dundee,0,0,0,D
85379,10,SCO2,2011-01-15,Falkirk,Queen of the South,0,3,-3,L
85380,10,SCO2,2011-01-15,Greenock Morton,Cowdenbeath,3,0,3,W
85381,10,SCO2,2011-01-15,Partick Thistle,Stirling Albion,6,1,5,W
85382,10,SCO2,2011-01-15,Ross County,Raith Rovers,0,1,-1,L
85383,10,SCO2,2011-01-22,FC Dundee,Falkirk,1,0,1,W
85384,10,SCO2,2011-01-22,Raith Rovers,Greenock Morton,2,2,0,D
85385,10,SCO2,2011-01-29,Greenock Morton,Ross County,2,1,1,W
85386,10,SCO2,2011-01-29,Partick Thistle,Dunfermline Athletic,2,0,2,W
85387,10,SCO2,2011-01-29,Raith Rovers,Falkirk,1,2,-1,L
85388,10,SCO2,2011-02-05,Queen of the South,FC Dundee,1,2,-1,L
85389,10,SCO2,2011-02-05,Ross County,Cowdenbeath,1,1,0,D
85390,10,SCO2,2011-02-05,Stirling Albion,Raith Rovers,1,3,-2,L
85391,10,SCO2,2011-02-12,Cowdenbeath,Dunfermline Athletic,0,4,-4,L
85392,10,SCO2,2011-02-12,FC Dundee,Raith Rovers,2,1,1,W
85393,10,SCO2,2011-02-12,Falkirk,Greenock Morton,1,0,1,W
85394,10,SCO2,2011-02-12,Queen of the South,Partick Thistle,3,3,0,D
85395,10,SCO2,2011-02-12,Ross County,Stirling Albion,0,0,0,D
85396,10,SCO2,2011-02-15,Cowdenbeath,Partick Thistle,1,1,0,D
85397,10,SCO2,2011-02-15,Dunfermline Athletic,Falkirk,1,1,0,D
85398,10,SCO2,2011-02-15,Stirling Albion,Greenock Morton,0,1,-1,L
85399,10,SCO2,2011-02-19,Cowdenbeath,Raith Rovers,0,3,-3,L
85400,10,SCO2,2011-02-19,Greenock Morton,Queen of the South,0,4,-4,L
85401,10,SCO2,2011-02-19,Stirling Albion,FC Dundee,0,1,-1,L
85402,10,SCO2,2011-02-22,Greenock Morton,Partick Thistle,1,0,1,W
85403,10,SCO2,2011-02-22,Queen of the South,Stirling Albion,2,2,0,D
85404,10,SCO2,2011-02-22,Raith Rovers,FC Dundee,1,2,-1,L
85405,10,SCO2,2011-02-22,Ross County,Dunfermline Athletic,0,0,0,D
85406,10,SCO2,2011-02-26,FC Dundee,Greenock Morton,1,1,0,D
85407,10,SCO2,2011-02-26,Falkirk,Cowdenbeath,2,0,2,W
85408,10,SCO2,2011-02-26,Queen of the South,Dunfermline Athletic,1,3,-2,L
85409,10,SCO2,2011-02-26,Raith Rovers,Stirling Albion,2,1,1,W
85410,10,SCO2,2011-02-26,Ross County,Partick Thistle,0,0,0,D
85411,10,SCO2,2011-03-01,Cowdenbeath,Queen of the South,2,2,0,D
85412,10,SCO2,2011-03-01,Greenock Morton,Falkirk,0,0,0,D
85413,10,SCO2,2011-03-01,Stirling Albion,Ross County,0,0,0,D
85414,10,SCO2,2011-03-05,Dunfermline Athletic,Greenock Morton,1,3,-2,L
85415,10,SCO2,2011-03-05,Partick Thistle,FC Dundee,0,0,0,D
85416,10,SCO2,2011-03-05,Queen of the South,Raith Rovers,0,2,-2,L
85417,10,SCO2,2011-03-05,Ross County,Falkirk,2,1,1,W
85418,10,SCO2,2011-03-05,Stirling Albion,Cowdenbeath,3,4,-1,L
85419,10,SCO2,2011-03-08,Cowdenbeath,FC Dundee,1,3,-2,L
85420,10,SCO2,2011-03-08,Dunfermline Athletic,Ross County,1,1,0,D
85421,10,SCO2,2011-03-08,Partick Thistle,Queen of the South,3,1,2,W
85422,10,SCO2,2011-03-12,FC Dundee,Queen of the South,2,1,1,W
85423,10,SCO2,2011-03-12,Falkirk,Dunfermline Athletic,1,2,-1,L
85424,10,SCO2,2011-03-12,Raith Rovers,Partick Thistle,0,2,-2,L
85425,10,SCO2,2011-03-15,Raith Rovers,Cowdenbeath,2,1,1,W
85426,10,SCO2,2011-03-15,Stirling Albion,Dunfermline Athletic,1,1,0,D
85427,10,SCO2,2011-03-16,Queen of the South,Greenock Morton,2,0,2,W
85428,10,SCO2,2011-03-19,Dunfermline Athletic,Stirling Albion,4,1,3,W
85429,10,SCO2,2011-03-19,Falkirk,FC Dundee,2,2,0,D
85430,10,SCO2,2011-03-19,Greenock Morton,Raith Rovers,0,0,0,D
85431,10,SCO2,2011-03-19,Partick Thistle,Cowdenbeath,0,1,-1,L
85432,10,SCO2,2011-03-19,Ross County,Queen of the South,1,2,-1,L
85433,10,SCO2,2011-03-22,Cowdenbeath,Greenock Morton,0,2,-2,L
85434,10,SCO2,2011-03-22,FC Dundee,Dunfermline Athletic,1,1,0,D
85435,10,SCO2,2011-03-22,Queen of the South,Falkirk,0,1,-1,L
85436,10,SCO2,2011-03-22,Raith Rovers,Ross County,1,1,0,D
85437,10,SCO2,2011-03-22,Stirling Albion,Partick Thistle,0,3,-3,L
85438,10,SCO2,2011-03-26,FC Dundee,Cowdenbeath,2,2,0,D
85439,10,SCO2,2011-03-26,Dunfermline Athletic,Partick Thistle,0,0,0,D
85440,10,SCO2,2011-03-26,Falkirk,Raith Rovers,2,1,1,W
85441,10,SCO2,2011-03-26,Queen of the South,Stirling Albion,4,1,3,W
85442,10,SCO2,2011-03-26,Ross County,Greenock Morton,2,0,2,W
85443,10,SCO2,2011-03-29,Cowdenbeath,Falkirk,0,0,0,D
85444,10,SCO2,2011-03-29,Ross County,Dunfermline Athletic,0,1,-1,L
85445,10,SCO2,2011-03-29,Stirling Albion,Queen of the South,0,2,-2,L
85446,10,SCO2,2011-04-02,Cowdenbeath,Dunfermline Athletic,0,1,-1,L
85447,10,SCO2,2011-04-02,Greenock Morton,Falkirk,2,2,0,D
85448,10,SCO2,2011-04-02,Partick Thistle,Queen of the South,0,0,0,D
85449,10,SCO2,2011-04-02,Raith Rovers,FC Dundee,2,1,1,W
85450,10,SCO2,2011-04-02,Stirling Albion,Ross County,0,2,-2,L
85451,10,SCO2,2011-04-05,Cowdenbeath,Ross County,2,1,1,W
85452,10,SCO2,2011-04-05,Greenock Morton,Stirling Albion,2,0,2,W
85453,10,SCO2,2011-04-09,Falkirk,Partick Thistle,2,3,-1,L
85454,10,SCO2,2011-04-09,Raith Rovers,Cowdenbeath,2,2,0,D
85455,10,SCO2,2011-04-10,FC Dundee,Stirling Albion,1,1,0,D
85456,10,SCO2,2011-04-12,Partick Thistle,Falkirk,1,2,-1,L
85457,10,SCO2,2011-04-13,Queen of the South,Greenock Morton,1,4,-3,L
85458,10,SCO2,2011-04-16,Cowdenbeath,Falkirk,1,2,-1,L
85459,10,SCO2,2011-04-16,Dunfermline Athletic,Queen of the South,6,1,5,W
85460,10,SCO2,2011-04-16,Greenock Morton,FC Dundee,1,3,-2,L
85461,10,SCO2,2011-04-16,Partick Thistle,Ross County,1,1,0,D
85462,10,SCO2,2011-04-16,Stirling Albion,Raith Rovers,1,2,-1,L
85463,10,SCO2,2011-04-19,Falkirk,Partick Thistle,2,0,2,W
85464,10,SCO2,2011-04-23,Dunfermline Athletic,Raith Rovers,2,1,1,W
85465,10,SCO2,2011-04-23,Partick Thistle,Greenock Morton,2,0,2,W
85466,10,SCO2,2011-04-23,Queen of the South,Cowdenbeath,2,2,0,D
85467,10,SCO2,2011-04-23,Ross County,FC Dundee,0,1,-1,L
85468,10,SCO2,2011-04-23,Stirling Albion,Falkirk,1,2,-1,L
85469,10,SCO2,2011-04-26,Queen of the South,Ross County,0,1,-1,L
85470,10,SCO2,2011-04-30,Cowdenbeath,Stirling Albion,1,0,1,W
85471,10,SCO2,2011-04-30,FC Dundee,Partick Thistle,3,2,1,W
85472,10,SCO2,2011-04-30,Falkirk,Ross County,0,1,-1,L
85473,10,SCO2,2011-04-30,Greenock Morton,Dunfermline Athletic,0,2,-2,L
85474,10,SCO2,2011-04-30,Raith Rovers,Queen of the South,0,1,-1,L
85475,10,SCO2,2011-05-07,Dunfermline Athletic,Falkirk,3,0,3,W
85476,10,SCO2,2011-05-07,Partick Thistle,Raith Rovers,3,0,3,W
85477,10,SCO2,2011-05-07,Queen of the South,FC Dundee,3,0,3,W
85478,10,SCO2,2011-05-07,Ross County,Cowdenbeath,3,0,3,W
85479,10,SCO2,2011-05-07,Stirling Albion,Greenock Morton,3,2,1,W
85480,11,SCO2,2011-08-06,Ayr United,Hamilton Academical,1,2,-1,L
85481,11,SCO2,2011-08-06,Livingston,Queen of the South,2,2,0,D
85482,11,SCO2,2011-08-06,Partick Thistle,FC Dundee,0,1,-1,L
85483,11,SCO2,2011-08-06,Raith Rovers,Falkirk,1,0,1,W
85484,11,SCO2,2011-08-06,Ross County,Greenock Morton,0,0,0,D
85485,11,SCO2,2011-08-13,FC Dundee,Ayr United,1,1,0,D
85486,11,SCO2,2011-08-13,Falkirk,Partick Thistle,2,1,1,W
85487,11,SCO2,2011-08-13,Hamilton Academical,Ross County,5,1,4,W
85488,11,SCO2,2011-08-13,Greenock Morton,Livingston,2,1,1,W
85489,11,SCO2,2011-08-13,Queen of the South,Raith Rovers,1,3,-2,L
85490,11,SCO2,2011-08-20,Ayr United,Falkirk,2,2,0,D
85491,11,SCO2,2011-08-20,Livingston,FC Dundee,4,2,2,W
85492,11,SCO2,2011-08-20,Partick Thistle,Hamilton Academical,1,1,0,D
85493,11,SCO2,2011-08-20,Raith Rovers,Greenock Morton,1,1,0,D
85494,11,SCO2,2011-08-20,Ross County,Queen of the South,2,0,2,W
85495,11,SCO2,2011-08-27,Ayr United,Raith Rovers,2,1,1,W
85496,11,SCO2,2011-08-27,FC Dundee,Greenock Morton,0,1,-1,L
85497,11,SCO2,2011-08-27,Falkirk,Ross County,1,1,0,D
85498,11,SCO2,2011-08-27,Hamilton Academical,Livingston,1,1,0,D
85499,11,SCO2,2011-08-27,Partick Thistle,Queen of the South,2,1,1,W
85500,11,SCO2,2011-09-10,Livingston,Falkirk,1,1,0,D
85501,11,SCO2,2011-09-10,Greenock Morton,Ayr United,4,1,3,W
85502,11,SCO2,2011-09-10,Queen of the South,Hamilton Academical,1,0,1,W
85503,11,SCO2,2011-09-10,Raith Rovers,FC Dundee,0,1,-1,L
85504,11,SCO2,2011-09-10,Ross County,Partick Thistle,2,2,0,D
85505,11,SCO2,2011-09-17,Falkirk,FC Dundee,2,1,1,W
85506,11,SCO2,2011-09-17,Hamilton Academical,Raith Rovers,2,2,0,D
85507,11,SCO2,2011-09-17,Partick Thistle,Ayr United,4,0,4,W
85508,11,SCO2,2011-09-17,Queen of the South,Greenock Morton,4,1,3,W
85509,11,SCO2,2011-09-17,Ross County,Livingston,1,1,0,D
85510,11,SCO2,2011-09-24,Ayr United,Queen of the South,1,0,1,W
85511,11,SCO2,2011-09-24,FC Dundee,Hamilton Academical,0,1,-1,L
85512,11,SCO2,2011-09-24,Livingston,Partick Thistle,2,1,1,W
85513,11,SCO2,2011-09-24,Greenock Morton,Falkirk,3,2,1,W
85514,11,SCO2,2011-09-24,Raith Rovers,Ross County,0,1,-1,L
85515,11,SCO2,2011-09-30,Partick Thistle,Greenock Morton,5,0,5,W
85516,11,SCO2,2011-10-01,Hamilton Academical,Falkirk,0,1,-1,L
85517,11,SCO2,2011-10-01,Livingston,Raith Rovers,1,1,0,D
85518,11,SCO2,2011-10-01,Queen of the South,FC Dundee,0,0,0,D
85519,11,SCO2,2011-10-01,Ross County,Ayr United,4,0,4,W
85520,11,SCO2,2011-10-15,Ayr United,Livingston,0,0,0,D
85521,11,SCO2,2011-10-15,FC Dundee,Ross County,1,2,-1,L
85522,11,SCO2,2011-10-15,Falkirk,Queen of the South,1,0,1,W
85523,11,SCO2,2011-10-15,Greenock Morton,Hamilton Academical,0,2,-2,L
85524,11,SCO2,2011-10-15,Raith Rovers,Partick Thistle,2,0,2,W
85525,11,SCO2,2011-10-22,Ayr United,FC Dundee,1,3,-2,L
85526,11,SCO2,2011-10-22,Livingston,Greenock Morton,1,1,0,D
85527,11,SCO2,2011-10-22,Partick Thistle,Falkirk,2,2,0,D
85528,11,SCO2,2011-10-22,Raith Rovers,Queen of the South,0,2,-2,L
85529,11,SCO2,2011-10-22,Ross County,Hamilton Academical,1,0,1,W
85530,11,SCO2,2011-10-29,FC Dundee,Partick Thistle,0,1,-1,L
85531,11,SCO2,2011-10-29,Falkirk,Raith Rovers,2,0,2,W
85532,11,SCO2,2011-10-29,Hamilton Academical,Ayr United,2,3,-1,L
85533,11,SCO2,2011-10-29,Greenock Morton,Ross County,0,2,-2,L
85534,11,SCO2,2011-10-29,Queen of the South,Livingston,0,2,-2,L
85535,11,SCO2,2011-11-05,Ayr United,Greenock Morton,0,1,-1,L
85536,11,SCO2,2011-11-05,FC Dundee,Raith Rovers,1,0,1,W
85537,11,SCO2,2011-11-05,Falkirk,Livingston,4,3,1,W
85538,11,SCO2,2011-11-05,Hamilton Academical,Queen of the South,3,1,2,W
85539,11,SCO2,2011-11-05,Partick Thistle,Ross County,0,1,-1,L
85540,11,SCO2,2011-11-12,Livingston,Hamilton Academical,1,0,1,W
85541,11,SCO2,2011-11-12,Greenock Morton,FC Dundee,1,2,-1,L
85542,11,SCO2,2011-11-12,Queen of the South,Partick Thistle,0,0,0,D
85543,11,SCO2,2011-11-12,Raith Rovers,Ayr United,0,1,-1,L
85544,11,SCO2,2011-11-12,Ross County,Falkirk,3,1,2,W
85545,11,SCO2,2011-11-26,FC Dundee,Falkirk,4,2,2,W
85546,11,SCO2,2011-11-26,Livingston,Ross County,0,3,-3,L
85547,11,SCO2,2011-11-26,Greenock Morton,Queen of the South,2,2,0,D
85548,11,SCO2,2011-11-26,Raith Rovers,Hamilton Academical,3,2,1,W
85549,11,SCO2,2011-11-30,Ayr United,Partick Thistle,0,0,0,D
85550,11,SCO2,2011-12-03,Falkirk,Greenock Morton,1,0,1,W
85551,11,SCO2,2011-12-03,Hamilton Academical,FC Dundee,1,6,-5,L
85552,11,SCO2,2011-12-03,Partick Thistle,Livingston,2,1,1,W
85553,11,SCO2,2011-12-03,Queen of the South,Ayr United,4,1,3,W
85554,11,SCO2,2011-12-03,Ross County,Raith Rovers,4,2,2,W
85555,11,SCO2,2011-12-10,FC Dundee,Queen of the South,2,1,1,W
85556,11,SCO2,2011-12-10,Falkirk,Hamilton Academical,0,0,0,D
85557,11,SCO2,2011-12-10,Greenock Morton,Partick Thistle,1,2,-1,L
85558,11,SCO2,2011-12-10,Raith Rovers,Livingston,0,1,-1,L
85559,11,SCO2,2011-12-17,Partick Thistle,Raith Rovers,0,1,-1,L
85560,11,SCO2,2011-12-17,Queen of the South,Falkirk,1,5,-4,L
85561,11,SCO2,2011-12-17,Ross County,FC Dundee,1,1,0,D
85562,11,SCO2,2011-12-26,Ayr United,Raith Rovers,1,1,0,D
85563,11,SCO2,2011-12-26,FC Dundee,Greenock Morton,0,1,-1,L
85564,11,SCO2,2011-12-26,Falkirk,Ross County,1,1,0,D
85565,11,SCO2,2011-12-26,Hamilton Academical,Livingston,0,1,-1,L
85566,11,SCO2,2011-12-26,Partick Thistle,Queen of the South,1,0,1,W
85567,11,SCO2,2012-01-02,Livingston,Falkirk,1,2,-1,L
85568,11,SCO2,2012-01-02,Greenock Morton,Ayr United,3,1,2,W
85569,11,SCO2,2012-01-02,Queen of the South,Hamilton Academical,1,2,-1,L
85570,11,SCO2,2012-01-02,Raith Rovers,FC Dundee,0,1,-1,L
85571,11,SCO2,2012-01-13,Hamilton Academical,Partick Thistle,1,0,1,W
85572,11,SCO2,2012-01-14,FC Dundee,Livingston,3,0,3,W
85573,11,SCO2,2012-01-14,Falkirk,Ayr United,0,0,0,D
85574,11,SCO2,2012-01-14,Greenock Morton,Raith Rovers,1,1,0,D
85575,11,SCO2,2012-01-14,Queen of the South,Ross County,0,0,0,D
85576,11,SCO2,2012-01-21,Ayr United,Hamilton Academical,2,2,0,D
85577,11,SCO2,2012-01-21,Livingston,Queen of the South,2,2,0,D
85578,11,SCO2,2012-01-21,Partick Thistle,FC Dundee,0,0,0,D
85579,11,SCO2,2012-01-21,Raith Rovers,Falkirk,2,2,0,D
85580,11,SCO2,2012-01-28,Queen of the South,Greenock Morton,2,1,1,W
85581,11,SCO2,2012-01-28,Ross County,Livingston,3,0,3,W
85582,11,SCO2,2012-02-11,Ayr United,Queen of the South,1,1,0,D
85583,11,SCO2,2012-02-11,FC Dundee,Hamilton Academical,2,2,0,D
85584,11,SCO2,2012-02-11,Livingston,Partick Thistle,3,1,2,W
85585,11,SCO2,2012-02-11,Greenock Morton,Falkirk,0,0,0,D
85586,11,SCO2,2012-02-11,Raith Rovers,Ross County,1,1,0,D
85587,11,SCO2,2012-02-14,Hamilton Academical,Greenock Morton,1,2,-1,L
85588,11,SCO2,2012-02-18,Hamilton Academical,Falkirk,0,1,-1,L
85589,11,SCO2,2012-02-18,Livingston,Raith Rovers,4,0,4,W
85590,11,SCO2,2012-02-18,Partick Thistle,Greenock Morton,0,0,0,D
85591,11,SCO2,2012-02-18,Queen of the South,FC Dundee,1,1,0,D
85592,11,SCO2,2012-02-18,Ross County,Ayr United,1,1,0,D
85593,11,SCO2,2012-02-21,Falkirk,FC Dundee,1,1,0,D
85594,11,SCO2,2012-02-21,Hamilton Academical,Raith Rovers,2,1,1,W
85595,11,SCO2,2012-02-21,Partick Thistle,Ayr United,4,2,2,W
85596,11,SCO2,2012-02-25,Ayr United,Livingston,3,1,2,W
85597,11,SCO2,2012-02-25,FC Dundee,Ross County,1,1,0,D
85598,11,SCO2,2012-02-25,Falkirk,Queen of the South,3,0,3,W
85599,11,SCO2,2012-02-25,Greenock Morton,Hamilton Academical,1,2,-1,L
85600,11,SCO2,2012-02-25,Raith Rovers,Partick Thistle,2,1,1,W
85601,11,SCO2,2012-02-29,Ayr United,Ross County,2,3,-1,L
85602,11,SCO2,2012-03-03,Ayr United,Falkirk,1,0,1,W
85603,11,SCO2,2012-03-03,Livingston,FC Dundee,2,3,-1,L
85604,11,SCO2,2012-03-03,Partick Thistle,Hamilton Academical,2,0,2,W
85605,11,SCO2,2012-03-03,Raith Rovers,Greenock Morton,5,0,5,W
85606,11,SCO2,2012-03-03,Ross County,Queen of the South,2,1,1,W
85607,11,SCO2,2012-03-06,Livingston,Ayr United,1,2,-1,L
85608,11,SCO2,2012-03-06,Ross County,Partick Thistle,3,0,3,W
85609,11,SCO2,2012-03-10,Falkirk,Partick Thistle,1,1,0,D
85610,11,SCO2,2012-03-10,Hamilton Academical,Ross County,0,2,-2,L
85611,11,SCO2,2012-03-10,Greenock Morton,Livingston,1,3,-2,L
85612,11,SCO2,2012-03-10,Queen of the South,Raith Rovers,1,0,1,W
85613,11,SCO2,2012-03-13,Ross County,Greenock Morton,2,2,0,D
85614,11,SCO2,2012-03-17,Livingston,Hamilton Academical,0,4,-4,L
85615,11,SCO2,2012-03-17,Greenock Morton,FC Dundee,0,2,-2,L
85616,11,SCO2,2012-03-17,Queen of the South,Partick Thistle,0,5,-5,L
85617,11,SCO2,2012-03-17,Raith Rovers,Ayr United,2,2,0,D
85618,11,SCO2,2012-03-17,Ross County,Falkirk,2,1,1,W
85619,11,SCO2,2012-03-20,Falkirk,Greenock Morton,0,2,-2,L
85620,11,SCO2,2012-03-20,Hamilton Academical,FC Dundee,3,1,2,W
85621,11,SCO2,2012-03-24,Ayr United,Greenock Morton,0,0,0,D
85622,11,SCO2,2012-03-24,FC Dundee,Raith Rovers,1,1,0,D
85623,11,SCO2,2012-03-24,Falkirk,Livingston,2,5,-3,L
85624,11,SCO2,2012-03-24,Hamilton Academical,Queen of the South,3,0,3,W
85625,11,SCO2,2012-03-24,Partick Thistle,Ross County,0,1,-1,L
85626,11,SCO2,2012-03-27,FC Dundee,Ayr United,4,1,3,W
85627,11,SCO2,2012-03-31,Partick Thistle,Livingston,2,3,-1,L
85628,11,SCO2,2012-03-31,Queen of the South,Ayr United,2,1,1,W
85629,11,SCO2,2012-03-31,Ross County,Raith Rovers,1,1,0,D
85630,11,SCO2,2012-04-07,Ayr United,Partick Thistle,1,3,-2,L
85631,11,SCO2,2012-04-07,FC Dundee,Falkirk,3,1,2,W
85632,11,SCO2,2012-04-07,Livingston,Ross County,1,3,-2,L
85633,11,SCO2,2012-04-07,Greenock Morton,Queen of the South,2,2,0,D
85634,11,SCO2,2012-04-07,Raith Rovers,Hamilton Academical,2,1,1,W
85635,11,SCO2,2012-04-10,FC Dundee,Queen of the South,1,1,0,D
85636,11,SCO2,2012-04-10,Falkirk,Hamilton Academical,3,0,3,W
85637,11,SCO2,2012-04-10,Greenock Morton,Partick Thistle,1,0,1,W
85638,11,SCO2,2012-04-10,Raith Rovers,Livingston,0,3,-3,L
85639,11,SCO2,2012-04-11,Ayr United,Ross County,1,3,-2,L
85640,11,SCO2,2012-04-14,Hamilton Academical,Greenock Morton,4,3,1,W
85641,11,SCO2,2012-04-14,Livingston,Ayr United,0,1,-1,L
85642,11,SCO2,2012-04-14,Partick Thistle,Raith Rovers,1,1,0,D
85643,11,SCO2,2012-04-14,Queen of the South,Falkirk,0,0,0,D
85644,11,SCO2,2012-04-14,Ross County,FC Dundee,3,0,3,W
85645,11,SCO2,2012-04-21,FC Dundee,Partick Thistle,0,3,-3,L
85646,11,SCO2,2012-04-21,Falkirk,Raith Rovers,2,3,-1,L
85647,11,SCO2,2012-04-21,Hamilton Academical,Ayr United,3,2,1,W
85648,11,SCO2,2012-04-21,Greenock Morton,Ross County,1,1,0,D
85649,11,SCO2,2012-04-21,Queen of the South,Livingston,0,4,-4,L
85650,11,SCO2,2012-04-28,Ayr United,FC Dundee,3,2,1,W
85651,11,SCO2,2012-04-28,Livingston,Greenock Morton,0,0,0,D
85652,11,SCO2,2012-04-28,Partick Thistle,Falkirk,1,1,0,D
85653,11,SCO2,2012-04-28,Raith Rovers,Queen of the South,3,1,2,W
85654,11,SCO2,2012-04-28,Ross County,Hamilton Academical,5,1,4,W
85655,11,SCO2,2012-05-05,FC Dundee,Livingston,1,0,1,W
85656,11,SCO2,2012-05-05,Falkirk,Ayr United,3,2,1,W
85657,11,SCO2,2012-05-05,Hamilton Academical,Partick Thistle,2,2,0,D
85658,11,SCO2,2012-05-05,Greenock Morton,Raith Rovers,1,3,-2,L
85659,11,SCO2,2012-05-05,Queen of the South,Ross County,3,5,-2,L
85660,12,SCO2,2012-08-11,Airdrie United,Dumbarton,4,1,3,W
85661,12,SCO2,2012-08-11,Cowdenbeath,Dunfermline Athletic,0,4,-4,L
85662,12,SCO2,2012-08-11,Greenock Morton,Livingston,2,2,0,D
85663,12,SCO2,2012-08-11,Partick Thistle,Falkirk,3,1,2,W
85664,12,SCO2,2012-08-11,Raith Rovers,Hamilton Academical,2,0,2,W
85665,12,SCO2,2012-08-18,Dumbarton,Cowdenbeath,0,3,-3,L
85666,12,SCO2,2012-08-18,Dunfermline Athletic,Partick Thistle,0,1,-1,L
85667,12,SCO2,2012-08-18,Falkirk,Raith Rovers,0,2,-2,L
85668,12,SCO2,2012-08-18,Hamilton Academical,Greenock Morton,1,1,0,D
85669,12,SCO2,2012-08-18,Livingston,Airdrie United,0,2,-2,L
85670,12,SCO2,2012-08-25,Airdrie United,Dunfermline Athletic,1,2,-1,L
85671,12,SCO2,2012-08-25,Cowdenbeath,Hamilton Academical,1,0,1,W
85672,12,SCO2,2012-08-25,Greenock Morton,Falkirk,1,2,-1,L
85673,12,SCO2,2012-08-25,Partick Thistle,Dumbarton,3,0,3,W
85674,12,SCO2,2012-08-25,Raith Rovers,Livingston,0,0,0,D
85675,12,SCO2,2012-09-01,Airdrie United,Cowdenbeath,0,3,-3,L
85676,12,SCO2,2012-09-01,Dunfermline Athletic,Raith Rovers,3,1,2,W
85677,12,SCO2,2012-09-01,Greenock Morton,Dumbarton,3,0,3,W
85678,12,SCO2,2012-09-01,Partick Thistle,Hamilton Academical,4,0,4,W
85679,12,SCO2,2012-09-02,Falkirk,Livingston,1,2,-1,L
85680,12,SCO2,2012-09-15,Cowdenbeath,Greenock Morton,3,4,-1,L
85681,12,SCO2,2012-09-15,Dumbarton,Dunfermline Athletic,0,2,-2,L
85682,12,SCO2,2012-09-15,Hamilton Academical,Falkirk,1,1,0,D
85683,12,SCO2,2012-09-15,Livingston,Partick Thistle,1,2,-1,L
85684,12,SCO2,2012-09-15,Raith Rovers,Airdrie United,2,0,2,W
85685,12,SCO2,2012-09-22,Dumbarton,Hamilton Academical,3,3,0,D
85686,12,SCO2,2012-09-22,Dunfermline Athletic,Livingston,4,0,4,W
85687,12,SCO2,2012-09-22,Falkirk,Airdrie United,1,1,0,D
85688,12,SCO2,2012-09-22,Greenock Morton,Raith Rovers,1,0,1,W
85689,12,SCO2,2012-09-22,Partick Thistle,Cowdenbeath,2,1,1,W
85690,12,SCO2,2012-09-29,Airdrie United,Greenock Morton,2,3,-1,L
85691,12,SCO2,2012-09-29,Cowdenbeath,Falkirk,1,1,0,D
85692,12,SCO2,2012-09-29,Hamilton Academical,Dunfermline Athletic,0,3,-3,L
85693,12,SCO2,2012-09-29,Livingston,Dumbarton,5,0,5,W
85694,12,SCO2,2012-09-29,Raith Rovers,Partick Thistle,1,1,0,D
85695,12,SCO2,2012-10-06,Airdrie United,Hamilton Academical,0,4,-4,L
85696,12,SCO2,2012-10-06,Falkirk,Dunfermline Athletic,2,2,0,D
85697,12,SCO2,2012-10-06,Livingston,Cowdenbeath,1,1,0,D
85698,12,SCO2,2012-10-06,Greenock Morton,Partick Thistle,3,1,2,W
85699,12,SCO2,2012-10-06,Raith Rovers,Dumbarton,2,2,0,D
85700,12,SCO2,2012-10-20,Cowdenbeath,Raith Rovers,4,4,0,D
85701,12,SCO2,2012-10-20,Dumbarton,Falkirk,0,2,-2,L
85702,12,SCO2,2012-10-20,Dunfermline Athletic,Greenock Morton,2,2,0,D
85703,12,SCO2,2012-10-20,Hamilton Academical,Livingston,1,2,-1,L
85704,12,SCO2,2012-10-20,Partick Thistle,Airdrie United,7,0,7,W
85705,12,SCO2,2012-10-27,Dumbarton,Airdrie United,3,4,-1,L
85706,12,SCO2,2012-10-27,Dunfermline Athletic,Cowdenbeath,3,0,3,W
85707,12,SCO2,2012-10-27,Falkirk,Partick Thistle,0,0,0,D
85708,12,SCO2,2012-10-27,Hamilton Academical,Raith Rovers,0,1,-1,L
85709,12,SCO2,2012-10-27,Livingston,Greenock Morton,2,2,0,D
85710,12,SCO2,2012-11-09,Airdrie United,Livingston,1,3,-2,L
85711,12,SCO2,2012-11-10,Cowdenbeath,Dumbarton,0,1,-1,L
85712,12,SCO2,2012-11-10,Greenock Morton,Hamilton Academical,0,1,-1,L
85713,12,SCO2,2012-11-10,Partick Thistle,Dunfermline Athletic,5,1,4,W
85714,12,SCO2,2012-11-10,Raith Rovers,Falkirk,2,1,1,W
85715,12,SCO2,2012-11-16,Hamilton Academical,Partick Thistle,1,0,1,W
85716,12,SCO2,2012-11-17,Cowdenbeath,Airdrie United,1,1,0,D
85717,12,SCO2,2012-11-17,Dumbarton,Greenock Morton,1,5,-4,L
85718,12,SCO2,2012-11-17,Livingston,Falkirk,2,1,1,W
85719,12,SCO2,2012-11-17,Raith Rovers,Dunfermline Athletic,1,3,-2,L
85720,12,SCO2,2012-11-24,Airdrie United,Raith Rovers,0,0,0,D
85721,12,SCO2,2012-11-24,Dunfermline Athletic,Dumbarton,4,0,4,W
85722,12,SCO2,2012-11-24,Falkirk,Hamilton Academical,2,1,1,W
85723,12,SCO2,2012-11-24,Greenock Morton,Cowdenbeath,1,0,1,W
85724,12,SCO2,2012-11-24,Partick Thistle,Livingston,2,0,2,W
85725,12,SCO2,2012-12-08,Livingston,Dunfermline Athletic,2,1,1,W
85726,12,SCO2,2012-12-08,Raith Rovers,Greenock Morton,3,3,0,D
85727,12,SCO2,2012-12-15,Dunfermline Athletic,Hamilton Academical,1,1,0,D
85728,12,SCO2,2012-12-15,Falkirk,Cowdenbeath,2,0,2,W
85729,12,SCO2,2012-12-15,Greenock Morton,Airdrie United,2,0,2,W
85730,12,SCO2,2012-12-15,Partick Thistle,Raith Rovers,3,2,1,W
85731,12,SCO2,2012-12-22,Airdrie United,Falkirk,1,4,-3,L
85732,12,SCO2,2012-12-22,Cowdenbeath,Livingston,1,1,0,D
85733,12,SCO2,2012-12-26,Dunfermline Athletic,Falkirk,0,1,-1,L
85734,12,SCO2,2012-12-26,Hamilton Academical,Airdrie United,3,0,3,W
85735,12,SCO2,2012-12-26,Partick Thistle,Greenock Morton,1,2,-1,L
85736,12,SCO2,2012-12-29,Airdrie United,Partick Thistle,1,1,0,D
85737,12,SCO2,2012-12-29,Falkirk,Dumbarton,3,4,-1,L
85738,12,SCO2,2012-12-29,Greenock Morton,Dunfermline Athletic,4,2,2,W
85739,12,SCO2,2012-12-29,Raith Rovers,Cowdenbeath,2,2,0,D
85740,12,SCO2,2013-01-02,Airdrie United,Cowdenbeath,1,1,0,D
85741,12,SCO2,2013-01-02,Dunfermline Athletic,Raith Rovers,1,0,1,W
85742,12,SCO2,2013-01-02,Greenock Morton,Dumbarton,0,3,-3,L
85743,12,SCO2,2013-01-05,Cowdenbeath,Greenock Morton,1,1,0,D
85744,12,SCO2,2013-01-05,Dumbarton,Dunfermline Athletic,0,1,-1,L
85745,12,SCO2,2013-01-05,Hamilton Academical,Falkirk,1,1,0,D
85746,12,SCO2,2013-01-05,Livingston,Partick Thistle,2,2,0,D
85747,12,SCO2,2013-01-05,Raith Rovers,Airdrie United,2,0,2,W
85748,12,SCO2,2013-01-12,Dumbarton,Partick Thistle,2,0,2,W
85749,12,SCO2,2013-01-12,Dunfermline Athletic,Airdrie United,1,3,-2,L
85750,12,SCO2,2013-01-12,Falkirk,Greenock Morton,0,1,-1,L
85751,12,SCO2,2013-01-12,Hamilton Academical,Cowdenbeath,2,1,1,W
85752,12,SCO2,2013-01-12,Livingston,Raith Rovers,2,1,1,W
85753,12,SCO2,2013-01-19,Airdrie United,Dumbarton,1,2,-1,L
85754,12,SCO2,2013-01-19,Greenock Morton,Livingston,2,1,1,W
85755,12,SCO2,2013-01-19,Partick Thistle,Falkirk,4,1,3,W
85756,12,SCO2,2013-01-19,Raith Rovers,Hamilton Academical,0,2,-2,L
85757,12,SCO2,2013-01-26,Dumbarton,Hamilton Academical,3,1,2,W
85758,12,SCO2,2013-01-26,Dunfermline Athletic,Livingston,0,1,-1,L
85759,12,SCO2,2013-01-26,Falkirk,Airdrie United,4,3,1,W
85760,12,SCO2,2013-01-26,Greenock Morton,Raith Rovers,1,0,1,W
85761,12,SCO2,2013-01-26,Partick Thistle,Cowdenbeath,2,1,1,W
85762,12,SCO2,2013-02-02,Dumbarton,Livingston,3,4,-1,L
85763,12,SCO2,2013-02-09,Airdrie United,Greenock Morton,0,4,-4,L
85764,12,SCO2,2013-02-09,Cowdenbeath,Falkirk,4,1,3,W
85765,12,SCO2,2013-02-09,Hamilton Academical,Dunfermline Athletic,1,2,-1,L
85766,12,SCO2,2013-02-09,Livingston,Dumbarton,2,3,-1,L
85767,12,SCO2,2013-02-12,Cowdenbeath,Dunfermline Athletic,4,2,2,W
85768,12,SCO2,2013-02-16,Airdrie United,Hamilton Academical,2,2,0,D
85769,12,SCO2,2013-02-16,Falkirk,Dunfermline Athletic,1,0,1,W
85770,12,SCO2,2013-02-16,Livingston,Cowdenbeath,3,0,3,W
85771,12,SCO2,2013-02-16,Greenock Morton,Partick Thistle,2,2,0,D
85772,12,SCO2,2013-02-16,Raith Rovers,Dumbarton,3,2,1,W
85773,12,SCO2,2013-02-19,Falkirk,Livingston,2,0,2,W
85774,12,SCO2,2013-02-19,Partick Thistle,Hamilton Academical,1,0,1,W
85775,12,SCO2,2013-02-23,Cowdenbeath,Raith Rovers,1,1,0,D
85776,12,SCO2,2013-02-23,Dumbarton,Falkirk,0,2,-2,L
85777,12,SCO2,2013-02-23,Dunfermline Athletic,Greenock Morton,1,4,-3,L
85778,12,SCO2,2013-02-23,Hamilton Academical,Livingston,1,1,0,D
85779,12,SCO2,2013-02-23,Partick Thistle,Airdrie United,1,0,1,W
85780,12,SCO2,2013-03-02,Dumbarton,Cowdenbeath,2,2,0,D
85781,12,SCO2,2013-03-02,Dunfermline Athletic,Partick Thistle,0,4,-4,L
85782,12,SCO2,2013-03-02,Livingston,Airdrie United,4,1,3,W
85783,12,SCO2,2013-03-05,Falkirk,Raith Rovers,1,1,0,D
85784,12,SCO2,2013-03-05,Hamilton Academical,Greenock Morton,2,1,1,W
85785,12,SCO2,2013-03-09,Airdrie United,Dunfermline Athletic,3,3,0,D
85786,12,SCO2,2013-03-09,Cowdenbeath,Hamilton Academical,1,1,0,D
85787,12,SCO2,2013-03-09,Greenock Morton,Falkirk,2,0,2,W
85788,12,SCO2,2013-03-09,Partick Thistle,Dumbarton,3,0,3,W
85789,12,SCO2,2013-03-09,Raith Rovers,Livingston,0,2,-2,L
85790,12,SCO2,2013-03-16,Cowdenbeath,Airdrie United,3,2,1,W
85791,12,SCO2,2013-03-16,Dumbarton,Greenock Morton,0,3,-3,L
85792,12,SCO2,2013-03-16,Hamilton Academical,Partick Thistle,0,2,-2,L
85793,12,SCO2,2013-03-16,Raith Rovers,Dunfermline Athletic,1,1,0,D
85794,12,SCO2,2013-03-23,Airdrie United,Raith Rovers,1,2,-1,L
85795,12,SCO2,2013-03-23,Dunfermline Athletic,Dumbarton,3,4,-1,L
85796,12,SCO2,2013-03-23,Falkirk,Hamilton Academical,0,2,-2,L
85797,12,SCO2,2013-03-23,Greenock Morton,Cowdenbeath,4,2,2,W
85798,12,SCO2,2013-03-23,Partick Thistle,Livingston,6,1,5,W
85799,12,SCO2,2013-03-27,Cowdenbeath,Partick Thistle,0,3,-3,L
85800,12,SCO2,2013-03-27,Dumbarton,Raith Rovers,4,2,2,W
85801,12,SCO2,2013-03-27,Dunfermline Athletic,Falkirk,0,2,-2,L
85802,12,SCO2,2013-03-30,Airdrie United,Falkirk,0,1,-1,L
85803,12,SCO2,2013-03-30,Cowdenbeath,Partick Thistle,1,2,-1,L
85804,12,SCO2,2013-03-30,Hamilton Academical,Dumbarton,2,3,-1,L
85805,12,SCO2,2013-03-30,Livingston,Dunfermline Athletic,2,2,0,D
85806,12,SCO2,2013-03-30,Raith Rovers,Greenock Morton,2,1,1,W
85807,12,SCO2,2013-04-02,Hamilton Academical,Dumbarton,2,1,1,W
85808,12,SCO2,2013-04-02,Livingston,Falkirk,1,2,-1,L
85809,12,SCO2,2013-04-02,Raith Rovers,Partick Thistle,0,0,0,D
85810,12,SCO2,2013-04-06,Dumbarton,Livingston,0,3,-3,L
85811,12,SCO2,2013-04-06,Dunfermline Athletic,Hamilton Academical,2,3,-1,L
85812,12,SCO2,2013-04-06,Falkirk,Cowdenbeath,4,0,4,W
85813,12,SCO2,2013-04-06,Greenock Morton,Airdrie United,5,2,3,W
85814,12,SCO2,2013-04-09,Cowdenbeath,Livingston,2,2,0,D
85815,12,SCO2,2013-04-09,Dumbarton,Raith Rovers,1,2,-1,L
85816,12,SCO2,2013-04-09,Hamilton Academical,Airdrie United,5,0,5,W
85817,12,SCO2,2013-04-10,Partick Thistle,Greenock Morton,1,0,1,W
85818,12,SCO2,2013-04-13,Airdrie United,Partick Thistle,1,2,-1,L
85819,12,SCO2,2013-04-13,Livingston,Hamilton Academical,0,3,-3,L
85820,12,SCO2,2013-04-13,Greenock Morton,Dunfermline Athletic,0,1,-1,L
85821,12,SCO2,2013-04-13,Raith Rovers,Cowdenbeath,0,1,-1,L
85822,12,SCO2,2013-04-16,Falkirk,Dumbarton,1,3,-2,L
85823,12,SCO2,2013-04-16,Livingston,Hamilton Academical,0,0,0,D
85824,12,SCO2,2013-04-16,Partick Thistle,Raith Rovers,0,0,0,D
85825,12,SCO2,2013-04-20,Dumbarton,Airdrie United,4,1,3,W
85826,12,SCO2,2013-04-20,Dunfermline Athletic,Cowdenbeath,1,0,1,W
85827,12,SCO2,2013-04-20,Falkirk,Partick Thistle,0,2,-2,L
85828,12,SCO2,2013-04-20,Hamilton Academical,Raith Rovers,2,0,2,W
85829,12,SCO2,2013-04-20,Livingston,Greenock Morton,0,2,-2,L
85830,12,SCO2,2013-04-27,Airdrie United,Livingston,0,2,-2,L
85831,12,SCO2,2013-04-27,Cowdenbeath,Dumbarton,2,3,-1,L
85832,12,SCO2,2013-04-27,Greenock Morton,Hamilton Academical,0,2,-2,L
85833,12,SCO2,2013-04-27,Partick Thistle,Dunfermline Athletic,3,3,0,D
85834,12,SCO2,2013-04-27,Raith Rovers,Falkirk,0,0,0,D
85835,12,SCO2,2013-05-04,Dumbarton,Partick Thistle,0,0,0,D
85836,12,SCO2,2013-05-04,Dunfermline Athletic,Airdrie United,1,2,-1,L
85837,12,SCO2,2013-05-04,Falkirk,Greenock Morton,4,1,3,W
85838,12,SCO2,2013-05-04,Hamilton Academical,Cowdenbeath,1,3,-2,L
85839,12,SCO2,2013-05-04,Livingston,Raith Rovers,2,3,-1,L
85840,13,SCO2,2013-08-10,Alloa Athletic,Livingston,1,0,1,W
85841,13,SCO2,2013-08-10,Dumbarton,Falkirk,1,1,0,D
85842,13,SCO2,2013-08-10,Greenock Morton,Cowdenbeath,2,0,2,W
85843,13,SCO2,2013-08-10,Queen of the South,FC Dundee,4,3,1,W
85844,13,SCO2,2013-08-10,Raith Rovers,Hamilton Academical,0,1,-1,L
85845,13,SCO2,2013-08-17,Cowdenbeath,Raith Rovers,3,4,-1,L
85846,13,SCO2,2013-08-17,FC Dundee,Alloa Athletic,1,0,1,W
85847,13,SCO2,2013-08-17,Falkirk,Greenock Morton,3,1,2,W
85848,13,SCO2,2013-08-17,Hamilton Academical,Dumbarton,4,1,3,W
85849,13,SCO2,2013-08-17,Livingston,Queen of the South,3,3,0,D
85850,13,SCO2,2013-08-24,Alloa Athletic,Cowdenbeath,3,1,2,W
85851,13,SCO2,2013-08-24,Dumbarton,Greenock Morton,3,1,2,W
85852,13,SCO2,2013-08-24,Hamilton Academical,Queen of the South,2,0,2,W
85853,13,SCO2,2013-08-24,Livingston,Falkirk,0,3,-3,L
85854,13,SCO2,2013-08-24,Raith Rovers,FC Dundee,0,0,0,D
85855,13,SCO2,2013-08-30,FC Dundee,Livingston,3,0,3,W
85856,13,SCO2,2013-08-31,Cowdenbeath,Dumbarton,3,2,1,W
85857,13,SCO2,2013-08-31,Falkirk,Hamilton Academical,1,2,-1,L
85858,13,SCO2,2013-08-31,Greenock Morton,Raith Rovers,1,1,0,D
85859,13,SCO2,2013-08-31,Queen of the South,Alloa Athletic,0,0,0,D
85860,13,SCO2,2013-09-14,Alloa Athletic,Dumbarton,1,2,-1,L
85861,13,SCO2,2013-09-14,Cowdenbeath,Falkirk,1,0,1,W
85862,13,SCO2,2013-09-14,FC Dundee,Hamilton Academical,0,0,0,D
85863,13,SCO2,2013-09-14,Livingston,Greenock Morton,2,2,0,D
85864,13,SCO2,2013-09-14,Queen of the South,Raith Rovers,0,1,-1,L
85865,13,SCO2,2013-09-21,Dumbarton,Livingston,1,2,-1,L
85866,13,SCO2,2013-09-21,Falkirk,FC Dundee,3,1,2,W
85867,13,SCO2,2013-09-21,Hamilton Academical,Cowdenbeath,1,0,1,W
85868,13,SCO2,2013-09-21,Greenock Morton,Queen of the South,0,2,-2,L
85869,13,SCO2,2013-09-21,Raith Rovers,Alloa Athletic,4,2,2,W
85870,13,SCO2,2013-09-28,Alloa Athletic,Hamilton Academical,1,0,1,W
85871,13,SCO2,2013-09-28,FC Dundee,Greenock Morton,3,1,2,W
85872,13,SCO2,2013-09-28,Livingston,Cowdenbeath,5,1,4,W
85873,13,SCO2,2013-09-28,Queen of the South,Dumbarton,1,2,-1,L
85874,13,SCO2,2013-09-28,Raith Rovers,Falkirk,1,1,0,D
85875,13,SCO2,2013-10-05,Cowdenbeath,FC Dundee,0,2,-2,L
85876,13,SCO2,2013-10-05,Dumbarton,Raith Rovers,2,4,-2,L
85877,13,SCO2,2013-10-05,Falkirk,Queen of the South,2,1,1,W
85878,13,SCO2,2013-10-05,Hamilton Academical,Livingston,2,0,2,W
85879,13,SCO2,2013-10-05,Greenock Morton,Alloa Athletic,0,2,-2,L
85880,13,SCO2,2013-10-12,Alloa Athletic,Falkirk,0,0,0,D
85881,13,SCO2,2013-10-12,Dumbarton,FC Dundee,1,4,-3,L
85882,13,SCO2,2013-10-12,Greenock Morton,Hamilton Academical,1,1,0,D
85883,13,SCO2,2013-10-12,Queen of the South,Cowdenbeath,1,1,0,D
85884,13,SCO2,2013-10-19,Cowdenbeath,Greenock Morton,5,1,4,W
85885,13,SCO2,2013-10-19,FC Dundee,Queen of the South,2,1,1,W
85886,13,SCO2,2013-10-19,Falkirk,Dumbarton,1,2,-1,L
85887,13,SCO2,2013-10-19,Hamilton Academical,Raith Rovers,1,1,0,D
85888,13,SCO2,2013-10-19,Livingston,Alloa Athletic,3,2,1,W
85889,13,SCO2,2013-10-26,Alloa Athletic,Queen of the South,0,3,-3,L
85890,13,SCO2,2013-10-26,Dumbarton,Cowdenbeath,0,0,0,D
85891,13,SCO2,2013-10-26,Hamilton Academical,Falkirk,2,0,2,W
85892,13,SCO2,2013-10-26,Livingston,FC Dundee,2,1,1,W
85893,13,SCO2,2013-10-26,Raith Rovers,Greenock Morton,2,1,1,W
85894,13,SCO2,2013-10-29,Raith Rovers,Livingston,1,0,1,W
85895,13,SCO2,2013-11-09,Cowdenbeath,Alloa Athletic,0,2,-2,L
85896,13,SCO2,2013-11-09,FC Dundee,Raith Rovers,2,0,2,W
85897,13,SCO2,2013-11-09,Falkirk,Livingston,4,1,3,W
85898,13,SCO2,2013-11-09,Greenock Morton,Dumbarton,2,0,2,W
85899,13,SCO2,2013-11-09,Queen of the South,Hamilton Academical,0,1,-1,L
85900,13,SCO2,2013-11-16,Alloa Athletic,Raith Rovers,1,0,1,W
85901,13,SCO2,2013-11-16,Cowdenbeath,Hamilton Academical,2,4,-2,L
85902,13,SCO2,2013-11-16,FC Dundee,Falkirk,1,1,0,D
85903,13,SCO2,2013-11-16,Livingston,Dumbarton,1,3,-2,L
85904,13,SCO2,2013-11-16,Queen of the South,Greenock Morton,2,0,2,W
85905,13,SCO2,2013-11-23,Falkirk,Cowdenbeath,4,0,4,W
85906,13,SCO2,2013-11-23,Hamilton Academical,FC Dundee,0,3,-3,L
85907,13,SCO2,2013-11-23,Greenock Morton,Livingston,1,5,-4,L
85908,13,SCO2,2013-11-23,Raith Rovers,Queen of the South,2,1,1,W
85909,13,SCO2,2013-12-04,Dumbarton,Alloa Athletic,1,1,0,D
85910,13,SCO2,2013-12-07,Cowdenbeath,Livingston,2,3,-1,L
85911,13,SCO2,2013-12-07,Dumbarton,Queen of the South,0,1,-1,L
85912,13,SCO2,2013-12-07,Falkirk,Raith Rovers,3,1,2,W
85913,13,SCO2,2013-12-07,Hamilton Academical,Alloa Athletic,0,1,-1,L
85914,13,SCO2,2013-12-07,Greenock Morton,FC Dundee,1,2,-1,L
85915,13,SCO2,2013-12-14,Alloa Athletic,Greenock Morton,2,0,2,W
85916,13,SCO2,2013-12-14,FC Dundee,Cowdenbeath,1,2,-1,L
85917,13,SCO2,2013-12-14,Livingston,Hamilton Academical,0,0,0,D
85918,13,SCO2,2013-12-14,Raith Rovers,Dumbarton,2,1,1,W
85919,13,SCO2,2013-12-21,Alloa Athletic,FC Dundee,0,1,-1,L
85920,13,SCO2,2013-12-21,Dumbarton,Hamilton Academical,2,1,1,W
85921,13,SCO2,2013-12-21,Greenock Morton,Falkirk,0,2,-2,L
85922,13,SCO2,2013-12-21,Queen of the South,Livingston,2,2,0,D
85923,13,SCO2,2013-12-21,Raith Rovers,Cowdenbeath,3,3,0,D
85924,13,SCO2,2013-12-28,Cowdenbeath,Queen of the South,0,2,-2,L
85925,13,SCO2,2013-12-28,FC Dundee,Dumbarton,3,0,3,W
85926,13,SCO2,2013-12-28,Falkirk,Alloa Athletic,0,0,0,D
85927,13,SCO2,2013-12-28,Hamilton Academical,Greenock Morton,1,0,1,W
85928,13,SCO2,2013-12-28,Livingston,Raith Rovers,3,0,3,W
85929,13,SCO2,2014-01-02,Alloa Athletic,Cowdenbeath,0,1,-1,L
85930,13,SCO2,2014-01-02,Raith Rovers,FC Dundee,0,2,-2,L
85931,13,SCO2,2014-01-04,Dumbarton,Greenock Morton,2,0,2,W
85932,13,SCO2,2014-01-04,Hamilton Academical,Queen of the South,3,1,2,W
85933,13,SCO2,2014-01-04,Livingston,Falkirk,0,1,-1,L
85934,13,SCO2,2014-01-11,Cowdenbeath,Dumbarton,2,4,-2,L
85935,13,SCO2,2014-01-11,FC Dundee,Livingston,0,1,-1,L
85936,13,SCO2,2014-01-11,Falkirk,Hamilton Academical,0,0,0,D
85937,13,SCO2,2014-01-11,Greenock Morton,Raith Rovers,0,0,0,D
85938,13,SCO2,2014-01-11,Queen of the South,Alloa Athletic,3,1,2,W
85939,13,SCO2,2014-01-18,Alloa Athletic,Dumbarton,1,5,-4,L
85940,13,SCO2,2014-01-18,Cowdenbeath,Falkirk,0,2,-2,L
85941,13,SCO2,2014-01-18,Livingston,Greenock Morton,0,1,-1,L
85942,13,SCO2,2014-01-18,Queen of the South,Raith Rovers,1,0,1,W
85943,13,SCO2,2014-01-25,Falkirk,FC Dundee,2,0,2,W
85944,13,SCO2,2014-01-25,Hamilton Academical,Cowdenbeath,3,4,-1,L
85945,13,SCO2,2014-01-25,Greenock Morton,Queen of the South,1,1,0,D
85946,13,SCO2,2014-02-01,Cowdenbeath,Raith Rovers,1,0,1,W
85947,13,SCO2,2014-02-01,FC Dundee,Alloa Athletic,1,1,0,D
85948,13,SCO2,2014-02-01,Falkirk,Greenock Morton,1,1,0,D
85949,13,SCO2,2014-02-01,Hamilton Academical,Dumbarton,3,3,0,D
85950,13,SCO2,2014-02-01,Livingston,Queen of the South,1,2,-1,L
85951,13,SCO2,2014-02-05,Dumbarton,Livingston,2,2,0,D
85952,13,SCO2,2014-02-08,FC Dundee,Hamilton Academical,1,0,1,W
85953,13,SCO2,2014-02-08,Queen of the South,Falkirk,2,0,2,W
85954,13,SCO2,2014-02-15,Alloa Athletic,Livingston,0,3,-3,L
85955,13,SCO2,2014-02-15,Dumbarton,Falkirk,2,1,1,W
85956,13,SCO2,2014-02-15,Greenock Morton,Cowdenbeath,1,1,0,D
85957,13,SCO2,2014-02-15,Queen of the South,FC Dundee,0,1,-1,L
85958,13,SCO2,2014-02-15,Raith Rovers,Hamilton Academical,2,4,-2,L
85959,13,SCO2,2014-02-21,Hamilton Academical,Livingston,2,0,2,W
85960,13,SCO2,2014-02-22,Cowdenbeath,FC Dundee,2,0,2,W
85961,13,SCO2,2014-02-22,Dumbarton,Raith Rovers,3,3,0,D
85962,13,SCO2,2014-02-22,Falkirk,Queen of the South,1,0,1,W
85963,13,SCO2,2014-02-22,Greenock Morton,Alloa Athletic,0,1,-1,L
85964,13,SCO2,2014-02-25,Raith Rovers,Alloa Athletic,1,1,0,D
85965,13,SCO2,2014-03-01,Alloa Athletic,Hamilton Academical,0,3,-3,L
85966,13,SCO2,2014-03-01,FC Dundee,Greenock Morton,2,0,2,W
85967,13,SCO2,2014-03-01,Livingston,Cowdenbeath,1,0,1,W
85968,13,SCO2,2014-03-01,Queen of the South,Dumbarton,3,1,2,W
85969,13,SCO2,2014-03-01,Raith Rovers,Falkirk,2,4,-2,L
85970,13,SCO2,2014-03-08,Cowdenbeath,Alloa Athletic,2,2,0,D
85971,13,SCO2,2014-03-08,Falkirk,Livingston,1,1,0,D
85972,13,SCO2,2014-03-08,Queen of the South,Hamilton Academical,1,1,0,D
85973,13,SCO2,2014-03-15,Alloa Athletic,Queen of the South,0,1,-1,L
85974,13,SCO2,2014-03-15,Dumbarton,Cowdenbeath,5,1,4,W
85975,13,SCO2,2014-03-15,Hamilton Academical,Falkirk,3,1,2,W
85976,13,SCO2,2014-03-15,Livingston,FC Dundee,0,2,-2,L
85977,13,SCO2,2014-03-15,Raith Rovers,Greenock Morton,2,1,1,W
85978,13,SCO2,2014-03-18,FC Dundee,Raith Rovers,0,0,0,D
85979,13,SCO2,2014-03-22,Alloa Athletic,Falkirk,3,0,3,W
85980,13,SCO2,2014-03-22,Dumbarton,FC Dundee,0,1,-1,L
85981,13,SCO2,2014-03-22,Greenock Morton,Hamilton Academical,3,4,-1,L
85982,13,SCO2,2014-03-22,Queen of the South,Cowdenbeath,2,1,1,W
85983,13,SCO2,2014-03-22,Raith Rovers,Livingston,2,4,-2,L
85984,13,SCO2,2014-03-25,Cowdenbeath,Greenock Morton,3,0,3,W
85985,13,SCO2,2014-03-25,FC Dundee,Queen of the South,1,0,1,W
85986,13,SCO2,2014-03-25,Falkirk,Dumbarton,2,0,2,W
85987,13,SCO2,2014-03-25,Hamilton Academical,Raith Rovers,3,2,1,W
85988,13,SCO2,2014-03-25,Livingston,Alloa Athletic,2,0,2,W
85989,13,SCO2,2014-03-29,Alloa Athletic,Raith Rovers,0,1,-1,L
85990,13,SCO2,2014-03-29,Cowdenbeath,Hamilton Academical,1,1,0,D
85991,13,SCO2,2014-03-29,FC Dundee,Falkirk,0,1,-1,L
85992,13,SCO2,2014-03-29,Livingston,Dumbarton,1,2,-1,L
85993,13,SCO2,2014-03-29,Queen of the South,Greenock Morton,3,0,3,W
85994,13,SCO2,2014-04-01,Greenock Morton,Dumbarton,3,0,3,W
85995,13,SCO2,2014-04-05,Dumbarton,Alloa Athletic,4,1,3,W
85996,13,SCO2,2014-04-05,Falkirk,Cowdenbeath,5,0,5,W
85997,13,SCO2,2014-04-05,Hamilton Academical,FC Dundee,1,1,0,D
85998,13,SCO2,2014-04-05,Greenock Morton,Livingston,2,0,2,W
85999,13,SCO2,2014-04-12,Alloa Athletic,Greenock Morton,2,0,2,W
86000,13,SCO2,2014-04-12,FC Dundee,Cowdenbeath,4,0,4,W
86001,13,SCO2,2014-04-12,Livingston,Hamilton Academical,1,1,0,D
86002,13,SCO2,2014-04-12,Queen of the South,Falkirk,1,2,-1,L
86003,13,SCO2,2014-04-12,Raith Rovers,Dumbarton,1,3,-2,L
86004,13,SCO2,2014-04-15,Raith Rovers,Queen of the South,3,2,1,W
86005,13,SCO2,2014-04-19,Cowdenbeath,Livingston,4,0,4,W
86006,13,SCO2,2014-04-19,Dumbarton,Queen of the South,0,3,-3,L
86007,13,SCO2,2014-04-19,Falkirk,Raith Rovers,2,1,1,W
86008,13,SCO2,2014-04-19,Hamilton Academical,Alloa Athletic,2,1,1,W
86009,13,SCO2,2014-04-19,Greenock Morton,FC Dundee,1,0,1,W
86010,13,SCO2,2014-04-26,Alloa Athletic,FC Dundee,0,3,-3,L
86011,13,SCO2,2014-04-26,Dumbarton,Hamilton Academical,4,1,3,W
86012,13,SCO2,2014-04-26,Greenock Morton,Falkirk,1,1,0,D
86013,13,SCO2,2014-04-26,Queen of the South,Livingston,2,0,2,W
86014,13,SCO2,2014-04-26,Raith Rovers,Cowdenbeath,1,2,-1,L
86015,13,SCO2,2014-05-03,Cowdenbeath,Queen of the South,1,1,0,D
86016,13,SCO2,2014-05-03,FC Dundee,Dumbarton,2,1,1,W
86017,13,SCO2,2014-05-03,Falkirk,Alloa Athletic,3,1,2,W
86018,13,SCO2,2014-05-03,Hamilton Academical,Greenock Morton,10,2,8,W
86019,13,SCO2,2014-05-03,Livingston,Raith Rovers,2,0,2,W
86020,14,SCO2,2014-08-09,Cowdenbeath,Falkirk,2,2,0,D
86021,14,SCO2,2014-08-09,Hibernian,Livingston,2,1,1,W
86022,14,SCO2,2014-08-09,Queen of the South,Alloa Athletic,2,0,2,W
86023,14,SCO2,2014-08-09,Raith Rovers,Dumbarton,3,1,2,W
86024,14,SCO2,2014-08-10,Glasgow Rangers,Hearts,1,2,-1,L
86025,14,SCO2,2014-08-15,Falkirk,Glasgow Rangers,0,2,-2,L
86026,14,SCO2,2014-08-16,Alloa Athletic,Raith Rovers,0,1,-1,L
86027,14,SCO2,2014-08-16,Dumbarton,Queen of the South,0,4,-4,L
86028,14,SCO2,2014-08-16,Livingston,Cowdenbeath,2,1,1,W
86029,14,SCO2,2014-08-17,Hearts,Hibernian,2,1,1,W
86030,14,SCO2,2014-08-23,Cowdenbeath,Alloa Athletic,0,3,-3,L
86031,14,SCO2,2014-08-23,Hibernian,Falkirk,0,1,-1,L
86032,14,SCO2,2014-08-23,Queen of the South,Livingston,1,1,0,D
86033,14,SCO2,2014-08-23,Raith Rovers,Hearts,0,4,-4,L
86034,14,SCO2,2014-08-23,Glasgow Rangers,Dumbarton,4,1,3,W
86035,14,SCO2,2014-08-30,Alloa Athletic,Hibernian,2,1,1,W
86036,14,SCO2,2014-08-30,Cowdenbeath,Raith Rovers,1,3,-2,L
86037,14,SCO2,2014-08-30,Dumbarton,Livingston,1,0,1,W
86038,14,SCO2,2014-08-30,Hearts,Falkirk,4,1,3,W
86039,14,SCO2,2014-08-30,Glasgow Rangers,Queen of the South,4,2,2,W
86040,14,SCO2,2014-09-12,Raith Rovers,Glasgow Rangers,0,4,-4,L
86041,14,SCO2,2014-09-13,Dumbarton,Hearts,0,0,0,D
86042,14,SCO2,2014-09-13,Falkirk,Queen of the South,1,1,0,D
86043,14,SCO2,2014-09-13,Hibernian,Cowdenbeath,3,2,1,W
86044,14,SCO2,2014-09-13,Livingston,Alloa Athletic,4,0,4,W
86045,14,SCO2,2014-09-20,Alloa Athletic,Glasgow Rangers,1,1,0,D
86046,14,SCO2,2014-09-20,Falkirk,Dumbarton,1,1,0,D
86047,14,SCO2,2014-09-20,Hearts,Cowdenbeath,5,1,4,W
86048,14,SCO2,2014-09-20,Livingston,Raith Rovers,0,1,-1,L
86049,14,SCO2,2014-09-20,Queen of the South,Hibernian,1,0,1,W
86050,14,SCO2,2014-09-27,Cowdenbeath,Queen of the South,2,1,1,W
86051,14,SCO2,2014-09-27,Dumbarton,Alloa Athletic,3,1,2,W
86052,14,SCO2,2014-09-27,Raith Rovers,Falkirk,0,0,0,D
86053,14,SCO2,2014-09-28,Hearts,Livingston,5,0,5,W
86054,14,SCO2,2014-09-29,Glasgow Rangers,Hibernian,1,3,-2,L
86055,14,SCO2,2014-10-04,Dumbarton,Cowdenbeath,0,0,0,D
86056,14,SCO2,2014-10-04,Falkirk,Alloa Athletic,2,1,1,W
86057,14,SCO2,2014-10-04,Hibernian,Raith Rovers,1,1,0,D
86058,14,SCO2,2014-10-04,Livingston,Glasgow Rangers,0,1,-1,L
86059,14,SCO2,2014-10-04,Queen of the South,Hearts,0,3,-3,L
86060,14,SCO2,2014-10-10,Raith Rovers,Queen of the South,3,4,-1,L
86061,14,SCO2,2014-10-11,Alloa Athletic,Hearts,0,1,-1,L
86062,14,SCO2,2014-10-11,Hibernian,Dumbarton,0,0,0,D
86063,14,SCO2,2014-10-18,Alloa Athletic,Cowdenbeath,2,3,-1,L
86064,14,SCO2,2014-10-18,Hearts,Dumbarton,5,1,4,W
86065,14,SCO2,2014-10-18,Livingston,Hibernian,0,4,-4,L
86066,14,SCO2,2014-10-18,Queen of the South,Falkirk,3,0,3,W
86067,14,SCO2,2014-10-18,Glasgow Rangers,Raith Rovers,6,1,5,W
86068,14,SCO2,2014-10-21,Falkirk,Livingston,0,0,0,D
86069,14,SCO2,2014-10-25,Dumbarton,Glasgow Rangers,0,3,-3,L
86070,14,SCO2,2014-10-25,Falkirk,Cowdenbeath,6,0,6,W
86071,14,SCO2,2014-10-25,Livingston,Queen of the South,2,2,0,D
86072,14,SCO2,2014-10-25,Raith Rovers,Alloa Athletic,1,1,0,D
86073,14,SCO2,2014-10-26,Hibernian,Hearts,1,1,0,D
86074,14,SCO2,2014-11-04,Cowdenbeath,Glasgow Rangers,0,3,-3,L
86075,14,SCO2,2014-11-08,Alloa Athletic,Livingston,1,0,1,W
86076,14,SCO2,2014-11-08,Cowdenbeath,Hibernian,1,2,-1,L
86077,14,SCO2,2014-11-08,Hearts,Raith Rovers,1,0,1,W
86078,14,SCO2,2014-11-08,Queen of the South,Dumbarton,3,0,3,W
86079,14,SCO2,2014-11-08,Glasgow Rangers,Falkirk,4,0,4,W
86080,14,SCO2,2014-11-15,Falkirk,Hearts,1,2,-1,L
86081,14,SCO2,2014-11-15,Hibernian,Queen of the South,0,0,0,D
86082,14,SCO2,2014-11-15,Livingston,Dumbarton,1,2,-1,L
86083,14,SCO2,2014-11-15,Raith Rovers,Cowdenbeath,2,1,1,W
86084,14,SCO2,2014-11-15,Glasgow Rangers,Alloa Athletic,1,1,0,D
86085,14,SCO2,2014-11-22,Alloa Athletic,Falkirk,2,3,-1,L
86086,14,SCO2,2014-11-22,Cowdenbeath,Livingston,1,0,1,W
86087,14,SCO2,2014-11-22,Dumbarton,Hibernian,3,6,-3,L
86088,14,SCO2,2014-11-22,Hearts,Glasgow Rangers,2,0,2,W
86089,14,SCO2,2014-11-22,Queen of the South,Raith Rovers,2,0,2,W
86090,14,SCO2,2014-12-06,Alloa Athletic,Dumbarton,0,1,-1,L
86091,14,SCO2,2014-12-06,Falkirk,Hibernian,1,0,1,W
86092,14,SCO2,2014-12-06,Hearts,Queen of the South,4,1,3,W
86093,14,SCO2,2014-12-06,Raith Rovers,Livingston,1,5,-4,L
86094,14,SCO2,2014-12-06,Glasgow Rangers,Cowdenbeath,1,0,1,W
86095,14,SCO2,2014-12-12,Queen of the South,Glasgow Rangers,2,0,2,W
86096,14,SCO2,2014-12-13,Dumbarton,Raith Rovers,2,1,1,W
86097,14,SCO2,2014-12-13,Hibernian,Alloa Athletic,2,0,2,W
86098,14,SCO2,2014-12-13,Livingston,Falkirk,0,1,-1,L
86099,14,SCO2,2014-12-20,Dumbarton,Falkirk,0,3,-3,L
86100,14,SCO2,2014-12-20,Hearts,Alloa Athletic,2,0,2,W
86101,14,SCO2,2014-12-20,Queen of the South,Cowdenbeath,1,2,-1,L
86102,14,SCO2,2014-12-20,Raith Rovers,Hibernian,1,3,-2,L
86103,14,SCO2,2014-12-20,Glasgow Rangers,Livingston,2,0,2,W
86104,14,SCO2,2014-12-23,Cowdenbeath,Hearts,0,2,-2,L
86105,14,SCO2,2014-12-27,Alloa Athletic,Queen of the South,1,1,0,D
86106,14,SCO2,2014-12-27,Cowdenbeath,Dumbarton,1,3,-2,L
86107,14,SCO2,2014-12-27,Falkirk,Raith Rovers,0,1,-1,L
86108,14,SCO2,2014-12-27,Hibernian,Glasgow Rangers,4,0,4,W
86109,14,SCO2,2014-12-27,Livingston,Hearts,0,1,-1,L
86110,14,SCO2,2015-01-03,Cowdenbeath,Raith Rovers,0,1,-1,L
86111,14,SCO2,2015-01-03,Falkirk,Alloa Athletic,1,0,1,W
86112,14,SCO2,2015-01-03,Hearts,Hibernian,1,1,0,D
86113,14,SCO2,2015-01-03,Queen of the South,Livingston,3,1,2,W
86114,14,SCO2,2015-01-03,Glasgow Rangers,Dumbarton,3,1,2,W
86115,14,SCO2,2015-01-10,Alloa Athletic,Glasgow Rangers,0,1,-1,L
86116,14,SCO2,2015-01-10,Dumbarton,Hearts,1,5,-4,L
86117,14,SCO2,2015-01-10,Hibernian,Falkirk,3,3,0,D
86118,14,SCO2,2015-01-10,Livingston,Cowdenbeath,1,1,0,D
86119,14,SCO2,2015-01-17,Falkirk,Queen of the South,1,1,0,D
86120,14,SCO2,2015-01-17,Hibernian,Cowdenbeath,5,0,5,W
86121,14,SCO2,2015-01-17,Raith Rovers,Dumbarton,2,1,1,W
86122,14,SCO2,2015-01-24,Alloa Athletic,Raith Rovers,0,0,0,D
86123,14,SCO2,2015-01-24,Dumbarton,Livingston,1,5,-4,L
86124,14,SCO2,2015-01-24,Hearts,Falkirk,2,3,-1,L
86125,14,SCO2,2015-01-24,Queen of the South,Hibernian,0,2,-2,L
86126,14,SCO2,2015-01-31,Alloa Athletic,Hearts,1,4,-3,L
86127,14,SCO2,2015-01-31,Cowdenbeath,Queen of the South,0,5,-5,L
86128,14,SCO2,2015-01-31,Falkirk,Dumbarton,3,3,0,D
86129,14,SCO2,2015-01-31,Hibernian,Raith Rovers,1,1,0,D
86130,14,SCO2,2015-02-03,Livingston,Alloa Athletic,0,0,0,D
86131,14,SCO2,2015-02-07,Livingston,Hearts,2,3,-1,L
86132,14,SCO2,2015-02-13,Glasgow Rangers,Hibernian,0,2,-2,L
86133,14,SCO2,2015-02-14,Dumbarton,Cowdenbeath,1,2,-1,L
86134,14,SCO2,2015-02-14,Hearts,Livingston,1,0,1,W
86135,14,SCO2,2015-02-14,Queen of the South,Alloa Athletic,1,0,1,W
86136,14,SCO2,2015-02-14,Raith Rovers,Falkirk,2,2,0,D
86137,14,SCO2,2015-02-20,Raith Rovers,Glasgow Rangers,1,2,-1,L
86138,14,SCO2,2015-02-21,Cowdenbeath,Alloa Athletic,0,2,-2,L
86139,14,SCO2,2015-02-21,Falkirk,Livingston,2,0,2,W
86140,14,SCO2,2015-02-21,Hibernian,Dumbarton,3,0,3,W
86141,14,SCO2,2015-02-21,Queen of the South,Hearts,1,2,-1,L
86142,14,SCO2,2015-02-27,Falkirk,Glasgow Rangers,1,1,0,D
86143,14,SCO2,2015-02-28,Alloa Athletic,Hibernian,0,1,-1,L
86144,14,SCO2,2015-02-28,Dumbarton,Queen of the South,0,0,0,D
86145,14,SCO2,2015-02-28,Hearts,Cowdenbeath,10,0,10,W
86146,14,SCO2,2015-02-28,Livingston,Raith Rovers,0,2,-2,L
86147,14,SCO2,2015-03-07,Cowdenbeath,Glasgow Rangers,0,0,0,D
86148,14,SCO2,2015-03-07,Dumbarton,Alloa Athletic,1,0,1,W
86149,14,SCO2,2015-03-10,Glasgow Rangers,Queen of the South,1,1,0,D
86150,14,SCO2,2015-03-11,Hibernian,Livingston,2,1,1,W
86151,14,SCO2,2015-03-14,Alloa Athletic,Falkirk,1,3,-2,L
86152,14,SCO2,2015-03-14,Cowdenbeath,Hibernian,0,2,-2,L
86153,14,SCO2,2015-03-14,Hearts,Dumbarton,4,0,4,W
86154,14,SCO2,2015-03-14,Queen of the South,Raith Rovers,2,1,1,W
86155,14,SCO2,2015-03-14,Glasgow Rangers,Livingston,1,1,0,D
86156,14,SCO2,2015-03-17,Raith Rovers,Hearts,1,3,-2,L
86157,14,SCO2,2015-03-17,Glasgow Rangers,Alloa Athletic,2,2,0,D
86158,14,SCO2,2015-03-21,Falkirk,Hearts,0,3,-3,L
86159,14,SCO2,2015-03-21,Livingston,Dumbarton,1,2,-1,L
86160,14,SCO2,2015-03-21,Queen of the South,Cowdenbeath,4,1,3,W
86161,14,SCO2,2015-03-21,Raith Rovers,Alloa Athletic,2,1,1,W
86162,14,SCO2,2015-03-22,Hibernian,Glasgow Rangers,0,2,-2,L
86163,14,SCO2,2015-03-24,Cowdenbeath,Falkirk,0,1,-1,L
86164,14,SCO2,2015-03-24,Raith Rovers,Queen of the South,3,0,3,W
86165,14,SCO2,2015-03-28,Alloa Athletic,Livingston,2,2,0,D
86166,14,SCO2,2015-03-28,Dumbarton,Falkirk,1,0,1,W
86167,14,SCO2,2015-03-28,Hearts,Queen of the South,2,0,2,W
86168,14,SCO2,2015-03-28,Raith Rovers,Hibernian,2,1,1,W
86169,14,SCO2,2015-03-28,Glasgow Rangers,Cowdenbeath,4,1,3,W
86170,14,SCO2,2015-03-31,Falkirk,Cowdenbeath,1,0,1,W
86171,14,SCO2,2015-04-04,Cowdenbeath,Dumbarton,3,0,3,W
86172,14,SCO2,2015-04-04,Falkirk,Raith Rovers,1,0,1,W
86173,14,SCO2,2015-04-04,Hibernian,Queen of the South,0,1,-1,L
86174,14,SCO2,2015-04-05,Glasgow Rangers,Hearts,2,1,1,W
86175,14,SCO2,2015-04-08,Dumbarton,Hibernian,1,2,-1,L
86176,14,SCO2,2015-04-08,Hearts,Alloa Athletic,3,0,3,W
86177,14,SCO2,2015-04-08,Livingston,Falkirk,2,1,1,W
86178,14,SCO2,2015-04-08,Raith Rovers,Cowdenbeath,1,3,-2,L
86179,14,SCO2,2015-04-09,Queen of the South,Glasgow Rangers,3,0,3,W
86180,14,SCO2,2015-04-11,Alloa Athletic,Dumbarton,3,0,3,W
86181,14,SCO2,2015-04-11,Cowdenbeath,Livingston,1,2,-1,L
86182,14,SCO2,2015-04-12,Hibernian,Hearts,2,0,2,W
86183,14,SCO2,2015-04-12,Queen of the South,Falkirk,1,0,1,W
86184,14,SCO2,2015-04-12,Glasgow Rangers,Raith Rovers,4,0,4,W
86185,14,SCO2,2015-04-15,Livingston,Glasgow Rangers,1,1,0,D
86186,14,SCO2,2015-04-18,Alloa Athletic,Queen of the South,2,2,0,D
86187,14,SCO2,2015-04-18,Dumbarton,Glasgow Rangers,1,3,-2,L
86188,14,SCO2,2015-04-18,Hearts,Raith Rovers,2,1,1,W
86189,14,SCO2,2015-04-22,Livingston,Hibernian,1,3,-2,L
86190,14,SCO2,2015-04-25,Cowdenbeath,Hearts,1,2,-1,L
86191,14,SCO2,2015-04-25,Hibernian,Alloa Athletic,4,1,3,W
86192,14,SCO2,2015-04-25,Queen of the South,Dumbarton,2,1,1,W
86193,14,SCO2,2015-04-25,Raith Rovers,Livingston,0,4,-4,L
86194,14,SCO2,2015-04-25,Glasgow Rangers,Falkirk,2,2,0,D
86195,14,SCO2,2015-05-02,Alloa Athletic,Cowdenbeath,3,0,3,W
86196,14,SCO2,2015-05-02,Dumbarton,Raith Rovers,2,2,0,D
86197,14,SCO2,2015-05-02,Falkirk,Hibernian,0,3,-3,L
86198,14,SCO2,2015-05-02,Hearts,Glasgow Rangers,2,2,0,D
86199,14,SCO2,2015-05-02,Livingston,Queen of the South,1,0,1,W
86200,15,SCO2,2015-08-07,Glasgow Rangers,St Mirren,3,1,2,W
86201,15,SCO2,2015-08-08,Dumbarton,Hibernian,2,1,1,W
86202,15,SCO2,2015-08-08,Greenock Morton,Falkirk,1,1,0,D
86203,15,SCO2,2015-08-08,Queen of the South,Alloa Athletic,3,1,2,W
86204,15,SCO2,2015-08-08,Raith Rovers,Livingston,3,0,3,W
86205,15,SCO2,2015-08-15,Falkirk,Raith Rovers,1,0,1,W
86206,15,SCO2,2015-08-15,Hibernian,Greenock Morton,1,0,1,W
86207,15,SCO2,2015-08-15,Livingston,Queen of the South,0,1,-1,L
86208,15,SCO2,2015-08-15,St Mirren,Dumbarton,1,2,-1,L
86209,15,SCO2,2015-08-16,Alloa Athletic,Glasgow Rangers,1,5,-4,L
86210,15,SCO2,2015-08-21,Greenock Morton,St Mirren,0,0,0,D
86211,15,SCO2,2015-08-22,Dumbarton,Queen of the South,0,2,-2,L
86212,15,SCO2,2015-08-22,Livingston,Falkirk,1,2,-1,L
86213,15,SCO2,2015-08-22,Raith Rovers,Alloa Athletic,3,0,3,W
86214,15,SCO2,2015-08-23,Glasgow Rangers,Hibernian,1,0,1,W
86215,15,SCO2,2015-08-28,Falkirk,Dumbarton,2,1,1,W
86216,15,SCO2,2015-08-29,Alloa Athletic,Greenock Morton,0,1,-1,L
86217,15,SCO2,2015-08-29,Hibernian,Raith Rovers,2,0,2,W
86218,15,SCO2,2015-08-29,St Mirren,Livingston,1,1,0,D
86219,15,SCO2,2015-08-30,Queen of the South,Glasgow Rangers,1,5,-4,L
86220,15,SCO2,2015-09-05,Dumbarton,Alloa Athletic,0,2,-2,L
86221,15,SCO2,2015-09-05,Livingston,Greenock Morton,2,4,-2,L
86222,15,SCO2,2015-09-05,Queen of the South,St Mirren,0,2,-2,L
86223,15,SCO2,2015-09-05,Glasgow Rangers,Raith Rovers,5,0,5,W
86224,15,SCO2,2015-09-12,Hibernian,Alloa Athletic,3,0,3,W
86225,15,SCO2,2015-09-12,Greenock Morton,Dumbarton,0,0,0,D
86226,15,SCO2,2015-09-12,Raith Rovers,Queen of the South,1,0,1,W
86227,15,SCO2,2015-09-12,Glasgow Rangers,Livingston,3,0,3,W
86228,15,SCO2,2015-09-12,St Mirren,Falkirk,2,3,-1,L
86229,15,SCO2,2015-09-18,St Mirren,Raith Rovers,1,2,-1,L
86230,15,SCO2,2015-09-19,Alloa Athletic,Falkirk,1,1,0,D
86231,15,SCO2,2015-09-19,Dumbarton,Glasgow Rangers,1,2,-1,L
86232,15,SCO2,2015-09-19,Livingston,Hibernian,0,1,-1,L
86233,15,SCO2,2015-09-19,Queen of the South,Greenock Morton,2,2,0,D
86234,15,SCO2,2015-09-25,Falkirk,Queen of the South,0,0,0,D
86235,15,SCO2,2015-09-26,Alloa Athletic,Livingston,0,3,-3,L
86236,15,SCO2,2015-09-26,Hibernian,St Mirren,1,1,0,D
86237,15,SCO2,2015-09-26,Raith Rovers,Dumbarton,1,0,1,W
86238,15,SCO2,2015-09-27,Greenock Morton,Glasgow Rangers,0,4,-4,L
86239,15,SCO2,2015-10-03,Dumbarton,Livingston,2,1,1,W
86240,15,SCO2,2015-10-03,Queen of the South,Hibernian,0,3,-3,L
86241,15,SCO2,2015-10-03,Raith Rovers,Greenock Morton,2,1,1,W
86242,15,SCO2,2015-10-03,Glasgow Rangers,Falkirk,3,1,2,W
86243,15,SCO2,2015-10-03,St Mirren,Alloa Athletic,1,1,0,D
86244,15,SCO2,2015-10-10,Queen of the South,Greenock Morton,1,0,1,W
86245,15,SCO2,2015-10-17,Alloa Athletic,Raith Rovers,0,1,-1,L
86246,15,SCO2,2015-10-17,Falkirk,Greenock Morton,1,0,1,W
86247,15,SCO2,2015-10-17,Hibernian,Dumbarton,4,2,2,W
86248,15,SCO2,2015-10-17,Livingston,St Mirren,0,1,-1,L
86249,15,SCO2,2015-10-17,Glasgow Rangers,Queen of the South,2,1,1,W
86250,15,SCO2,2015-10-20,Falkirk,Hibernian,0,1,-1,L
86251,15,SCO2,2015-10-24,Dumbarton,Falkirk,0,5,-5,L
86252,15,SCO2,2015-10-24,Greenock Morton,Alloa Athletic,1,0,1,W
86253,15,SCO2,2015-10-24,Queen of the South,Livingston,1,4,-3,L
86254,15,SCO2,2015-10-24,Raith Rovers,Hibernian,1,2,-1,L
86255,15,SCO2,2015-10-25,St Mirren,Glasgow Rangers,0,1,-1,L
86256,15,SCO2,2015-10-31,Alloa Athletic,Queen of the South,1,2,-1,L
86257,15,SCO2,2015-10-31,Dumbarton,Greenock Morton,1,2,-1,L
86258,15,SCO2,2015-10-31,Falkirk,St Mirren,3,0,3,W
86259,15,SCO2,2015-10-31,Livingston,Raith Rovers,3,0,3,W
86260,15,SCO2,2015-11-01,Hibernian,Glasgow Rangers,2,1,1,W
86261,15,SCO2,2015-11-07,Greenock Morton,Livingston,1,0,1,W
86262,15,SCO2,2015-11-07,Queen of the South,Dumbarton,1,0,1,W
86263,15,SCO2,2015-11-07,Raith Rovers,Falkirk,1,2,-1,L
86264,15,SCO2,2015-11-07,Glasgow Rangers,Alloa Athletic,4,0,4,W
86265,15,SCO2,2015-11-07,St Mirren,Hibernian,1,4,-3,L
86266,15,SCO2,2015-11-14,Falkirk,Alloa Athletic,5,0,5,W
86267,15,SCO2,2015-11-14,Greenock Morton,Queen of the South,2,0,2,W
86268,15,SCO2,2015-11-17,Hibernian,Livingston,2,1,1,W
86269,15,SCO2,2015-11-20,St Mirren,Greenock Morton,1,1,0,D
86270,15,SCO2,2015-11-21,Alloa Athletic,Hibernian,0,1,-1,L
86271,15,SCO2,2015-11-21,Dumbarton,Raith Rovers,3,3,0,D
86272,15,SCO2,2015-11-21,Livingston,Glasgow Rangers,1,1,0,D
86273,15,SCO2,2015-11-21,Queen of the South,Falkirk,2,2,0,D
86274,15,SCO2,2015-11-24,Raith Rovers,St Mirren,1,1,0,D
86275,15,SCO2,2015-12-01,Glasgow Rangers,Dumbarton,4,0,4,W
86276,15,SCO2,2015-12-05,Alloa Athletic,Dumbarton,0,2,-2,L
86277,15,SCO2,2015-12-11,Queen of the South,Raith Rovers,1,1,0,D
86278,15,SCO2,2015-12-12,Dumbarton,St Mirren,1,0,1,W
86279,15,SCO2,2015-12-12,Hibernian,Falkirk,1,1,0,D
86280,15,SCO2,2015-12-12,Livingston,Alloa Athletic,0,1,-1,L
86281,15,SCO2,2015-12-12,Glasgow Rangers,Greenock Morton,2,2,0,D
86282,15,SCO2,2015-12-18,Greenock Morton,Raith Rovers,1,2,-1,L
86283,15,SCO2,2015-12-19,Alloa Athletic,St Mirren,0,2,-2,L
86284,15,SCO2,2015-12-19,Falkirk,Glasgow Rangers,2,1,1,W
86285,15,SCO2,2015-12-19,Hibernian,Queen of the South,1,0,1,W
86286,15,SCO2,2015-12-19,Livingston,Dumbarton,1,1,0,D
86287,15,SCO2,2015-12-26,Falkirk,Dumbarton,1,0,1,W
86288,15,SCO2,2015-12-26,St Mirren,Livingston,1,4,-3,L
86289,15,SCO2,2015-12-28,Glasgow Rangers,Hibernian,4,2,2,W
86290,15,SCO2,2015-12-29,Falkirk,Livingston,2,0,2,W
86291,15,SCO2,2016-01-02,Alloa Athletic,Falkirk,0,1,-1,L
86292,15,SCO2,2016-01-02,Dumbarton,Glasgow Rangers,0,6,-6,L
86293,15,SCO2,2016-01-02,Hibernian,Raith Rovers,1,0,1,W
86294,15,SCO2,2016-01-02,Livingston,Queen of the South,0,2,-2,L
86295,15,SCO2,2016-01-02,Greenock Morton,St Mirren,0,1,-1,L
86296,15,SCO2,2016-01-12,Raith Rovers,Alloa Athletic,0,1,-1,L
86297,15,SCO2,2016-01-16,Glasgow Rangers,Livingston,4,1,3,W
86298,15,SCO2,2016-01-17,Falkirk,Hibernian,1,1,0,D
86299,15,SCO2,2016-01-23,Hibernian,St Mirren,3,1,2,W
86300,15,SCO2,2016-01-23,Livingston,Falkirk,1,1,0,D
86301,15,SCO2,2016-01-23,Queen of the South,Alloa Athletic,1,0,1,W
86302,15,SCO2,2016-01-23,Raith Rovers,Dumbarton,0,0,0,D
86303,15,SCO2,2016-01-25,Greenock Morton,Glasgow Rangers,0,2,-2,L
86304,15,SCO2,2016-01-30,Dumbarton,Livingston,1,0,1,W
86305,15,SCO2,2016-01-30,Glasgow Rangers,Falkirk,1,0,1,W
86306,15,SCO2,2016-01-30,St Mirren,Alloa Athletic,3,1,2,W
86307,15,SCO2,2016-02-02,Greenock Morton,Hibernian,0,1,-1,L
86308,15,SCO2,2016-02-02,Raith Rovers,Glasgow Rangers,0,1,-1,L
86309,15,SCO2,2016-02-06,St Mirren,Queen of the South,1,0,1,W
86310,15,SCO2,2016-02-09,Alloa Athletic,Greenock Morton,2,2,0,D
86311,15,SCO2,2016-02-13,Alloa Athletic,Glasgow Rangers,1,1,0,D
86312,15,SCO2,2016-02-13,Falkirk,Raith Rovers,2,2,0,D
86313,15,SCO2,2016-02-13,Livingston,Hibernian,0,0,0,D
86314,15,SCO2,2016-02-13,Greenock Morton,Dumbarton,2,0,2,W
86315,15,SCO2,2016-02-13,Queen of the South,St Mirren,1,0,1,W
86316,15,SCO2,2016-02-20,Greenock Morton,Falkirk,0,1,-1,L
86317,15,SCO2,2016-02-20,Raith Rovers,Livingston,2,0,2,W
86318,15,SCO2,2016-02-20,St Mirren,Dumbarton,1,0,1,W
86319,15,SCO2,2016-02-21,Hibernian,Alloa Athletic,3,0,3,W
86320,15,SCO2,2016-02-21,Queen of the South,Glasgow Rangers,0,1,-1,L
86321,15,SCO2,2016-02-24,Hibernian,Greenock Morton,0,3,-3,L
86322,15,SCO2,2016-02-27,Alloa Athletic,Livingston,1,3,-2,L
86323,15,SCO2,2016-02-27,Dumbarton,Hibernian,3,2,1,W
86324,15,SCO2,2016-02-27,Falkirk,Queen of the South,3,1,2,W
86325,15,SCO2,2016-02-27,Raith Rovers,Greenock Morton,3,2,1,W
86326,15,SCO2,2016-02-27,Glasgow Rangers,St Mirren,1,0,1,W
86327,15,SCO2,2016-03-01,Livingston,Greenock Morton,0,0,0,D
86328,15,SCO2,2016-03-01,Queen of the South,Hibernian,1,0,1,W
86329,15,SCO2,2016-03-01,Glasgow Rangers,Raith Rovers,2,0,2,W
86330,15,SCO2,2016-03-01,St Mirren,Falkirk,0,0,0,D
86331,15,SCO2,2016-03-05,Falkirk,Alloa Athletic,2,0,2,W
86332,15,SCO2,2016-03-05,Livingston,Dumbarton,2,0,2,W
86333,15,SCO2,2016-03-05,Raith Rovers,St Mirren,4,3,1,W
86334,15,SCO2,2016-03-08,Dumbarton,Alloa Athletic,3,1,2,W
86335,15,SCO2,2016-03-08,Raith Rovers,Queen of the South,2,0,2,W
86336,15,SCO2,2016-03-11,Glasgow Rangers,Greenock Morton,3,1,2,W
86337,15,SCO2,2016-03-12,Alloa Athletic,Raith Rovers,1,1,0,D
86338,15,SCO2,2016-03-12,Dumbarton,Falkirk,1,1,0,D
86339,15,SCO2,2016-03-12,St Mirren,Queen of the South,2,1,1,W
86340,15,SCO2,2016-03-15,Greenock Morton,Queen of the South,3,2,1,W
86341,15,SCO2,2016-03-18,Falkirk,Glasgow Rangers,3,2,1,W
86342,15,SCO2,2016-03-19,Livingston,St Mirren,2,3,-1,L
86343,15,SCO2,2016-03-19,Greenock Morton,Alloa Athletic,4,1,3,W
86344,15,SCO2,2016-03-19,Queen of the South,Dumbarton,6,0,6,W
86345,15,SCO2,2016-03-19,Raith Rovers,Hibernian,2,1,1,W
86346,15,SCO2,2016-03-22,St Mirren,Raith Rovers,1,2,-1,L
86347,15,SCO2,2016-03-26,Alloa Athletic,St Mirren,0,1,-1,L
86348,15,SCO2,2016-03-26,Falkirk,Livingston,1,2,-1,L
86349,15,SCO2,2016-03-26,Greenock Morton,Raith Rovers,0,1,-1,L
86350,15,SCO2,2016-03-26,Glasgow Rangers,Queen of the South,4,3,1,W
86351,15,SCO2,2016-04-02,Dumbarton,Greenock Morton,0,0,0,D
86352,15,SCO2,2016-04-02,Livingston,Alloa Athletic,0,0,0,D
86353,15,SCO2,2016-04-02,Queen of the South,Falkirk,2,2,0,D
86354,15,SCO2,2016-04-02,Raith Rovers,Glasgow Rangers,3,3,0,D
86355,15,SCO2,2016-04-02,St Mirren,Hibernian,2,2,0,D
86356,15,SCO2,2016-04-05,Hibernian,Livingston,2,1,1,W
86357,15,SCO2,2016-04-05,Glasgow Rangers,Dumbarton,1,0,1,W
86358,15,SCO2,2016-04-09,Alloa Athletic,Hibernian,1,0,1,W
86359,15,SCO2,2016-04-09,Falkirk,St Mirren,3,2,1,W
86360,15,SCO2,2016-04-09,Greenock Morton,Livingston,2,1,1,W
86361,15,SCO2,2016-04-09,Queen of the South,Raith Rovers,1,2,-1,L
86362,15,SCO2,2016-04-12,Dumbarton,Queen of the South,4,2,2,W
86363,15,SCO2,2016-04-12,Hibernian,Falkirk,2,2,0,D
86364,15,SCO2,2016-04-16,Alloa Athletic,Queen of the South,2,2,0,D
86365,15,SCO2,2016-04-16,Dumbarton,Raith Rovers,2,3,-1,L
86366,15,SCO2,2016-04-16,St Mirren,Greenock Morton,3,1,2,W
86367,15,SCO2,2016-04-20,Hibernian,Glasgow Rangers,3,2,1,W
86368,15,SCO2,2016-04-23,Dumbarton,St Mirren,2,1,1,W
86369,15,SCO2,2016-04-23,Greenock Morton,Hibernian,0,0,0,D
86370,15,SCO2,2016-04-23,Queen of the South,Livingston,3,1,2,W
86371,15,SCO2,2016-04-23,Raith Rovers,Falkirk,2,2,0,D
86372,15,SCO2,2016-04-23,Glasgow Rangers,Alloa Athletic,1,1,0,D
86373,15,SCO2,2016-04-26,Hibernian,Dumbarton,4,0,4,W
86374,15,SCO2,2016-04-26,Livingston,Glasgow Rangers,1,0,1,W
86375,15,SCO2,2016-05-01,Alloa Athletic,Dumbarton,1,1,0,D
86376,15,SCO2,2016-05-01,Falkirk,Greenock Morton,1,0,1,W
86377,15,SCO2,2016-05-01,Hibernian,Queen of the South,2,0,2,W
86378,15,SCO2,2016-05-01,Livingston,Raith Rovers,0,1,-1,L
86379,15,SCO2,2016-05-01,St Mirren,Glasgow Rangers,2,2,0,D
86380,16,SCO2,2016-08-06,Dundee United,Queen of the South,1,1,0,D
86381,16,SCO2,2016-08-06,Ayr United,Raith Rovers,0,2,-2,L
86382,16,SCO2,2016-08-06,St Mirren,Greenock Morton,1,1,0,D
86383,16,SCO2,2016-08-06,Dunfermline Athletic,Dumbarton,4,3,1,W
86384,16,SCO2,2016-08-06,Falkirk,Hibernian,1,2,-1,L
86385,16,SCO2,2016-08-13,Raith Rovers,St Mirren,3,1,2,W
86386,16,SCO2,2016-08-13,Queen of the South,Ayr United,4,1,3,W
86387,16,SCO2,2016-08-13,Hibernian,Dunfermline Athletic,2,1,1,W
86388,16,SCO2,2016-08-13,Dumbarton,Dundee United,1,0,1,W
86389,16,SCO2,2016-08-13,Greenock Morton,Falkirk,1,1,0,D
86390,16,SCO2,2016-08-20,Queen of the South,Falkirk,2,0,2,W
86391,16,SCO2,2016-08-20,Dundee United,Ayr United,3,0,3,W
86392,16,SCO2,2016-08-20,Greenock Morton,Dumbarton,1,1,0,D
86393,16,SCO2,2016-08-20,St Mirren,Hibernian,0,2,-2,L
86394,16,SCO2,2016-08-20,Raith Rovers,Dunfermline Athletic,2,0,2,W
86395,16,SCO2,2016-08-27,Hibernian,Greenock Morton,4,0,4,W
86396,16,SCO2,2016-08-27,Falkirk,Dumbarton,1,0,1,W
86397,16,SCO2,2016-08-27,Ayr United,St Mirren,1,1,0,D
86398,16,SCO2,2016-08-27,Dunfermline Athletic,Queen of the South,0,1,-1,L
86399,16,SCO2,2016-08-27,Dundee United,Raith Rovers,2,2,0,D
86400,16,SCO2,2016-09-10,Ayr United,Greenock Morton,2,1,1,W
86401,16,SCO2,2016-09-10,Raith Rovers,Falkirk,0,2,-2,L
86402,16,SCO2,2016-09-10,Dunfermline Athletic,Dundee United,1,3,-2,L
86403,16,SCO2,2016-09-10,Dumbarton,Hibernian,0,1,-1,L
86404,16,SCO2,2016-09-10,St Mirren,Queen of the South,1,3,-2,L
86405,16,SCO2,2016-09-17,Dumbarton,St Mirren,1,1,0,D
86406,16,SCO2,2016-09-17,Greenock Morton,Dunfermline Athletic,2,1,1,W
86407,16,SCO2,2016-09-17,Queen of the South,Raith Rovers,3,1,2,W
86408,16,SCO2,2016-09-17,Hibernian,Ayr United,1,2,-1,L
86409,16,SCO2,2016-09-17,Falkirk,Dundee United,3,1,2,W
86410,16,SCO2,2016-09-24,Dundee United,Greenock Morton,2,1,1,W
86411,16,SCO2,2016-09-24,Falkirk,Ayr United,2,0,2,W
86412,16,SCO2,2016-09-24,Queen of the South,Hibernian,0,0,0,D
86413,16,SCO2,2016-09-24,Raith Rovers,Dumbarton,3,2,1,W
86414,16,SCO2,2016-09-24,Dunfermline Athletic,St Mirren,4,3,1,W
86415,16,SCO2,2016-10-01,Ayr United,Dunfermline Athletic,0,0,0,D
86416,16,SCO2,2016-10-01,Dumbarton,Queen of the South,0,0,0,D
86417,16,SCO2,2016-10-01,Greenock Morton,Raith Rovers,1,0,1,W
86418,16,SCO2,2016-10-01,St Mirren,Falkirk,1,1,0,D
86419,16,SCO2,2016-10-02,Hibernian,Dundee United,1,1,0,D
86420,16,SCO2,2016-10-15,St Mirren,Dundee United,0,2,-2,L
86421,16,SCO2,2016-10-15,Dumbarton,Ayr United,0,3,-3,L
86422,16,SCO2,2016-10-15,Falkirk,Dunfermline Athletic,2,1,1,W
86423,16,SCO2,2016-10-15,Queen of the South,Greenock Morton,0,5,-5,L
86424,16,SCO2,2016-10-15,Raith Rovers,Hibernian,0,0,0,D
86425,16,SCO2,2016-10-22,Ayr United,Queen of the South,1,0,1,W
86426,16,SCO2,2016-10-22,Dundee United,Dumbarton,2,1,1,W
86427,16,SCO2,2016-10-22,Dunfermline Athletic,Hibernian,1,3,-2,L
86428,16,SCO2,2016-10-22,Falkirk,Raith Rovers,2,4,-2,L
86429,16,SCO2,2016-10-29,Greenock Morton,Ayr United,2,1,1,W
86430,16,SCO2,2016-10-29,Hibernian,St Mirren,2,0,2,W
86431,16,SCO2,2016-10-29,Dumbarton,Dunfermline Athletic,2,2,0,D
86432,16,SCO2,2016-10-29,Dundee United,Falkirk,1,0,1,W
86433,16,SCO2,2016-10-29,Raith Rovers,Queen of the South,1,0,1,W
86434,16,SCO2,2016-11-01,Greenock Morton,St Mirren,3,1,2,W
86435,16,SCO2,2016-11-05,Queen of the South,Dundee United,1,4,-3,L
86436,16,SCO2,2016-11-05,Falkirk,Greenock Morton,1,1,0,D
86437,16,SCO2,2016-11-05,St Mirren,Dumbarton,0,1,-1,L
86438,16,SCO2,2016-11-05,Ayr United,Hibernian,0,3,-3,L
86439,16,SCO2,2016-11-05,Dunfermline Athletic,Raith Rovers,0,0,0,D
86440,16,SCO2,2016-11-08,Dundee United,Dunfermline Athletic,1,0,1,W
86441,16,SCO2,2016-11-12,Hibernian,Falkirk,1,1,0,D
86442,16,SCO2,2016-11-12,Dumbarton,Greenock Morton,0,2,-2,L
86443,16,SCO2,2016-11-19,Ayr United,Falkirk,0,1,-1,L
86444,16,SCO2,2016-11-19,Dumbarton,Raith Rovers,0,0,0,D
86445,16,SCO2,2016-11-19,Hibernian,Queen of the South,4,0,4,W
86446,16,SCO2,2016-11-19,Greenock Morton,Dundee United,0,0,0,D
86447,16,SCO2,2016-11-19,St Mirren,Dunfermline Athletic,0,1,-1,L
86448,16,SCO2,2016-11-22,Raith Rovers,Ayr United,1,1,0,D
86449,16,SCO2,2016-12-02,Dundee United,Hibernian,1,0,1,W
86450,16,SCO2,2016-12-03,Falkirk,St Mirren,3,1,2,W
86451,16,SCO2,2016-12-03,Dunfermline Athletic,Ayr United,1,1,0,D
86452,16,SCO2,2016-12-03,Queen of the South,Dumbarton,1,2,-1,L
86453,16,SCO2,2016-12-06,Queen of the South,St Mirren,2,3,-1,L
86454,16,SCO2,2016-12-10,St Mirren,Raith Rovers,1,0,1,W
86455,16,SCO2,2016-12-10,Ayr United,Dundee United,0,1,-1,L
86456,16,SCO2,2016-12-10,Dunfermline Athletic,Greenock Morton,2,1,1,W
86457,16,SCO2,2016-12-10,Falkirk,Queen of the South,2,2,0,D
86458,16,SCO2,2016-12-10,Hibernian,Dumbarton,2,0,2,W
86459,16,SCO2,2016-12-17,Queen of the South,Dunfermline Athletic,2,2,0,D
86460,16,SCO2,2016-12-17,Dumbarton,Falkirk,2,1,1,W
86461,16,SCO2,2016-12-17,St Mirren,Ayr United,1,1,0,D
86462,16,SCO2,2016-12-17,Raith Rovers,Dundee United,0,0,0,D
86463,16,SCO2,2016-12-17,Greenock Morton,Hibernian,1,1,0,D
86464,16,SCO2,2016-12-24,Ayr United,Dumbarton,4,4,0,D
86465,16,SCO2,2016-12-24,Dundee United,St Mirren,2,1,1,W
86466,16,SCO2,2016-12-24,Hibernian,Raith Rovers,1,1,0,D
86467,16,SCO2,2016-12-24,Greenock Morton,Queen of the South,1,0,1,W
86468,16,SCO2,2016-12-26,Dunfermline Athletic,Falkirk,1,1,0,D
86469,16,SCO2,2016-12-31,Falkirk,Hibernian,1,2,-1,L
86470,16,SCO2,2016-12-31,Dumbarton,Dundee United,1,0,1,W
86471,16,SCO2,2016-12-31,Queen of the South,Ayr United,0,0,0,D
86472,16,SCO2,2016-12-31,St Mirren,Greenock Morton,1,1,0,D
86473,16,SCO2,2017-01-02,Raith Rovers,Dunfermline Athletic,0,2,-2,L
86474,16,SCO2,2017-01-06,Hibernian,Dundee United,3,0,3,W
86475,16,SCO2,2017-01-07,Greenock Morton,Dumbarton,2,1,1,W
86476,16,SCO2,2017-01-07,St Mirren,Queen of the South,0,3,-3,L
86477,16,SCO2,2017-01-07,Ayr United,Dunfermline Athletic,0,2,-2,L
86478,16,SCO2,2017-01-07,Raith Rovers,Falkirk,1,4,-3,L
86479,16,SCO2,2017-01-14,Dumbarton,Hibernian,0,1,-1,L
86480,16,SCO2,2017-01-14,Dundee United,Queen of the South,3,3,0,D
86481,16,SCO2,2017-01-14,Dunfermline Athletic,St Mirren,1,1,0,D
86482,16,SCO2,2017-01-14,Falkirk,Ayr United,1,1,0,D
86483,16,SCO2,2017-01-14,Greenock Morton,Raith Rovers,2,0,2,W
86484,16,SCO2,2017-01-21,Dumbarton,Queen of the South,1,2,-1,L
86485,16,SCO2,2017-01-28,St Mirren,Falkirk,1,2,-1,L
86486,16,SCO2,2017-01-28,Dunfermline Athletic,Dundee United,1,1,0,D
86487,16,SCO2,2017-01-28,Queen of the South,Hibernian,0,1,-1,L
86488,16,SCO2,2017-01-28,Raith Rovers,Dumbarton,1,3,-2,L
86489,16,SCO2,2017-01-28,Ayr United,Greenock Morton,1,4,-3,L
86490,16,SCO2,2017-02-04,Dumbarton,St Mirren,2,2,0,D
86491,16,SCO2,2017-02-04,Falkirk,Dunfermline Athletic,2,0,2,W
86492,16,SCO2,2017-02-04,Hibernian,Ayr United,1,1,0,D
86493,16,SCO2,2017-02-04,Queen of the South,Greenock Morton,3,0,3,W
86494,16,SCO2,2017-02-04,Dundee United,Raith Rovers,3,0,3,W
86495,16,SCO2,2017-02-07,Raith Rovers,Greenock Morton,0,1,-1,L
86496,16,SCO2,2017-02-11,Falkirk,Dundee United,3,0,3,W
86497,16,SCO2,2017-02-18,Greenock Morton,Falkirk,2,2,0,D
86498,16,SCO2,2017-02-18,Dumbarton,Ayr United,2,2,0,D
86499,16,SCO2,2017-02-18,Raith Rovers,Hibernian,1,1,0,D
86500,16,SCO2,2017-02-25,Falkirk,Dumbarton,2,2,0,D
86501,16,SCO2,2017-02-25,Ayr United,St Mirren,0,2,-2,L
86502,16,SCO2,2017-02-25,Dundee United,Greenock Morton,1,1,0,D
86503,16,SCO2,2017-02-25,Queen of the South,Raith Rovers,2,1,1,W
86504,16,SCO2,2017-02-25,Hibernian,Dunfermline Athletic,2,2,0,D
86505,16,SCO2,2017-02-28,Ayr United,Raith Rovers,1,0,1,W
86506,16,SCO2,2017-03-01,St Mirren,Hibernian,2,0,2,W
86507,16,SCO2,2017-03-04,Dunfermline Athletic,Dumbarton,5,1,4,W
86508,16,SCO2,2017-03-04,Queen of the South,Falkirk,0,2,-2,L
86509,16,SCO2,2017-03-07,Dunfermline Athletic,Queen of the South,1,1,0,D
86510,16,SCO2,2017-03-08,Raith Rovers,St Mirren,2,0,2,W
86511,16,SCO2,2017-03-10,Dundee United,Hibernian,0,1,-1,L
86512,16,SCO2,2017-03-11,St Mirren,Dunfermline Athletic,0,0,0,D
86513,16,SCO2,2017-03-11,Ayr United,Falkirk,1,4,-3,L
86514,16,SCO2,2017-03-11,Dumbarton,Raith Rovers,4,0,4,W
86515,16,SCO2,2017-03-11,Greenock Morton,Queen of the South,1,0,1,W
86516,16,SCO2,2017-03-15,St Mirren,Dundee United,3,2,1,W
86517,16,SCO2,2017-03-18,Dunfermline Athletic,Ayr United,0,1,-1,L
86518,16,SCO2,2017-03-18,Hibernian,Dumbarton,2,2,0,D
86519,16,SCO2,2017-03-18,Queen of the South,St Mirren,0,2,-2,L
86520,16,SCO2,2017-03-18,Raith Rovers,Dundee United,2,1,1,W
86521,16,SCO2,2017-03-18,Falkirk,Greenock Morton,0,1,-1,L
86522,16,SCO2,2017-03-25,Greenock Morton,Dunfermline Athletic,0,1,-1,L
86523,16,SCO2,2017-03-25,Hibernian,Falkirk,2,1,1,W
86524,16,SCO2,2017-03-25,Ayr United,Dumbarton,2,1,1,W
86525,16,SCO2,2017-03-25,Raith Rovers,Queen of the South,1,1,0,D
86526,16,SCO2,2017-03-28,Dundee United,Ayr United,2,1,1,W
86527,16,SCO2,2017-03-29,Hibernian,Greenock Morton,0,0,0,D
86528,16,SCO2,2017-04-01,Dunfermline Athletic,Hibernian,1,1,0,D
86529,16,SCO2,2017-04-01,Dumbarton,Greenock Morton,1,0,1,W
86530,16,SCO2,2017-04-01,St Mirren,Ayr United,6,2,4,W
86531,16,SCO2,2017-04-01,Falkirk,Raith Rovers,1,0,1,W
86532,16,SCO2,2017-04-01,Queen of the South,Dundee United,4,2,2,W
86533,16,SCO2,2017-04-08,Greenock Morton,Hibernian,1,1,0,D
86534,16,SCO2,2017-04-08,St Mirren,Dumbarton,1,1,0,D
86535,16,SCO2,2017-04-08,Ayr United,Queen of the South,0,2,-2,L
86536,16,SCO2,2017-04-08,Dundee United,Falkirk,1,1,0,D
86537,16,SCO2,2017-04-08,Dunfermline Athletic,Raith Rovers,1,0,1,W
86538,16,SCO2,2017-04-11,Greenock Morton,St Mirren,1,4,-3,L
86539,16,SCO2,2017-04-11,Dundee United,Dunfermline Athletic,1,0,1,W
86540,16,SCO2,2017-04-15,Hibernian,Queen of the South,3,0,3,W
86541,16,SCO2,2017-04-15,Falkirk,St Mirren,2,2,0,D
86542,16,SCO2,2017-04-15,Dumbarton,Dunfermline Athletic,0,2,-2,L
86543,16,SCO2,2017-04-15,Raith Rovers,Greenock Morton,2,0,2,W
86544,16,SCO2,2017-04-15,Ayr United,Dundee United,0,0,0,D
86545,16,SCO2,2017-04-22,Dundee United,St Mirren,3,2,1,W
86546,16,SCO2,2017-04-22,Dunfermline Athletic,Falkirk,1,2,-1,L
86547,16,SCO2,2017-04-22,Queen of the South,Dumbarton,1,2,-1,L
86548,16,SCO2,2017-04-22,Greenock Morton,Ayr United,1,1,0,D
86549,16,SCO2,2017-04-26,Hibernian,Raith Rovers,3,2,1,W
86550,16,SCO2,2017-04-29,St Mirren,Raith Rovers,5,0,5,W
86551,16,SCO2,2017-04-29,Ayr United,Hibernian,0,4,-4,L
86552,16,SCO2,2017-04-29,Dunfermline Athletic,Greenock Morton,3,1,2,W
86553,16,SCO2,2017-04-29,Falkirk,Queen of the South,2,2,0,D
86554,16,SCO2,2017-04-29,Dundee United,Dumbarton,2,2,0,D
86555,16,SCO2,2017-05-06,Hibernian,St Mirren,1,1,0,D
86556,16,SCO2,2017-05-06,Dumbarton,Falkirk,0,1,-1,L
86557,16,SCO2,2017-05-06,Greenock Morton,Dundee United,1,1,0,D
86558,16,SCO2,2017-05-06,Queen of the South,Dunfermline Athletic,0,1,-1,L
86559,16,SCO2,2017-05-06,Raith Rovers,Ayr United,2,1,1,W
86560,17,SCO2,2017-08-05,Dumbarton,Greenock Morton,0,0,0,D
86561,17,SCO2,2017-08-05,Inverness CT,Dundee United,0,1,-1,L
86562,17,SCO2,2017-08-05,Livingston,Dunfermline Athletic,1,1,0,D
86563,17,SCO2,2017-08-05,Queen of the South,Brechin City,4,1,3,W
86564,17,SCO2,2017-08-05,St Mirren,Falkirk,3,1,2,W
86565,17,SCO2,2017-08-12,Brechin City,Livingston,2,2,0,D
86566,17,SCO2,2017-08-12,Dundee United,Queen of the South,2,1,1,W
86567,17,SCO2,2017-08-12,Dunfermline Athletic,Inverness CT,5,1,4,W
86568,17,SCO2,2017-08-12,Falkirk,Dumbarton,1,1,0,D
86569,17,SCO2,2017-08-12,Greenock Morton,St Mirren,4,1,3,W
86570,17,SCO2,2017-08-19,Dundee United,Brechin City,1,0,1,W
86571,17,SCO2,2017-08-19,Dunfermline Athletic,Falkirk,3,1,2,W
86572,17,SCO2,2017-08-19,Inverness CT,Greenock Morton,1,1,0,D
86573,17,SCO2,2017-08-19,Livingston,St Mirren,1,3,-2,L
86574,17,SCO2,2017-08-19,Queen of the South,Dumbarton,1,0,1,W
86575,17,SCO2,2017-08-26,Brechin City,Inverness CT,0,4,-4,L
86576,17,SCO2,2017-08-26,Dumbarton,Dunfermline Athletic,0,4,-4,L
86577,17,SCO2,2017-08-26,Falkirk,Queen of the South,1,4,-3,L
86578,17,SCO2,2017-08-26,Greenock Morton,Livingston,0,1,-1,L
86579,17,SCO2,2017-08-26,St Mirren,Dundee United,3,0,3,W
86580,17,SCO2,2017-09-09,Brechin City,Falkirk,1,1,0,D
86581,17,SCO2,2017-09-09,Dundee United,Dumbarton,1,1,0,D
86582,17,SCO2,2017-09-09,Livingston,Queen of the South,2,2,0,D
86583,17,SCO2,2017-09-09,Greenock Morton,Dunfermline Athletic,3,2,1,W
86584,17,SCO2,2017-09-09,St Mirren,Inverness CT,4,2,2,W
86585,17,SCO2,2017-09-16,Dumbarton,Brechin City,2,1,1,W
86586,17,SCO2,2017-09-16,Dunfermline Athletic,St Mirren,3,0,3,W
86587,17,SCO2,2017-09-16,Falkirk,Dundee United,0,0,0,D
86588,17,SCO2,2017-09-16,Inverness CT,Livingston,1,3,-2,L
86589,17,SCO2,2017-09-16,Queen of the South,Greenock Morton,1,2,-1,L
86590,17,SCO2,2017-09-23,Brechin City,Dunfermline Athletic,0,3,-3,L
86591,17,SCO2,2017-09-23,Dumbarton,Inverness CT,2,1,1,W
86592,17,SCO2,2017-09-23,Dundee United,Greenock Morton,2,1,1,W
86593,17,SCO2,2017-09-23,Falkirk,Livingston,0,2,-2,L
86594,17,SCO2,2017-09-24,St Mirren,Queen of the South,3,1,2,W
86595,17,SCO2,2017-09-30,Dunfermline Athletic,Dundee United,1,3,-2,L
86596,17,SCO2,2017-09-30,Inverness CT,Queen of the South,0,0,0,D
86597,17,SCO2,2017-09-30,Livingston,Dumbarton,2,1,1,W
86598,17,SCO2,2017-09-30,Greenock Morton,Falkirk,0,1,-1,L
86599,17,SCO2,2017-09-30,St Mirren,Brechin City,2,1,1,W
86600,17,SCO2,2017-10-14,Brechin City,Greenock Morton,0,1,-1,L
86601,17,SCO2,2017-10-14,Dumbarton,St Mirren,0,2,-2,L
86602,17,SCO2,2017-10-14,Falkirk,Inverness CT,0,0,0,D
86603,17,SCO2,2017-10-14,Livingston,Dundee United,2,0,2,W
86604,17,SCO2,2017-10-14,Queen of the South,Dunfermline Athletic,0,0,0,D
86605,17,SCO2,2017-10-21,Brechin City,Queen of the South,0,1,-1,L
86606,17,SCO2,2017-10-21,Dundee United,Inverness CT,0,2,-2,L
86607,17,SCO2,2017-10-21,Dunfermline Athletic,Livingston,3,1,2,W
86608,17,SCO2,2017-10-21,Falkirk,St Mirren,0,0,0,D
86609,17,SCO2,2017-10-21,Greenock Morton,Dumbarton,1,1,0,D
86610,17,SCO2,2017-10-28,Dumbarton,Dundee United,0,2,-2,L
86611,17,SCO2,2017-10-28,Inverness CT,Dunfermline Athletic,1,0,1,W
86612,17,SCO2,2017-10-28,Livingston,Brechin City,3,2,1,W
86613,17,SCO2,2017-10-28,Queen of the South,Falkirk,4,2,2,W
86614,17,SCO2,2017-10-28,St Mirren,Greenock Morton,2,2,0,D
86615,17,SCO2,2017-11-04,Brechin City,Dumbarton,0,1,-1,L
86616,17,SCO2,2017-11-04,Dundee United,St Mirren,2,1,1,W
86617,17,SCO2,2017-11-04,Falkirk,Dunfermline Athletic,1,1,0,D
86618,17,SCO2,2017-11-04,Livingston,Inverness CT,0,0,0,D
86619,17,SCO2,2017-11-04,Greenock Morton,Queen of the South,1,2,-1,L
86620,17,SCO2,2017-11-19,Dundee United,Falkirk,3,0,3,W
86621,17,SCO2,2017-11-21,Dunfermline Athletic,Greenock Morton,1,1,0,D
86622,17,SCO2,2017-11-25,Brechin City,Dundee United,1,1,0,D
86623,17,SCO2,2017-11-25,Dunfermline Athletic,Dumbarton,2,2,0,D
86624,17,SCO2,2017-11-25,Falkirk,Greenock Morton,0,3,-3,L
86625,17,SCO2,2017-11-25,Inverness CT,St Mirren,0,2,-2,L
86626,17,SCO2,2017-11-25,Queen of the South,Livingston,0,3,-3,L
86627,17,SCO2,2017-11-28,Dumbarton,Queen of the South,2,2,0,D
86628,17,SCO2,2017-11-28,Inverness CT,Brechin City,4,0,4,W
86629,17,SCO2,2017-11-28,St Mirren,Livingston,3,1,2,W
86630,17,SCO2,2017-12-02,Dundee United,Dunfermline Athletic,2,1,1,W
86631,17,SCO2,2017-12-02,Greenock Morton,Brechin City,4,1,3,W
86632,17,SCO2,2017-12-02,Queen of the South,Inverness CT,0,0,0,D
86633,17,SCO2,2017-12-02,St Mirren,Dumbarton,0,1,-1,L
86634,17,SCO2,2017-12-09,Brechin City,St Mirren,1,2,-1,L
86635,17,SCO2,2017-12-09,Dunfermline Athletic,Queen of the South,2,5,-3,L
86636,17,SCO2,2017-12-09,Greenock Morton,Dundee United,0,2,-2,L
86637,17,SCO2,2017-12-16,Inverness CT,Dumbarton,1,0,1,W
86638,17,SCO2,2017-12-16,St Mirren,Dunfermline Athletic,1,0,1,W
86639,17,SCO2,2017-12-19,Livingston,Falkirk,0,0,0,D
86640,17,SCO2,2017-12-23,Dumbarton,Falkirk,0,0,0,D
86641,17,SCO2,2017-12-23,Dundee United,Livingston,3,0,3,W
86642,17,SCO2,2017-12-23,Dunfermline Athletic,Brechin City,2,1,1,W
86643,17,SCO2,2017-12-23,Greenock Morton,Inverness CT,1,0,1,W
86644,17,SCO2,2017-12-23,Queen of the South,St Mirren,2,3,-1,L
86645,17,SCO2,2017-12-26,Dumbarton,Livingston,1,4,-3,L
86646,17,SCO2,2017-12-29,St Mirren,Dundee United,2,0,2,W
86647,17,SCO2,2017-12-30,Brechin City,Inverness CT,2,3,-1,L
86648,17,SCO2,2017-12-30,Falkirk,Queen of the South,3,2,1,W
86649,17,SCO2,2018-01-02,Dundee United,Brechin City,4,1,3,W
86650,17,SCO2,2018-01-02,Dunfermline Athletic,Falkirk,2,0,2,W
86651,17,SCO2,2018-01-02,Inverness CT,Livingston,1,1,0,D
86652,17,SCO2,2018-01-02,Greenock Morton,St Mirren,1,1,0,D
86653,17,SCO2,2018-01-02,Queen of the South,Dumbarton,0,0,0,D
86654,17,SCO2,2018-01-06,Brechin City,Greenock Morton,1,1,0,D
86655,17,SCO2,2018-01-06,Dumbarton,Dunfermline Athletic,0,1,-1,L
86656,17,SCO2,2018-01-06,Falkirk,Dundee United,6,1,5,W
86657,17,SCO2,2018-01-06,Livingston,Queen of the South,0,1,-1,L
86658,17,SCO2,2018-01-06,St Mirren,Inverness CT,1,0,1,W
86659,17,SCO2,2018-01-09,Inverness CT,Falkirk,4,1,3,W
86660,17,SCO2,2018-01-13,Brechin City,Livingston,0,2,-2,L
86661,17,SCO2,2018-01-13,Dumbarton,St Mirren,0,2,-2,L
86662,17,SCO2,2018-01-13,Dunfermline Athletic,Dundee United,0,0,0,D
86663,17,SCO2,2018-01-13,Inverness CT,Queen of the South,3,1,2,W
86664,17,SCO2,2018-01-13,Greenock Morton,Falkirk,0,1,-1,L
86665,17,SCO2,2018-01-26,Dunfermline Athletic,St Mirren,1,2,-1,L
86666,17,SCO2,2018-01-27,Dundee United,Greenock Morton,0,3,-3,L
86667,17,SCO2,2018-01-27,Falkirk,Inverness CT,3,1,2,W
86668,17,SCO2,2018-01-27,Livingston,Dumbarton,2,0,2,W
86669,17,SCO2,2018-01-27,Queen of the South,Brechin City,3,1,2,W
86670,17,SCO2,2018-02-03,Falkirk,Livingston,1,3,-2,L
86671,17,SCO2,2018-02-03,Greenock Morton,Dunfermline Athletic,2,1,1,W
86672,17,SCO2,2018-02-03,St Mirren,Queen of the South,2,0,2,W
86673,17,SCO2,2018-02-06,Falkirk,Brechin City,3,1,2,W
86674,17,SCO2,2018-02-10,Livingston,Dunfermline Athletic,0,0,0,D
86675,17,SCO2,2018-02-17,Brechin City,Falkirk,0,1,-1,L
86676,17,SCO2,2018-02-17,Livingston,St Mirren,4,1,3,W
86677,17,SCO2,2018-02-17,Queen of the South,Greenock Morton,1,1,0,D
86678,17,SCO2,2018-02-20,Dumbarton,Greenock Morton,0,1,-1,L
86679,17,SCO2,2018-02-23,Livingston,Dundee United,2,1,1,W
86680,17,SCO2,2018-02-24,Falkirk,Dumbarton,0,0,0,D
86681,17,SCO2,2018-02-24,Inverness CT,Greenock Morton,0,2,-2,L
86682,17,SCO2,2018-02-24,Queen of the South,Dunfermline Athletic,0,0,0,D
86683,17,SCO2,2018-02-24,St Mirren,Brechin City,1,0,1,W
86684,17,SCO2,2018-02-27,Greenock Morton,Livingston,0,1,-1,L
86685,17,SCO2,2018-03-10,Dumbarton,Queen of the South,0,1,-1,L
86686,17,SCO2,2018-03-10,Falkirk,Greenock Morton,3,1,2,W
86687,17,SCO2,2018-03-10,St Mirren,Dunfermline Athletic,2,0,2,W
86688,17,SCO2,2018-03-13,Livingston,Greenock Morton,1,1,0,D
86689,17,SCO2,2018-03-13,Queen of the South,Dundee United,1,3,-2,L
86690,17,SCO2,2018-03-13,Dumbarton,Brechin City,1,0,1,W
86691,17,SCO2,2018-03-13,Dunfermline Athletic,Inverness CT,1,0,1,W
86692,17,SCO2,2018-03-17,Brechin City,Dumbarton,1,3,-2,L
86693,17,SCO2,2018-03-17,Dundee United,Inverness CT,1,1,0,D
86694,17,SCO2,2018-03-17,Dunfermline Athletic,Greenock Morton,0,0,0,D
86695,17,SCO2,2018-03-17,Livingston,Falkirk,0,0,0,D
86696,17,SCO2,2018-03-17,Queen of the South,St Mirren,1,3,-2,L
86697,17,SCO2,2018-03-20,Brechin City,Dunfermline Athletic,0,3,-3,L
86698,17,SCO2,2018-03-20,Dundee United,Queen of the South,2,3,-1,L
86699,17,SCO2,2018-03-24,Dundee United,Dunfermline Athletic,1,1,0,D
86700,17,SCO2,2018-03-24,Greenock Morton,Brechin City,2,0,2,W
86701,17,SCO2,2018-03-24,Queen of the South,Livingston,3,3,0,D
86702,17,SCO2,2018-03-27,Inverness CT,Dundee United,1,0,1,W
86703,17,SCO2,2018-03-27,St Mirren,Dumbarton,5,0,5,W
86704,17,SCO2,2018-03-31,Dumbarton,Livingston,0,3,-3,L
86705,17,SCO2,2018-03-31,Dunfermline Athletic,Queen of the South,3,1,2,W
86706,17,SCO2,2018-03-31,Falkirk,Brechin City,3,0,3,W
86707,17,SCO2,2018-03-31,Inverness CT,St Mirren,2,2,0,D
86708,17,SCO2,2018-03-31,Greenock Morton,Dundee United,1,1,0,D
86709,17,SCO2,2018-04-03,Dundee United,Dumbarton,2,0,2,W
86710,17,SCO2,2018-04-03,Dunfermline Athletic,Livingston,1,0,1,W
86711,17,SCO2,2018-04-03,Inverness CT,Brechin City,4,0,4,W
86712,17,SCO2,2018-04-03,Queen of the South,Falkirk,2,2,0,D
86713,17,SCO2,2018-04-07,Brechin City,St Mirren,0,1,-1,L
86714,17,SCO2,2018-04-07,Dumbarton,Dundee United,3,2,1,W
86715,17,SCO2,2018-04-07,Falkirk,Dunfermline Athletic,1,2,-1,L
86716,17,SCO2,2018-04-07,Livingston,Greenock Morton,3,2,1,W
86717,17,SCO2,2018-04-07,Queen of the South,Inverness CT,0,2,-2,L
86718,17,SCO2,2018-04-10,Dundee United,St Mirren,1,0,1,W
86719,17,SCO2,2018-04-10,Greenock Morton,Dumbarton,3,2,1,W
86720,17,SCO2,2018-04-10,Inverness CT,Falkirk,1,0,1,W
86721,17,SCO2,2018-04-14,Dundee United,Falkirk,1,0,1,W
86722,17,SCO2,2018-04-14,Dunfermline Athletic,Brechin City,4,0,4,W
86723,17,SCO2,2018-04-14,Inverness CT,Dumbarton,5,1,4,W
86724,17,SCO2,2018-04-14,Greenock Morton,Queen of the South,0,1,-1,L
86725,17,SCO2,2018-04-14,St Mirren,Livingston,0,0,0,D
86726,17,SCO2,2018-04-17,St Mirren,Falkirk,1,2,-1,L
86727,17,SCO2,2018-04-17,Brechin City,Dundee United,0,5,-5,L
86728,17,SCO2,2018-04-18,Dumbarton,Inverness CT,0,1,-1,L
86729,17,SCO2,2018-04-21,Dumbarton,Falkirk,2,5,-3,L
86730,17,SCO2,2018-04-21,Inverness CT,Dunfermline Athletic,2,2,0,D
86731,17,SCO2,2018-04-21,Livingston,Brechin City,3,0,3,W
86732,17,SCO2,2018-04-21,Queen of the South,Dundee United,3,0,3,W
86733,17,SCO2,2018-04-21,St Mirren,Greenock Morton,2,1,1,W
86734,17,SCO2,2018-04-24,Livingston,Inverness CT,0,1,-1,L
86735,17,SCO2,2018-04-28,Brechin City,Queen of the South,1,5,-4,L
86736,17,SCO2,2018-04-28,Dundee United,Livingston,2,0,2,W
86737,17,SCO2,2018-04-28,Dunfermline Athletic,Dumbarton,4,0,4,W
86738,17,SCO2,2018-04-28,Falkirk,St Mirren,1,0,1,W
86739,17,SCO2,2018-04-28,Greenock Morton,Inverness CT,0,3,-3,L
86740,18,SCO2,2018-08-04,Ayr United,Partick Thistle,2,0,2,W
86741,18,SCO2,2018-08-04,Dundee United,Dunfermline Athletic,2,3,-1,L
86742,18,SCO2,2018-08-04,Falkirk,Inverness CT,0,1,-1,L
86743,18,SCO2,2018-08-04,Greenock Morton,Queen of the South,2,2,0,D
86744,18,SCO2,2018-08-04,Ross County,Alloa Athletic,1,0,1,W
86745,18,SCO2,2018-08-11,Alloa Athletic,Greenock Morton,0,2,-2,L
86746,18,SCO2,2018-08-11,Dunfermline Athletic,Ross County,1,3,-2,L
86747,18,SCO2,2018-08-11,Inverness CT,Ayr United,0,0,0,D
86748,18,SCO2,2018-08-11,Partick Thistle,Falkirk,2,1,1,W
86749,18,SCO2,2018-08-11,Queen of the South,Dundee United,1,2,-1,L
86750,18,SCO2,2018-08-25,Ayr United,Dunfermline Athletic,4,1,3,W
86751,18,SCO2,2018-08-25,Dundee United,Partick Thistle,3,1,2,W
86752,18,SCO2,2018-08-25,Falkirk,Queen of the South,0,3,-3,L
86753,18,SCO2,2018-08-25,Inverness CT,Alloa Athletic,2,2,0,D
86754,18,SCO2,2018-08-25,Greenock Morton,Ross County,2,1,1,W
86755,18,SCO2,2018-09-01,Alloa Athletic,Dundee United,1,1,0,D
86756,18,SCO2,2018-09-01,Dunfermline Athletic,Inverness CT,0,3,-3,L
86757,18,SCO2,2018-09-01,Partick Thistle,Greenock Morton,1,0,1,W
86758,18,SCO2,2018-09-01,Queen of the South,Ayr United,5,0,5,W
86759,18,SCO2,2018-09-01,Ross County,Falkirk,2,0,2,W
86760,18,SCO2,2018-09-15,Ayr United,Falkirk,3,2,1,W
86761,18,SCO2,2018-09-15,Dundee United,Greenock Morton,1,1,0,D
86762,18,SCO2,2018-09-15,Dunfermline Athletic,Alloa Athletic,0,0,0,D
86763,18,SCO2,2018-09-15,Inverness CT,Partick Thistle,3,2,1,W
86764,18,SCO2,2018-09-15,Queen of the South,Ross County,0,0,0,D
86765,18,SCO2,2018-09-22,Alloa Athletic,Ayr United,0,2,-2,L
86766,18,SCO2,2018-09-22,Falkirk,Dundee United,0,2,-2,L
86767,18,SCO2,2018-09-22,Greenock Morton,Dunfermline Athletic,1,1,0,D
86768,18,SCO2,2018-09-22,Partick Thistle,Queen of the South,3,2,1,W
86769,18,SCO2,2018-09-22,Ross County,Inverness CT,0,0,0,D
86770,18,SCO2,2018-09-28,Dunfermline Athletic,Partick Thistle,1,0,1,W
86771,18,SCO2,2018-09-29,Alloa Athletic,Falkirk,0,2,-2,L
86772,18,SCO2,2018-09-29,Dundee United,Ross County,1,5,-4,L
86773,18,SCO2,2018-09-29,Inverness CT,Queen of the South,0,0,0,D
86774,18,SCO2,2018-09-29,Greenock Morton,Ayr United,1,5,-4,L
86775,18,SCO2,2018-10-06,Ayr United,Dundee United,2,0,2,W
86776,18,SCO2,2018-10-06,Falkirk,Dunfermline Athletic,0,2,-2,L
86777,18,SCO2,2018-10-06,Inverness CT,Greenock Morton,1,1,0,D
86778,18,SCO2,2018-10-06,Partick Thistle,Ross County,0,2,-2,L
86779,18,SCO2,2018-10-06,Queen of the South,Alloa Athletic,3,3,0,D
86780,18,SCO2,2018-10-13,Partick Thistle,Dundee United,1,2,-1,L
86781,18,SCO2,2018-10-20,Alloa Athletic,Partick Thistle,1,0,1,W
86782,18,SCO2,2018-10-20,Dundee United,Inverness CT,1,1,0,D
86783,18,SCO2,2018-10-20,Dunfermline Athletic,Queen of the South,0,1,-1,L
86784,18,SCO2,2018-10-20,Greenock Morton,Falkirk,1,0,1,W
86785,18,SCO2,2018-10-20,Ross County,Ayr United,2,1,1,W
86786,18,SCO2,2018-10-27,Alloa Athletic,Inverness CT,0,0,0,D
86787,18,SCO2,2018-10-27,Dunfermline Athletic,Dundee United,0,2,-2,L
86788,18,SCO2,2018-10-27,Partick Thistle,Ayr United,0,1,-1,L
86789,18,SCO2,2018-10-27,Queen of the South,Falkirk,2,0,2,W
86790,18,SCO2,2018-10-27,Ross County,Greenock Morton,5,0,5,W
86791,18,SCO2,2018-10-30,Ayr United,Alloa Athletic,3,0,3,W
86792,18,SCO2,2018-10-30,Falkirk,Ross County,1,1,0,D
86793,18,SCO2,2018-10-30,Inverness CT,Dunfermline Athletic,2,2,0,D
86794,18,SCO2,2018-10-30,Queen of the South,Greenock Morton,1,2,-1,L
86795,18,SCO2,2018-11-03,Alloa Athletic,Dunfermline Athletic,0,1,-1,L
86796,18,SCO2,2018-11-03,Dundee United,Queen of the South,2,0,2,W
86797,18,SCO2,2018-11-03,Falkirk,Ayr United,0,1,-1,L
86798,18,SCO2,2018-11-03,Inverness CT,Ross County,2,2,0,D
86799,18,SCO2,2018-11-03,Greenock Morton,Partick Thistle,5,1,4,W
86800,18,SCO2,2018-11-10,Ayr United,Queen of the South,1,1,0,D
86801,18,SCO2,2018-11-10,Dunfermline Athletic,Falkirk,0,1,-1,L
86802,18,SCO2,2018-11-10,Greenock Morton,Alloa Athletic,0,2,-2,L
86803,18,SCO2,2018-11-10,Partick Thistle,Inverness CT,0,1,-1,L
86804,18,SCO2,2018-11-10,Ross County,Dundee United,0,1,-1,L
86805,18,SCO2,2018-11-17,Ayr United,Greenock Morton,0,0,0,D
86806,18,SCO2,2018-11-17,Falkirk,Partick Thistle,1,1,0,D
86807,18,SCO2,2018-11-17,Queen of the South,Inverness CT,3,3,0,D
86808,18,SCO2,2018-11-20,Dundee United,Alloa Athletic,4,2,2,W
86809,18,SCO2,2018-11-24,Ross County,Dunfermline Athletic,2,1,1,W
86810,18,SCO2,2018-11-30,Dundee United,Ayr United,0,5,-5,L
86811,18,SCO2,2018-12-01,Alloa Athletic,Ross County,0,1,-1,L
86812,18,SCO2,2018-12-01,Dunfermline Athletic,Greenock Morton,3,0,3,W
86813,18,SCO2,2018-12-01,Inverness CT,Falkirk,2,3,-1,L
86814,18,SCO2,2018-12-01,Queen of the South,Partick Thistle,1,0,1,W
86815,18,SCO2,2018-12-08,Falkirk,Alloa Athletic,2,2,0,D
86816,18,SCO2,2018-12-08,Greenock Morton,Dundee United,1,1,0,D
86817,18,SCO2,2018-12-08,Partick Thistle,Dunfermline Athletic,2,0,2,W
86818,18,SCO2,2018-12-08,Ross County,Queen of the South,1,1,0,D
86819,18,SCO2,2018-12-15,Ayr United,Ross County,3,3,0,D
86820,18,SCO2,2018-12-15,Falkirk,Greenock Morton,0,0,0,D
86821,18,SCO2,2018-12-15,Inverness CT,Dundee United,1,1,0,D
86822,18,SCO2,2018-12-15,Partick Thistle,Alloa Athletic,2,2,0,D
86823,18,SCO2,2018-12-15,Queen of the South,Dunfermline Athletic,0,0,0,D
86824,18,SCO2,2018-12-22,Alloa Athletic,Queen of the South,2,0,2,W
86825,18,SCO2,2018-12-22,Dundee United,Falkirk,2,1,1,W
86826,18,SCO2,2018-12-22,Dunfermline Athletic,Ayr United,0,0,0,D
86827,18,SCO2,2018-12-22,Greenock Morton,Inverness CT,1,2,-1,L
86828,18,SCO2,2018-12-22,Ross County,Partick Thistle,2,0,2,W
86829,18,SCO2,2018-12-29,Alloa Athletic,Dundee United,2,1,1,W
86830,18,SCO2,2018-12-29,Falkirk,Dunfermline Athletic,2,4,-2,L
86831,18,SCO2,2018-12-29,Partick Thistle,Greenock Morton,1,2,-1,L
86832,18,SCO2,2018-12-29,Queen of the South,Ayr United,1,1,0,D
86833,18,SCO2,2018-12-29,Ross County,Inverness CT,2,1,1,W
86834,18,SCO2,2019-01-04,Greenock Morton,Ross County,1,0,1,W
86835,18,SCO2,2019-01-05,Ayr United,Falkirk,0,1,-1,L
86836,18,SCO2,2019-01-05,Dundee United,Partick Thistle,1,1,0,D
86837,18,SCO2,2019-01-05,Dunfermline Athletic,Alloa Athletic,2,2,0,D
86838,18,SCO2,2019-01-05,Inverness CT,Queen of the South,1,2,-1,L
86839,18,SCO2,2019-01-12,Alloa Athletic,Greenock Morton,2,1,1,W
86840,18,SCO2,2019-01-12,Dundee United,Dunfermline Athletic,1,0,1,W
86841,18,SCO2,2019-01-12,Inverness CT,Ayr United,1,0,1,W
86842,18,SCO2,2019-01-12,Partick Thistle,Falkirk,1,1,0,D
86843,18,SCO2,2019-01-12,Queen of the South,Ross County,4,0,4,W
86844,18,SCO2,2019-01-25,Ayr United,Dundee United,1,0,1,W
86845,18,SCO2,2019-01-26,Falkirk,Inverness CT,2,2,0,D
86846,18,SCO2,2019-01-26,Greenock Morton,Dunfermline Athletic,0,0,0,D
86847,18,SCO2,2019-01-26,Partick Thistle,Queen of the South,2,1,1,W
86848,18,SCO2,2019-01-26,Ross County,Alloa Athletic,2,0,2,W
86849,18,SCO2,2019-01-29,Ayr United,Inverness CT,2,3,-1,L
86850,18,SCO2,2019-02-02,Alloa Athletic,Ayr United,1,3,-2,L
86851,18,SCO2,2019-02-02,Dundee United,Greenock Morton,2,1,1,W
86852,18,SCO2,2019-02-02,Dunfermline Athletic,Ross County,1,2,-1,L
86853,18,SCO2,2019-02-02,Falkirk,Queen of the South,3,0,3,W
86854,18,SCO2,2019-02-02,Inverness CT,Partick Thistle,1,2,-1,L
86855,18,SCO2,2019-02-09,Alloa Athletic,Falkirk,1,2,-1,L
86856,18,SCO2,2019-02-16,Alloa Athletic,Partick Thistle,0,2,-2,L
86857,18,SCO2,2019-02-16,Dunfermline Athletic,Inverness CT,1,0,1,W
86858,18,SCO2,2019-02-16,Greenock Morton,Ayr United,0,0,0,D
86859,18,SCO2,2019-02-16,Queen of the South,Dundee United,0,1,-1,L
86860,18,SCO2,2019-02-23,Ayr United,Dunfermline Athletic,0,1,-1,L
86861,18,SCO2,2019-02-23,Falkirk,Dundee United,1,1,0,D
86862,18,SCO2,2019-02-23,Inverness CT,Greenock Morton,1,0,1,W
86863,18,SCO2,2019-02-23,Partick Thistle,Ross County,2,4,-2,L
86864,18,SCO2,2019-02-23,Queen of the South,Alloa Athletic,1,2,-1,L
86865,18,SCO2,2019-02-26,Dundee United,Inverness CT,1,0,1,W
86866,18,SCO2,2019-02-26,Dunfermline Athletic,Partick Thistle,3,0,3,W
86867,18,SCO2,2019-02-26,Greenock Morton,Queen of the South,1,0,1,W
86868,18,SCO2,2019-02-26,Ross County,Ayr United,3,2,1,W
86869,18,SCO2,2019-03-01,Greenock Morton,Falkirk,1,1,0,D
86870,18,SCO2,2019-03-02,Dunfermline Athletic,Queen of the South,1,0,1,W
86871,18,SCO2,2019-03-08,Falkirk,Ayr United,2,0,2,W
86872,18,SCO2,2019-03-09,Alloa Athletic,Dunfermline Athletic,0,1,-1,L
86873,18,SCO2,2019-03-09,Partick Thistle,Dundee United,2,1,1,W
86874,18,SCO2,2019-03-09,Queen of the South,Inverness CT,0,2,-2,L
86875,18,SCO2,2019-03-09,Ross County,Greenock Morton,2,0,2,W
86876,18,SCO2,2019-03-12,Ross County,Falkirk,2,1,1,W
86877,18,SCO2,2019-03-16,Falkirk,Partick Thistle,1,1,0,D
86878,18,SCO2,2019-03-19,Dundee United,Ross County,1,0,1,W
86879,18,SCO2,2019-03-22,Partick Thistle,Inverness CT,1,2,-1,L
86880,18,SCO2,2019-03-23,Dundee United,Alloa Athletic,2,1,1,W
86881,18,SCO2,2019-03-26,Inverness CT,Alloa Athletic,3,2,1,W
86882,18,SCO2,2019-03-26,Dunfermline Athletic,Dundee United,0,1,-1,L
86883,18,SCO2,2019-03-29,Dunfermline Athletic,Ayr United,0,1,-1,L
86884,18,SCO2,2019-03-30,Alloa Athletic,Ross County,1,0,1,W
86885,18,SCO2,2019-03-30,Dundee United,Queen of the South,1,2,-1,L
86886,18,SCO2,2019-03-30,Inverness CT,Falkirk,0,0,0,D
86887,18,SCO2,2019-03-30,Greenock Morton,Partick Thistle,0,3,-3,L
86888,18,SCO2,2019-04-02,Inverness CT,Ross County,1,2,-1,L
86889,18,SCO2,2019-04-02,Ayr United,Greenock Morton,1,1,0,D
86890,18,SCO2,2019-04-02,Queen of the South,Falkirk,1,1,0,D
86891,18,SCO2,2019-04-05,Ross County,Dundee United,1,1,0,D
86892,18,SCO2,2019-04-06,Ayr United,Inverness CT,0,1,-1,L
86893,18,SCO2,2019-04-06,Falkirk,Alloa Athletic,1,2,-1,L
86894,18,SCO2,2019-04-06,Partick Thistle,Dunfermline Athletic,2,2,0,D
86895,18,SCO2,2019-04-06,Queen of the South,Greenock Morton,1,1,0,D
86896,18,SCO2,2019-04-09,Ayr United,Queen of the South,1,0,1,W
86897,18,SCO2,2019-04-09,Greenock Morton,Alloa Athletic,1,2,-1,L
86898,18,SCO2,2019-04-09,Ross County,Dunfermline Athletic,1,0,1,W
86899,18,SCO2,2019-04-12,Dundee United,Ayr United,2,1,1,W
86900,18,SCO2,2019-04-13,Alloa Athletic,Queen of the South,1,0,1,W
86901,18,SCO2,2019-04-13,Dunfermline Athletic,Falkirk,0,1,-1,L
86902,18,SCO2,2019-04-13,Ross County,Partick Thistle,0,0,0,D
86903,18,SCO2,2019-04-16,Greenock Morton,Inverness CT,2,2,0,D
86904,18,SCO2,2019-04-19,Ayr United,Ross County,1,3,-2,L
86905,18,SCO2,2019-04-20,Falkirk,Greenock Morton,0,2,-2,L
86906,18,SCO2,2019-04-20,Inverness CT,Dundee United,0,2,-2,L
86907,18,SCO2,2019-04-20,Partick Thistle,Alloa Athletic,2,1,1,W
86908,18,SCO2,2019-04-20,Queen of the South,Dunfermline Athletic,2,1,1,W
86909,18,SCO2,2019-04-23,Ayr United,Partick Thistle,0,1,-1,L
86910,18,SCO2,2019-04-26,Ross County,Queen of the South,4,0,4,W
86911,18,SCO2,2019-04-27,Alloa Athletic,Inverness CT,1,2,-1,L
86912,18,SCO2,2019-04-27,Dundee United,Falkirk,2,0,2,W
86913,18,SCO2,2019-04-27,Dunfermline Athletic,Greenock Morton,0,1,-1,L
86914,18,SCO2,2019-04-27,Partick Thistle,Ayr United,1,2,-1,L
86915,18,SCO2,2019-05-04,Ayr United,Alloa Athletic,1,1,0,D
86916,18,SCO2,2019-05-04,Falkirk,Ross County,3,2,1,W
86917,18,SCO2,2019-05-04,Inverness CT,Dunfermline Athletic,1,0,1,W
86918,18,SCO2,2019-05-04,Greenock Morton,Dundee United,1,0,1,W
86919,18,SCO2,2019-05-04,Queen of the South,Partick Thistle,0,3,-3,L
86920,19,SCO2,2019-08-02,Dunfermline Athletic,FC Dundee,2,2,0,D
86921,19,SCO2,2019-08-03,Alloa Athletic,Partick Thistle,1,1,0,D
86922,19,SCO2,2019-08-03,Arbroath,Queen of the South,0,0,0,D
86923,19,SCO2,2019-08-03,Ayr United,Greenock Morton,4,2,2,W
86924,19,SCO2,2019-08-03,Dundee United,Inverness CT,4,1,3,W
86925,19,SCO2,2019-08-09,Partick Thistle,Dundee United,1,2,-1,L
86926,19,SCO2,2019-08-10,FC Dundee,Ayr United,1,0,1,W
86927,19,SCO2,2019-08-10,Inverness CT,Arbroath,2,1,1,W
86928,19,SCO2,2019-08-10,Greenock Morton,Alloa Athletic,4,1,3,W
86929,19,SCO2,2019-08-10,Queen of the South,Dunfermline Athletic,1,1,0,D
86930,19,SCO2,2019-08-23,Greenock Morton,Partick Thistle,3,2,1,W
86931,19,SCO2,2019-08-24,Alloa Athletic,Arbroath,0,1,-1,L
86932,19,SCO2,2019-08-24,Ayr United,Queen of the South,1,0,1,W
86933,19,SCO2,2019-08-24,FC Dundee,Inverness CT,0,0,0,D
86934,19,SCO2,2019-08-24,Dunfermline Athletic,Dundee United,0,2,-2,L
86935,19,SCO2,2019-08-30,Inverness CT,Greenock Morton,5,0,5,W
86936,19,SCO2,2019-08-30,Dundee United,FC Dundee,6,2,4,W
86937,19,SCO2,2019-08-31,Arbroath,Dunfermline Athletic,1,0,1,W
86938,19,SCO2,2019-08-31,Partick Thistle,Ayr United,2,3,-1,L
86939,19,SCO2,2019-08-31,Queen of the South,Alloa Athletic,0,1,-1,L
86940,19,SCO2,2019-09-13,Arbroath,Partick Thistle,1,1,0,D
86941,19,SCO2,2019-09-14,Ayr United,Dundee United,2,0,2,W
86942,19,SCO2,2019-09-14,FC Dundee,Alloa Athletic,2,1,1,W
86943,19,SCO2,2019-09-14,Dunfermline Athletic,Inverness CT,0,1,-1,L
86944,19,SCO2,2019-09-14,Queen of the South,Greenock Morton,1,0,1,W
86945,19,SCO2,2019-09-21,Alloa Athletic,Ayr United,1,4,-3,L
86946,19,SCO2,2019-09-21,Dundee United,Arbroath,2,1,1,W
86947,19,SCO2,2019-09-21,Inverness CT,Queen of the South,2,0,2,W
86948,19,SCO2,2019-09-21,Greenock Morton,FC Dundee,1,0,1,W
86949,19,SCO2,2019-09-21,Partick Thistle,Dunfermline Athletic,0,3,-3,L
86950,19,SCO2,2019-09-27,Queen of the South,FC Dundee,1,1,0,D
86951,19,SCO2,2019-09-28,Arbroath,Ayr United,0,3,-3,L
86952,19,SCO2,2019-09-28,Dundee United,Greenock Morton,6,0,6,W
86953,19,SCO2,2019-09-28,Dunfermline Athletic,Alloa Athletic,1,1,0,D
86954,19,SCO2,2019-09-28,Inverness CT,Partick Thistle,1,3,-2,L
86955,19,SCO2,2019-10-04,Alloa Athletic,Dundee United,1,0,1,W
86956,19,SCO2,2019-10-05,Ayr United,Inverness CT,0,2,-2,L
86957,19,SCO2,2019-10-05,FC Dundee,Arbroath,2,0,2,W
86958,19,SCO2,2019-10-05,Greenock Morton,Dunfermline Athletic,1,1,0,D
86959,19,SCO2,2019-10-05,Partick Thistle,Queen of the South,0,1,-1,L
86960,19,SCO2,2019-10-19,Arbroath,Greenock Morton,1,0,1,W
86961,19,SCO2,2019-10-19,FC Dundee,Partick Thistle,1,3,-2,L
86962,19,SCO2,2019-10-19,Dunfermline Athletic,Ayr United,3,2,1,W
86963,19,SCO2,2019-10-19,Inverness CT,Alloa Athletic,2,2,0,D
86964,19,SCO2,2019-10-19,Queen of the South,Dundee United,4,0,4,W
86965,19,SCO2,2019-10-25,Ayr United,FC Dundee,1,2,-1,L
86966,19,SCO2,2019-10-26,Alloa Athletic,Queen of the South,2,2,0,D
86967,19,SCO2,2019-10-26,Dundee United,Dunfermline Athletic,2,0,2,W
86968,19,SCO2,2019-10-26,Greenock Morton,Inverness CT,2,1,1,W
86969,19,SCO2,2019-10-26,Partick Thistle,Arbroath,1,3,-2,L
86970,19,SCO2,2019-10-29,Alloa Athletic,FC Dundee,0,3,-3,L
86971,19,SCO2,2019-10-29,Dundee United,Partick Thistle,1,0,1,W
86972,19,SCO2,2019-10-29,Dunfermline Athletic,Arbroath,2,0,2,W
86973,19,SCO2,2019-10-29,Greenock Morton,Ayr United,2,3,-1,L
86974,19,SCO2,2019-10-29,Queen of the South,Inverness CT,0,2,-2,L
86975,19,SCO2,2019-11-01,FC Dundee,Greenock Morton,2,1,1,W
86976,19,SCO2,2019-11-02,Arbroath,Alloa Athletic,2,1,1,W
86977,19,SCO2,2019-11-02,Ayr United,Partick Thistle,4,1,3,W
86978,19,SCO2,2019-11-02,Dunfermline Athletic,Queen of the South,2,0,2,W
86979,19,SCO2,2019-11-02,Inverness CT,Dundee United,0,3,-3,L
86980,19,SCO2,2019-11-08,FC Dundee,Dundee United,0,2,-2,L
86981,19,SCO2,2019-11-09,Alloa Athletic,Dunfermline Athletic,2,1,1,W
86982,19,SCO2,2019-11-09,Arbroath,Inverness CT,3,0,3,W
86983,19,SCO2,2019-11-09,Partick Thistle,Greenock Morton,2,1,1,W
86984,19,SCO2,2019-11-09,Queen of the South,Ayr United,3,1,2,W
86985,19,SCO2,2019-11-16,Dundee United,Queen of the South,3,0,3,W
86986,19,SCO2,2019-11-16,Greenock Morton,Arbroath,1,0,1,W
86987,19,SCO2,2019-11-23,Inverness CT,FC Dundee,1,0,1,W
86988,19,SCO2,2019-11-26,Partick Thistle,Alloa Athletic,1,1,0,D
86989,19,SCO2,2019-11-30,Alloa Athletic,Inverness CT,0,2,-2,L
86990,19,SCO2,2019-11-30,FC Dundee,Queen of the South,1,2,-1,L
86991,19,SCO2,2019-11-30,Dunfermline Athletic,Partick Thistle,5,1,4,W
86992,19,SCO2,2019-12-03,Ayr United,Dunfermline Athletic,0,1,-1,L
86993,19,SCO2,2019-12-07,Arbroath,FC Dundee,1,1,0,D
86994,19,SCO2,2019-12-07,Dundee United,Alloa Athletic,2,1,1,W
86995,19,SCO2,2019-12-07,Dunfermline Athletic,Greenock Morton,3,1,2,W
86996,19,SCO2,2019-12-07,Inverness CT,Ayr United,2,0,2,W
86997,19,SCO2,2019-12-07,Queen of the South,Partick Thistle,1,2,-1,L
86998,19,SCO2,2019-12-10,Ayr United,Arbroath,1,1,0,D
86999,19,SCO2,2019-12-10,Greenock Morton,Dundee United,1,2,-1,L
87000,19,SCO2,2019-12-14,Arbroath,Dundee United,0,1,-1,L
87001,19,SCO2,2019-12-14,Ayr United,Alloa Athletic,2,1,1,W
87002,19,SCO2,2019-12-14,FC Dundee,Dunfermline Athletic,4,3,1,W
87003,19,SCO2,2019-12-14,Partick Thistle,Inverness CT,3,1,2,W
87004,19,SCO2,2019-12-21,Alloa Athletic,Greenock Morton,0,2,-2,L
87005,19,SCO2,2019-12-21,Dundee United,Ayr United,4,0,4,W
87006,19,SCO2,2019-12-21,Inverness CT,Dunfermline Athletic,2,0,2,W
87007,19,SCO2,2019-12-21,Partick Thistle,FC Dundee,0,1,-1,L
87008,19,SCO2,2019-12-21,Queen of the South,Arbroath,2,0,2,W
87009,19,SCO2,2019-12-27,Dundee United,FC Dundee,1,1,0,D
87010,19,SCO2,2019-12-28,Ayr United,Queen of the South,1,2,-1,L
87011,19,SCO2,2019-12-28,Dunfermline Athletic,Alloa Athletic,1,3,-2,L
87012,19,SCO2,2019-12-28,Inverness CT,Arbroath,0,1,-1,L
87013,19,SCO2,2019-12-28,Greenock Morton,Partick Thistle,1,2,-1,L
87014,19,SCO2,2020-01-04,Alloa Athletic,Partick Thistle,1,1,0,D
87015,19,SCO2,2020-01-04,Arbroath,Greenock Morton,1,2,-1,L
87016,19,SCO2,2020-01-04,FC Dundee,Inverness CT,0,2,-2,L
87017,19,SCO2,2020-01-04,Dunfermline Athletic,Ayr United,0,1,-1,L
87018,19,SCO2,2020-01-04,Queen of the South,Dundee United,0,1,-1,L
87019,19,SCO2,2020-01-11,Greenock Morton,Dunfermline Athletic,3,2,1,W
87020,19,SCO2,2020-01-11,Partick Thistle,Dundee United,1,4,-3,L
87021,19,SCO2,2020-01-21,Alloa Athletic,Arbroath,2,0,2,W
87022,19,SCO2,2020-01-24,Dunfermline Athletic,FC Dundee,2,0,2,W
87023,19,SCO2,2020-01-25,Arbroath,Partick Thistle,2,1,1,W
87024,19,SCO2,2020-01-25,Ayr United,Inverness CT,1,0,1,W
87025,19,SCO2,2020-01-25,Dundee United,Greenock Morton,1,1,0,D
87026,19,SCO2,2020-01-25,Queen of the South,Alloa Athletic,2,3,-1,L
87027,19,SCO2,2020-01-31,Partick Thistle,Ayr United,1,1,0,D
87028,19,SCO2,2020-02-01,Dundee United,Arbroath,0,1,-1,L
87029,19,SCO2,2020-02-01,Inverness CT,Alloa Athletic,1,1,0,D
87030,19,SCO2,2020-02-01,Greenock Morton,FC Dundee,1,1,0,D
87031,19,SCO2,2020-02-01,Queen of the South,Dunfermline Athletic,2,3,-1,L
87032,19,SCO2,2020-02-08,Greenock Morton,Queen of the South,2,2,0,D
87033,19,SCO2,2020-02-08,FC Dundee,Partick Thistle,2,0,2,W
87034,19,SCO2,2020-02-14,Alloa Athletic,Dundee United,0,0,0,D
87035,19,SCO2,2020-02-15,Arbroath,Queen of the South,2,0,2,W
87036,19,SCO2,2020-02-21,Dundee United,Inverness CT,2,1,1,W
87037,19,SCO2,2020-02-22,Greenock Morton,Alloa Athletic,4,4,0,D
87038,19,SCO2,2020-02-22,Queen of the South,FC Dundee,0,1,-1,L
87039,19,SCO2,2020-02-25,Ayr United,Greenock Morton,1,2,-1,L
87040,19,SCO2,2020-02-25,Dunfermline Athletic,Inverness CT,1,2,-1,L
87041,19,SCO2,2020-02-29,Alloa Athletic,Ayr United,0,2,-2,L
87042,19,SCO2,2020-02-29,Dunfermline Athletic,Dundee United,2,0,2,W
87043,19,SCO2,2020-02-29,Queen of the South,Greenock Morton,0,4,-4,L
87044,19,SCO2,2020-03-03,Ayr United,Dundee United,0,0,0,D
87045,19,SCO2,2020-03-03,FC Dundee,Alloa Athletic,0,0,0,D
87046,19,SCO2,2020-03-03,Inverness CT,Greenock Morton,3,2,1,W
87047,19,SCO2,2020-03-03,Partick Thistle,Queen of the South,0,0,0,D
87048,19,SCO2,2020-03-04,Arbroath,Dunfermline Athletic,0,0,0,D
87049,19,SCO2,2020-03-07,Alloa Athletic,Inverness CT,2,0,2,W
87050,19,SCO2,2020-03-07,Ayr United,FC Dundee,0,0,0,D
87051,19,SCO2,2020-03-07,Dundee United,Partick Thistle,1,1,0,D
87052,19,SCO2,2020-03-07,Dunfermline Athletic,Queen of the South,1,1,0,D
87053,19,SCO2,2020-03-07,Greenock Morton,Arbroath,1,1,0,D
87054,19,SCO2,2020-03-10,FC Dundee,Ayr United,2,0,2,W
87055,19,SCO2,2020-03-10,Inverness CT,Queen of the South,3,1,2,W
87056,19,SCO2,2020-03-10,Partick Thistle,Dunfermline Athletic,1,1,0,D
87057,20,SCO2,2020-10-16,Hearts,FC Dundee,6,2,4,W
87058,20,SCO2,2020-10-17,Ayr United,Queen of the South,2,1,1,W
87059,20,SCO2,2020-10-17,Dunfermline Athletic,Inverness CT,3,1,2,W
87060,20,SCO2,2020-10-17,Greenock Morton,Alloa Athletic,1,0,1,W
87061,20,SCO2,2020-10-17,Raith Rovers,Arbroath,3,0,3,W
87062,20,SCO2,2020-10-23,Arbroath,Hearts,0,1,-1,L
87063,20,SCO2,2020-10-24,Alloa Athletic,Dunfermline Athletic,1,4,-3,L
87064,20,SCO2,2020-10-24,FC Dundee,Greenock Morton,1,0,1,W
87065,20,SCO2,2020-10-24,Inverness CT,Ayr United,1,1,0,D
87066,20,SCO2,2020-10-24,Queen of the South,Raith Rovers,2,5,-3,L
87067,20,SCO2,2020-10-31,FC Dundee,Raith Rovers,1,1,0,D
87068,20,SCO2,2020-10-31,Dunfermline Athletic,Queen of the South,3,2,1,W
87069,20,SCO2,2020-10-31,Inverness CT,Arbroath,3,1,2,W
87070,20,SCO2,2020-10-31,Greenock Morton,Ayr United,3,2,1,W
87071,20,SCO2,2020-11-06,Alloa Athletic,FC Dundee,3,3,0,D
87072,20,SCO2,2020-11-07,Arbroath,Queen of the South,1,1,0,D
87073,20,SCO2,2020-11-07,Ayr United,Dunfermline Athletic,0,0,0,D
87074,20,SCO2,2020-11-07,Hearts,Inverness CT,2,1,1,W
87075,20,SCO2,2020-11-07,Raith Rovers,Greenock Morton,5,0,5,W
87076,20,SCO2,2020-11-20,Dunfermline Athletic,Hearts,2,1,1,W
87077,20,SCO2,2020-11-21,Arbroath,Greenock Morton,0,0,0,D
87078,20,SCO2,2020-11-21,Ayr United,FC Dundee,2,0,2,W
87079,20,SCO2,2020-11-21,Inverness CT,Raith Rovers,2,0,2,W
87080,20,SCO2,2020-11-21,Queen of the South,Alloa Athletic,2,0,2,W
87081,20,SCO2,2020-11-24,Hearts,Alloa Athletic,3,0,3,W
87082,20,SCO2,2020-12-04,Queen of the South,Inverness CT,0,3,-3,L
87083,20,SCO2,2020-12-05,Alloa Athletic,Ayr United,0,2,-2,L
87084,20,SCO2,2020-12-05,FC Dundee,Arbroath,1,0,1,W
87085,20,SCO2,2020-12-05,Greenock Morton,Hearts,0,2,-2,L
87086,20,SCO2,2020-12-05,Raith Rovers,Dunfermline Athletic,2,2,0,D
87087,20,SCO2,2020-12-11,Ayr United,Raith Rovers,0,0,0,D
87088,20,SCO2,2020-12-12,Arbroath,Alloa Athletic,0,1,-1,L
87089,20,SCO2,2020-12-12,Dunfermline Athletic,Greenock Morton,1,2,-1,L
87090,20,SCO2,2020-12-12,Hearts,Queen of the South,6,1,5,W
87091,20,SCO2,2020-12-12,Inverness CT,FC Dundee,2,2,0,D
87092,20,SCO2,2020-12-19,Alloa Athletic,Inverness CT,2,1,1,W
87093,20,SCO2,2020-12-19,Arbroath,Ayr United,2,1,1,W
87094,20,SCO2,2020-12-19,FC Dundee,Dunfermline Athletic,3,3,0,D
87095,20,SCO2,2020-12-19,Greenock Morton,Queen of the South,2,0,2,W
87096,20,SCO2,2020-12-26,Alloa Athletic,Raith Rovers,2,5,-3,L
87097,20,SCO2,2020-12-26,Dunfermline Athletic,Arbroath,1,0,1,W
87098,20,SCO2,2020-12-26,Hearts,Ayr United,5,3,2,W
87099,20,SCO2,2020-12-26,Queen of the South,FC Dundee,1,3,-2,L
87100,20,SCO2,2020-12-29,Ayr United,Greenock Morton,1,1,0,D
87101,20,SCO2,2020-12-29,Inverness CT,Dunfermline Athletic,1,1,0,D
87102,20,SCO2,2020-12-29,FC Dundee,Alloa Athletic,3,1,2,W
87103,20,SCO2,2020-12-29,Hearts,Arbroath,3,1,2,W
87104,20,SCO2,2020-12-29,Raith Rovers,Queen of the South,0,2,-2,L
87105,20,SCO2,2021-01-02,Alloa Athletic,Greenock Morton,1,1,0,D
87106,20,SCO2,2021-01-02,Queen of the South,Ayr United,3,2,1,W
87107,20,SCO2,2021-01-02,FC Dundee,Hearts,3,1,2,W
87108,20,SCO2,2021-01-15,Greenock Morton,Dunfermline Athletic,0,0,0,D
87109,20,SCO2,2021-01-16,Alloa Athletic,Hearts,1,3,-2,L
87110,20,SCO2,2021-01-16,Queen of the South,Arbroath,2,2,0,D
87111,20,SCO2,2021-01-22,Arbroath,FC Dundee,1,1,0,D
87112,20,SCO2,2021-01-23,Dunfermline Athletic,Ayr United,0,0,0,D
87113,20,SCO2,2021-01-23,Hearts,Raith Rovers,2,3,-1,L
87114,20,SCO2,2021-01-23,Queen of the South,Greenock Morton,2,1,1,W
87115,20,SCO2,2021-01-26,Raith Rovers,Hearts,0,4,-4,L
87116,20,SCO2,2021-01-27,Greenock Morton,Inverness CT,2,2,0,D
87117,20,SCO2,2021-01-30,Ayr United,Alloa Athletic,4,1,3,W
87118,20,SCO2,2021-01-30,Hearts,Dunfermline Athletic,1,0,1,W
87119,20,SCO2,2021-01-30,Greenock Morton,Arbroath,0,1,-1,L
87120,20,SCO2,2021-01-30,Raith Rovers,FC Dundee,3,1,2,W
87121,20,SCO2,2021-02-03,Arbroath,Inverness CT,1,1,0,D
87122,20,SCO2,2021-02-03,Dunfermline Athletic,Raith Rovers,4,1,3,W
87123,20,SCO2,2021-02-05,Ayr United,Hearts,0,1,-1,L
87124,20,SCO2,2021-02-06,Alloa Athletic,Queen of the South,2,1,1,W
87125,20,SCO2,2021-02-06,Arbroath,Dunfermline Athletic,2,0,2,W
87126,20,SCO2,2021-02-06,Greenock Morton,Raith Rovers,0,1,-1,L
87127,20,SCO2,2021-02-12,Queen of the South,Hearts,1,1,0,D
87128,20,SCO2,2021-02-13,Alloa Athletic,Arbroath,1,1,0,D
87129,20,SCO2,2021-02-17,Inverness CT,Queen of the South,0,1,-1,L
87130,20,SCO2,2021-02-20,Arbroath,Raith Rovers,1,0,1,W
87131,20,SCO2,2021-02-20,Ayr United,Inverness CT,0,2,-2,L
87132,20,SCO2,2021-02-20,FC Dundee,Queen of the South,2,3,-1,L
87133,20,SCO2,2021-02-20,Dunfermline Athletic,Alloa Athletic,2,1,1,W
87134,20,SCO2,2021-02-20,Hearts,Greenock Morton,1,1,0,D
87135,20,SCO2,2021-02-23,Inverness CT,Alloa Athletic,2,2,0,D
87136,20,SCO2,2021-02-26,Inverness CT,Hearts,1,1,0,D
87137,20,SCO2,2021-02-27,Ayr United,Arbroath,0,1,-1,L
87138,20,SCO2,2021-02-27,Greenock Morton,FC Dundee,2,2,0,D
87139,20,SCO2,2021-02-27,Queen of the South,Dunfermline Athletic,1,0,1,W
87140,20,SCO2,2021-02-27,Raith Rovers,Alloa Athletic,3,1,2,W
87141,20,SCO2,2021-03-02,FC Dundee,Inverness CT,2,1,1,W
87142,20,SCO2,2021-03-06,Alloa Athletic,Inverness CT,1,1,0,D
87143,20,SCO2,2021-03-06,Arbroath,Queen of the South,2,4,-2,L
87144,20,SCO2,2021-03-06,Hearts,FC Dundee,2,1,1,W
87145,20,SCO2,2021-03-06,Greenock Morton,Ayr United,0,2,-2,L
87146,20,SCO2,2021-03-09,Inverness CT,Greenock Morton,0,1,-1,L
87147,20,SCO2,2021-03-09,Raith Rovers,Ayr United,0,0,0,D
87148,20,SCO2,2021-03-12,Inverness CT,Raith Rovers,0,0,0,D
87149,20,SCO2,2021-03-13,FC Dundee,Arbroath,2,0,2,W
87150,20,SCO2,2021-03-13,Dunfermline Athletic,Greenock Morton,1,0,1,W
87151,20,SCO2,2021-03-13,Hearts,Ayr United,2,0,2,W
87152,20,SCO2,2021-03-13,Queen of the South,Alloa Athletic,2,3,-1,L
87153,20,SCO2,2021-03-16,FC Dundee,Ayr United,1,3,-2,L
87154,20,SCO2,2021-03-16,Raith Rovers,Inverness CT,0,1,-1,L
87155,20,SCO2,2021-03-19,Alloa Athletic,FC Dundee,0,3,-3,L
87156,20,SCO2,2021-03-20,Arbroath,Hearts,0,0,0,D
87157,20,SCO2,2021-03-20,Ayr United,Raith Rovers,1,1,0,D
87158,20,SCO2,2021-03-20,Dunfermline Athletic,Inverness CT,0,1,-1,L
87159,20,SCO2,2021-03-20,Greenock Morton,Queen of the South,2,1,1,W
87160,20,SCO2,2021-03-27,Alloa Athletic,Ayr United,2,2,0,D
87161,20,SCO2,2021-03-27,Hearts,Queen of the South,2,3,-1,L
87162,20,SCO2,2021-03-27,Inverness CT,Arbroath,1,0,1,W
87163,20,SCO2,2021-03-27,Raith Rovers,Greenock Morton,1,0,1,W
87164,20,SCO2,2021-03-27,FC Dundee,Dunfermline Athletic,3,2,1,W
87165,20,SCO2,2021-03-30,Raith Rovers,Dunfermline Athletic,5,1,4,W
87166,20,SCO2,2021-04-03,Arbroath,Alloa Athletic,2,1,1,W
87167,20,SCO2,2021-04-03,Dunfermline Athletic,Hearts,0,0,0,D
87168,20,SCO2,2021-04-06,Ayr United,FC Dundee,0,3,-3,L
87169,20,SCO2,2021-04-06,Greenock Morton,Inverness CT,1,4,-3,L
87170,20,SCO2,2021-04-09,Hearts,Alloa Athletic,6,0,6,W
87171,20,SCO2,2021-04-10,Ayr United,Dunfermline Athletic,1,1,0,D
87172,20,SCO2,2021-04-10,FC Dundee,Greenock Morton,1,1,0,D
87173,20,SCO2,2021-04-10,Queen of the South,Inverness CT,1,1,0,D
87174,20,SCO2,2021-04-10,Raith Rovers,Arbroath,2,2,0,D
87175,20,SCO2,2021-04-13,Dunfermline Athletic,FC Dundee,0,0,0,D
87176,20,SCO2,2021-04-13,Queen of the South,Raith Rovers,0,1,-1,L
87177,20,SCO2,2021-04-17,Alloa Athletic,Raith Rovers,1,2,-1,L
87178,20,SCO2,2021-04-17,Arbroath,Ayr United,4,0,4,W
87179,20,SCO2,2021-04-17,Dunfermline Athletic,Queen of the South,3,1,2,W
87180,20,SCO2,2021-04-20,Inverness CT,FC Dundee,1,1,0,D
87181,20,SCO2,2021-04-20,Greenock Morton,Hearts,0,0,0,D
87182,20,SCO2,2021-04-24,Ayr United,Queen of the South,0,0,0,D
87183,20,SCO2,2021-04-24,FC Dundee,Raith Rovers,2,1,1,W
87184,20,SCO2,2021-04-24,Dunfermline Athletic,Arbroath,4,3,1,W
87185,20,SCO2,2021-04-24,Hearts,Inverness CT,3,0,3,W
87186,20,SCO2,2021-04-24,Greenock Morton,Alloa Athletic,1,1,0,D
87187,20,SCO2,2021-04-30,Alloa Athletic,Dunfermline Athletic,1,0,1,W
87188,20,SCO2,2021-04-30,Arbroath,Greenock Morton,0,0,0,D
87189,20,SCO2,2021-04-30,Inverness CT,Ayr United,2,2,0,D
87190,20,SCO2,2021-04-30,Queen of the South,FC Dundee,0,2,-2,L
87191,20,SCO2,2021-04-30,Raith Rovers,Hearts,0,4,-4,L
87192,21,SCO2,2021-07-31,Arbroath,Inverness CT,0,1,-1,L
87193,21,SCO2,2021-07-31,Greenock Morton,Dunfermline Athletic,2,2,0,D
87194,21,SCO2,2021-07-31,Partick Thistle,Queen of the South,3,2,1,W
87195,21,SCO2,2021-07-31,Raith Rovers,Hamilton Academical,4,4,0,D
87196,21,SCO2,2021-08-02,Kilmarnock,Ayr United,2,0,2,W
87197,21,SCO2,2021-08-07,Ayr United,Arbroath,2,2,0,D
87198,21,SCO2,2021-08-07,Dunfermline Athletic,Partick Thistle,0,3,-3,L
87199,21,SCO2,2021-08-07,Hamilton Academical,Greenock Morton,0,1,-1,L
87200,21,SCO2,2021-08-07,Inverness CT,Raith Rovers,1,0,1,W
87201,21,SCO2,2021-08-07,Queen of the South,Kilmarnock,0,1,-1,L
87202,21,SCO2,2021-08-21,Arbroath,Partick Thistle,3,1,2,W
87203,21,SCO2,2021-08-21,Hamilton Academical,Kilmarnock,0,2,-2,L
87204,21,SCO2,2021-08-21,Inverness CT,Ayr United,1,0,1,W
87205,21,SCO2,2021-08-21,Greenock Morton,Queen of the South,2,3,-1,L
87206,21,SCO2,2021-08-28,Dunfermline Athletic,Arbroath,0,3,-3,L
87207,21,SCO2,2021-08-28,Kilmarnock,Inverness CT,0,1,-1,L
87208,21,SCO2,2021-08-28,Partick Thistle,Greenock Morton,3,0,3,W
87209,21,SCO2,2021-08-28,Queen of the South,Hamilton Academical,1,2,-1,L
87210,21,SCO2,2021-09-07,Ayr United,Raith Rovers,0,2,-2,L
87211,21,SCO2,2021-09-11,Arbroath,Hamilton Academical,4,0,4,W
87212,21,SCO2,2021-09-11,Ayr United,Dunfermline Athletic,3,1,2,W
87213,21,SCO2,2021-09-11,Kilmarnock,Greenock Morton,1,0,1,W
87214,21,SCO2,2021-09-11,Inverness CT,Partick Thistle,3,1,2,W
87215,21,SCO2,2021-09-11,Raith Rovers,Queen of the South,0,1,-1,L
87216,21,SCO2,2021-09-18,Dunfermline Athletic,Inverness CT,0,0,0,D
87217,21,SCO2,2021-09-18,Hamilton Academical,Ayr United,0,2,-2,L
87218,21,SCO2,2021-09-18,Greenock Morton,Raith Rovers,0,1,-1,L
87219,21,SCO2,2021-09-18,Partick Thistle,Kilmarnock,0,2,-2,L
87220,21,SCO2,2021-09-18,Queen of the South,Arbroath,0,2,-2,L
87221,21,SCO2,2021-09-24,Arbroath,Kilmarnock,0,0,0,D
87222,21,SCO2,2021-09-25,Ayr United,Greenock Morton,0,0,0,D
87223,21,SCO2,2021-09-25,Dunfermline Athletic,Hamilton Academical,0,0,0,D
87224,21,SCO2,2021-09-25,Inverness CT,Queen of the South,2,1,1,W
87225,21,SCO2,2021-09-26,Raith Rovers,Partick Thistle,3,2,1,W
87226,21,SCO2,2021-09-29,Raith Rovers,Dunfermline Athletic,1,1,0,D
87227,21,SCO2,2021-10-02,Kilmarnock,Raith Rovers,1,3,-2,L
87228,21,SCO2,2021-10-02,Hamilton Academical,Inverness CT,2,1,1,W
87229,21,SCO2,2021-10-02,Greenock Morton,Arbroath,2,2,0,D
87230,21,SCO2,2021-10-02,Partick Thistle,Ayr United,4,0,4,W
87231,21,SCO2,2021-10-02,Queen of the South,Dunfermline Athletic,1,0,1,W
87232,21,SCO2,2021-10-15,Hamilton Academical,Partick Thistle,1,6,-5,L
87233,21,SCO2,2021-10-16,Ayr United,Queen of the South,2,1,1,W
87234,21,SCO2,2021-10-16,Dunfermline Athletic,Kilmarnock,2,2,0,D
87235,21,SCO2,2021-10-16,Inverness CT,Greenock Morton,2,0,2,W
87236,21,SCO2,2021-10-16,Raith Rovers,Arbroath,2,1,1,W
87237,21,SCO2,2021-10-23,Arbroath,Ayr United,1,1,0,D
87238,21,SCO2,2021-10-23,Kilmarnock,Hamilton Academical,2,1,1,W
87239,21,SCO2,2021-10-23,Partick Thistle,Dunfermline Athletic,0,0,0,D
87240,21,SCO2,2021-10-23,Queen of the South,Greenock Morton,0,0,0,D
87241,21,SCO2,2021-10-23,Raith Rovers,Inverness CT,1,1,0,D
87242,21,SCO2,2021-10-26,Greenock Morton,Partick Thistle,0,0,0,D
87243,21,SCO2,2021-10-26,Ayr United,Kilmarnock,0,1,-1,L
87244,21,SCO2,2021-10-26,Dunfermline Athletic,Raith Rovers,1,1,0,D
87245,21,SCO2,2021-10-26,Hamilton Academical,Queen of the South,1,0,1,W
87246,21,SCO2,2021-10-26,Inverness CT,Arbroath,0,1,-1,L
87247,21,SCO2,2021-10-30,Arbroath,Dunfermline Athletic,4,2,2,W
87248,21,SCO2,2021-10-30,Kilmarnock,Queen of the South,4,0,4,W
87249,21,SCO2,2021-10-30,Greenock Morton,Hamilton Academical,1,1,0,D
87250,21,SCO2,2021-10-30,Partick Thistle,Inverness CT,0,0,0,D
87251,21,SCO2,2021-10-30,Raith Rovers,Ayr United,2,1,1,W
87252,21,SCO2,2021-11-06,Ayr United,Inverness CT,2,2,0,D
87253,21,SCO2,2021-11-06,Dunfermline Athletic,Greenock Morton,1,3,-2,L
87254,21,SCO2,2021-11-06,Kilmarnock,Partick Thistle,0,1,-1,L
87255,21,SCO2,2021-11-06,Hamilton Academical,Arbroath,1,1,0,D
87256,21,SCO2,2021-11-06,Queen of the South,Raith Rovers,1,1,0,D
87257,21,SCO2,2021-11-13,Arbroath,Queen of the South,1,1,0,D
87258,21,SCO2,2021-11-13,Ayr United,Partick Thistle,0,4,-4,L
87259,21,SCO2,2021-11-13,Hamilton Academical,Raith Rovers,0,3,-3,L
87260,21,SCO2,2021-11-13,Inverness CT,Dunfermline Athletic,1,2,-1,L
87261,21,SCO2,2021-11-13,Greenock Morton,Kilmarnock,0,2,-2,L
87262,21,SCO2,2021-11-19,Queen of the South,Inverness CT,1,2,-1,L
87263,21,SCO2,2021-11-20,Dunfermline Athletic,Ayr United,3,0,3,W
87264,21,SCO2,2021-11-20,Kilmarnock,Arbroath,0,1,-1,L
87265,21,SCO2,2021-11-20,Partick Thistle,Hamilton Academical,1,0,1,W
87266,21,SCO2,2021-11-20,Raith Rovers,Greenock Morton,2,1,1,W
87267,21,SCO2,2021-12-03,Inverness CT,Kilmarnock,1,0,1,W
87268,21,SCO2,2021-12-04,Arbroath,Raith Rovers,0,0,0,D
87269,21,SCO2,2021-12-04,Hamilton Academical,Dunfermline Athletic,1,0,1,W
87270,21,SCO2,2021-12-04,Greenock Morton,Ayr United,2,2,0,D
87271,21,SCO2,2021-12-04,Queen of the South,Partick Thistle,0,0,0,D
87272,21,SCO2,2021-12-10,Ayr United,Hamilton Academical,1,1,0,D
87273,21,SCO2,2021-12-11,Dunfermline Athletic,Queen of the South,3,3,0,D
87274,21,SCO2,2021-12-11,Greenock Morton,Inverness CT,1,6,-5,L
87275,21,SCO2,2021-12-11,Partick Thistle,Arbroath,0,2,-2,L
87276,21,SCO2,2021-12-11,Raith Rovers,Kilmarnock,1,0,1,W
87277,21,SCO2,2021-12-18,Arbroath,Greenock Morton,2,1,1,W
87278,21,SCO2,2021-12-18,Inverness CT,Hamilton Academical,1,2,-1,L
87279,21,SCO2,2021-12-18,Partick Thistle,Raith Rovers,1,0,1,W
87280,21,SCO2,2021-12-18,Queen of the South,Ayr United,3,0,3,W
87281,21,SCO2,2021-12-26,Ayr United,Raith Rovers,2,0,2,W
87282,21,SCO2,2021-12-26,Dunfermline Athletic,Arbroath,0,3,-3,L
87283,21,SCO2,2021-12-26,Hamilton Academical,Kilmarnock,2,3,-1,L
87284,21,SCO2,2021-12-29,Kilmarnock,Greenock Morton,1,1,0,D
87285,21,SCO2,2022-01-02,Arbroath,Inverness CT,0,0,0,D
87286,21,SCO2,2022-01-02,Queen of the South,Hamilton Academical,0,3,-3,L
87287,21,SCO2,2022-01-02,Raith Rovers,Dunfermline Athletic,0,0,0,D
87288,21,SCO2,2022-01-08,Ayr United,Arbroath,1,0,1,W
87289,21,SCO2,2022-01-08,Hamilton Academical,Partick Thistle,2,2,0,D
87290,21,SCO2,2022-01-08,Inverness CT,Raith Rovers,1,1,0,D
87291,21,SCO2,2022-01-08,Greenock Morton,Dunfermline Athletic,5,0,5,W
87292,21,SCO2,2022-01-08,Queen of the South,Kilmarnock,0,2,-2,L
87293,21,SCO2,2022-01-14,Partick Thistle,Kilmarnock,1,1,0,D
87294,21,SCO2,2022-01-15,Ayr United,Greenock Morton,0,2,-2,L
87295,21,SCO2,2022-01-15,Dunfermline Athletic,Hamilton Academical,1,0,1,W
87296,21,SCO2,2022-01-15,Inverness CT,Queen of the South,2,2,0,D
87297,21,SCO2,2022-01-15,Raith Rovers,Arbroath,1,2,-1,L
87298,21,SCO2,2022-01-22,Dunfermline Athletic,Inverness CT,1,1,0,D
87299,21,SCO2,2022-01-28,Greenock Morton,Raith Rovers,2,2,0,D
87300,21,SCO2,2022-01-29,Kilmarnock,Inverness CT,1,0,1,W
87301,21,SCO2,2022-01-29,Hamilton Academical,Ayr United,1,1,0,D
87302,21,SCO2,2022-01-29,Queen of the South,Dunfermline Athletic,0,2,-2,L
87303,21,SCO2,2022-02-01,Partick Thistle,Ayr United,1,0,1,W
87304,21,SCO2,2022-02-01,Raith Rovers,Queen of the South,3,3,0,D
87305,21,SCO2,2022-02-04,Arbroath,Kilmarnock,1,0,1,W
87306,21,SCO2,2022-02-05,Ayr United,Dunfermline Athletic,1,1,0,D
87307,21,SCO2,2022-02-05,Inverness CT,Greenock Morton,0,1,-1,L
87308,21,SCO2,2022-02-05,Raith Rovers,Hamilton Academical,0,0,0,D
87309,21,SCO2,2022-02-09,Inverness CT,Partick Thistle,3,3,0,D
87310,21,SCO2,2022-02-09,Arbroath,Hamilton Academical,2,2,0,D
87311,21,SCO2,2022-02-09,Kilmarnock,Ayr United,1,2,-1,L
87312,21,SCO2,2022-02-12,Kilmarnock,Dunfermline Athletic,2,1,1,W
87313,21,SCO2,2022-02-12,Greenock Morton,Queen of the South,2,1,1,W
87314,21,SCO2,2022-02-19,Kilmarnock,Raith Rovers,3,0,3,W
87315,21,SCO2,2022-02-19,Hamilton Academical,Greenock Morton,1,0,1,W
87316,21,SCO2,2022-02-19,Inverness CT,Ayr United,1,2,-1,L
87317,21,SCO2,2022-02-19,Queen of the South,Arbroath,0,0,0,D
87318,21,SCO2,2022-02-22,Partick Thistle,Greenock Morton,0,1,-1,L
87319,21,SCO2,2022-02-25,Hamilton Academical,Inverness CT,1,1,0,D
87320,21,SCO2,2022-02-26,Ayr United,Queen of the South,0,1,-1,L
87321,21,SCO2,2022-02-26,Dunfermline Athletic,Kilmarnock,0,0,0,D
87322,21,SCO2,2022-02-26,Greenock Morton,Arbroath,0,0,0,D
87323,21,SCO2,2022-02-26,Raith Rovers,Partick Thistle,0,0,0,D
87324,21,SCO2,2022-03-01,Arbroath,Partick Thistle,1,1,0,D
87325,21,SCO2,2022-03-04,Partick Thistle,Inverness CT,1,0,1,W
87326,21,SCO2,2022-03-05,Arbroath,Dunfermline Athletic,1,0,1,W
87327,21,SCO2,2022-03-05,Kilmarnock,Hamilton Academical,2,0,2,W
87328,21,SCO2,2022-03-05,Queen of the South,Greenock Morton,3,0,3,W
87329,21,SCO2,2022-03-05,Raith Rovers,Ayr United,0,4,-4,L
87330,21,SCO2,2022-03-08,Partick Thistle,Queen of the South,1,0,1,W
87331,21,SCO2,2022-03-11,Ayr United,Kilmarnock,1,3,-2,L
87332,21,SCO2,2022-03-12,Hamilton Academical,Dunfermline Athletic,2,2,0,D
87333,21,SCO2,2022-03-12,Inverness CT,Arbroath,3,0,3,W
87334,21,SCO2,2022-03-12,Greenock Morton,Partick Thistle,2,1,1,W
87335,21,SCO2,2022-03-12,Queen of the South,Raith Rovers,0,1,-1,L
87336,21,SCO2,2022-03-18,Dunfermline Athletic,Greenock Morton,1,1,0,D
87337,21,SCO2,2022-03-19,Arbroath,Ayr United,1,0,1,W
87338,21,SCO2,2022-03-19,Kilmarnock,Queen of the South,2,1,1,W
87339,21,SCO2,2022-03-19,Partick Thistle,Hamilton Academical,0,4,-4,L
87340,21,SCO2,2022-03-19,Raith Rovers,Inverness CT,2,3,-1,L
87341,21,SCO2,2022-03-22,Dunfermline Athletic,Partick Thistle,4,1,3,W
87342,21,SCO2,2022-03-26,Arbroath,Raith Rovers,3,3,0,D
87343,21,SCO2,2022-03-26,Kilmarnock,Partick Thistle,2,1,1,W
87344,21,SCO2,2022-03-26,Hamilton Academical,Queen of the South,1,0,1,W
87345,21,SCO2,2022-03-26,Inverness CT,Dunfermline Athletic,2,0,2,W
87346,21,SCO2,2022-03-26,Greenock Morton,Ayr United,1,1,0,D
87347,21,SCO2,2022-04-01,Ayr United,Hamilton Academical,1,1,0,D
87348,21,SCO2,2022-04-01,Greenock Morton,Kilmarnock,1,1,0,D
87349,21,SCO2,2022-04-02,Partick Thistle,Arbroath,0,0,0,D
87350,21,SCO2,2022-04-06,Dunfermline Athletic,Raith Rovers,2,0,2,W
87351,21,SCO2,2022-04-08,Queen of the South,Partick Thistle,0,1,-1,L
87352,21,SCO2,2022-04-09,Ayr United,Inverness CT,2,2,0,D
87353,21,SCO2,2022-04-09,Kilmarnock,Dunfermline Athletic,2,0,2,W
87354,21,SCO2,2022-04-09,Hamilton Academical,Arbroath,0,1,-1,L
87355,21,SCO2,2022-04-09,Raith Rovers,Greenock Morton,0,1,-1,L
87356,21,SCO2,2022-04-15,Inverness CT,Kilmarnock,2,1,1,W
87357,21,SCO2,2022-04-16,Arbroath,Queen of the South,5,1,4,W
87358,21,SCO2,2022-04-16,Dunfermline Athletic,Ayr United,2,1,1,W
87359,21,SCO2,2022-04-16,Greenock Morton,Hamilton Academical,0,1,-1,L
87360,21,SCO2,2022-04-16,Partick Thistle,Raith Rovers,0,1,-1,L
87361,21,SCO2,2022-04-19,Queen of the South,Inverness CT,2,1,1,W
87362,21,SCO2,2022-04-22,Kilmarnock,Arbroath,2,1,1,W
87363,21,SCO2,2022-04-23,Hamilton Academical,Raith Rovers,0,2,-2,L
87364,21,SCO2,2022-04-23,Greenock Morton,Inverness CT,0,1,-1,L
87365,21,SCO2,2022-04-23,Partick Thistle,Dunfermline Athletic,1,0,1,W
87366,21,SCO2,2022-04-23,Queen of the South,Ayr United,1,1,0,D
87367,21,SCO2,2022-04-29,Arbroath,Greenock Morton,3,0,3,W
87368,21,SCO2,2022-04-29,Ayr United,Partick Thistle,3,1,2,W
87369,21,SCO2,2022-04-29,Dunfermline Athletic,Queen of the South,1,2,-1,L
87370,21,SCO2,2022-04-29,Inverness CT,Hamilton Academical,4,0,4,W
87371,21,SCO2,2022-04-29,Raith Rovers,Kilmarnock,1,1,0,D
87372,22,SCO2,2022-07-30,Ayr United,Arbroath,0,0,0,D
87373,22,SCO2,2022-07-30,Cove Rangers,Raith Rovers,2,0,2,W
87374,22,SCO2,2022-07-30,FC Dundee,Partick Thistle,2,3,-1,L
87375,22,SCO2,2022-07-30,Hamilton Academical,Greenock Morton,1,1,0,D
87376,22,SCO2,2022-07-30,Inverness CT,Queens Park,1,1,0,D
87377,22,SCO2,2022-08-05,Queens Park,Ayr United,2,3,-1,L
87378,22,SCO2,2022-08-06,Arbroath,Inverness CT,0,0,0,D
87379,22,SCO2,2022-08-06,Greenock Morton,Cove Rangers,1,0,1,W
87380,22,SCO2,2022-08-06,Partick Thistle,Hamilton Academical,1,1,0,D
87381,22,SCO2,2022-08-06,Raith Rovers,FC Dundee,0,1,-1,L
87382,22,SCO2,2022-08-12,FC Dundee,Arbroath,4,2,2,W
87383,22,SCO2,2022-08-13,Ayr United,Hamilton Academical,2,2,0,D
87384,22,SCO2,2022-08-13,Inverness CT,Cove Rangers,4,1,3,W
87385,22,SCO2,2022-08-13,Queens Park,Partick Thistle,3,2,1,W
87386,22,SCO2,2022-08-13,Raith Rovers,Greenock Morton,2,1,1,W
87387,22,SCO2,2022-08-19,Partick Thistle,Inverness CT,4,1,3,W
87388,22,SCO2,2022-08-20,Arbroath,Queens Park,1,2,-1,L
87389,22,SCO2,2022-08-20,Cove Rangers,Ayr United,1,2,-1,L
87390,22,SCO2,2022-08-20,Hamilton Academical,Raith Rovers,0,2,-2,L
87391,22,SCO2,2022-08-20,Greenock Morton,FC Dundee,0,0,0,D
87392,22,SCO2,2022-08-26,Ayr United,FC Dundee,3,1,2,W
87393,22,SCO2,2022-08-27,Hamilton Academical,Arbroath,1,0,1,W
87394,22,SCO2,2022-08-27,Inverness CT,Greenock Morton,0,1,-1,L
87395,22,SCO2,2022-08-27,Partick Thistle,Raith Rovers,2,1,1,W
87396,22,SCO2,2022-08-27,Queens Park,Cove Rangers,2,1,1,W
87397,22,SCO2,2022-09-03,Arbroath,Partick Thistle,0,2,-2,L
87398,22,SCO2,2022-09-03,Cove Rangers,Hamilton Academical,2,2,0,D
87399,22,SCO2,2022-09-03,FC Dundee,Queens Park,3,0,3,W
87400,22,SCO2,2022-09-03,Greenock Morton,Ayr United,1,2,-1,L
87401,22,SCO2,2022-09-03,Raith Rovers,Inverness CT,0,2,-2,L
87402,22,SCO2,2022-09-17,FC Dundee,Inverness CT,2,3,-1,L
87403,22,SCO2,2022-09-17,Hamilton Academical,Queens Park,0,2,-2,L
87404,22,SCO2,2022-09-17,Greenock Morton,Arbroath,1,2,-1,L
87405,22,SCO2,2022-09-17,Partick Thistle,Cove Rangers,2,2,0,D
87406,22,SCO2,2022-09-17,Raith Rovers,Ayr United,3,2,1,W
87407,22,SCO2,2022-10-01,Ayr United,Inverness CT,0,1,-1,L
87408,22,SCO2,2022-10-01,Cove Rangers,Arbroath,2,0,2,W
87409,22,SCO2,2022-10-01,Hamilton Academical,FC Dundee,0,2,-2,L
87410,22,SCO2,2022-10-01,Partick Thistle,Greenock Morton,5,1,4,W
87411,22,SCO2,2022-10-01,Queens Park,Raith Rovers,1,0,1,W
87412,22,SCO2,2022-10-04,Cove Rangers,FC Dundee,3,1,2,W
87413,22,SCO2,2022-10-04,Queens Park,Greenock Morton,1,2,-1,L
87414,22,SCO2,2022-10-07,Inverness CT,Partick Thistle,1,0,1,W
87415,22,SCO2,2022-10-08,Arbroath,FC Dundee,1,1,0,D
87416,22,SCO2,2022-10-08,Ayr United,Queens Park,5,0,5,W
87417,22,SCO2,2022-10-08,Greenock Morton,Hamilton Academical,5,0,5,W
87418,22,SCO2,2022-10-08,Raith Rovers,Cove Rangers,3,0,3,W
87419,22,SCO2,2022-10-14,Queens Park,Arbroath,1,1,0,D
87420,22,SCO2,2022-10-15,Cove Rangers,Inverness CT,0,1,-1,L
87421,22,SCO2,2022-10-15,FC Dundee,Ayr United,2,1,1,W
87422,22,SCO2,2022-10-15,Hamilton Academical,Partick Thistle,1,2,-1,L
87423,22,SCO2,2022-10-15,Greenock Morton,Raith Rovers,1,0,1,W
87424,22,SCO2,2022-10-18,Inverness CT,Hamilton Academical,0,1,-1,L
87425,22,SCO2,2022-10-19,Arbroath,Raith Rovers,0,1,-1,L
87426,22,SCO2,2022-10-22,Arbroath,Hamilton Academical,1,0,1,W
87427,22,SCO2,2022-10-22,Ayr United,Cove Rangers,2,2,0,D
87428,22,SCO2,2022-10-22,FC Dundee,Greenock Morton,0,0,0,D
87429,22,SCO2,2022-10-22,Inverness CT,Raith Rovers,1,1,0,D
87430,22,SCO2,2022-10-22,Partick Thistle,Queens Park,0,4,-4,L
87431,22,SCO2,2022-10-25,Ayr United,Partick Thistle,4,2,2,W
87432,22,SCO2,2022-10-28,Greenock Morton,Inverness CT,4,0,4,W
87433,22,SCO2,2022-10-28,Queens Park,FC Dundee,2,2,0,D
87434,22,SCO2,2022-10-29,Arbroath,Ayr United,0,2,-2,L
87435,22,SCO2,2022-10-29,Hamilton Academical,Cove Rangers,4,4,0,D
87436,22,SCO2,2022-10-29,Raith Rovers,Partick Thistle,3,0,3,W
87437,22,SCO2,2022-11-04,Cove Rangers,Queens Park,2,0,2,W
87438,22,SCO2,2022-11-05,Ayr United,Greenock Morton,1,1,0,D
87439,22,SCO2,2022-11-05,Inverness CT,Arbroath,1,1,0,D
87440,22,SCO2,2022-11-05,Partick Thistle,FC Dundee,2,3,-1,L
87441,22,SCO2,2022-11-05,Raith Rovers,Hamilton Academical,3,1,2,W
87442,22,SCO2,2022-11-11,Hamilton Academical,Ayr United,2,3,-1,L
87443,22,SCO2,2022-11-12,Arbroath,Cove Rangers,1,1,0,D
87444,22,SCO2,2022-11-12,FC Dundee,Raith Rovers,2,0,2,W
87445,22,SCO2,2022-11-12,Greenock Morton,Partick Thistle,2,1,1,W
87446,22,SCO2,2022-11-12,Queens Park,Inverness CT,2,1,1,W
87447,22,SCO2,2022-11-19,Cove Rangers,Greenock Morton,1,2,-1,L
87448,22,SCO2,2022-11-19,FC Dundee,Hamilton Academical,1,0,1,W
87449,22,SCO2,2022-11-19,Inverness CT,Ayr United,2,2,0,D
87450,22,SCO2,2022-11-19,Partick Thistle,Arbroath,3,0,3,W
87451,22,SCO2,2022-11-19,Raith Rovers,Queens Park,2,5,-3,L
87452,22,SCO2,2022-12-03,Arbroath,Greenock Morton,1,1,0,D
87453,22,SCO2,2022-12-03,Ayr United,Raith Rovers,2,0,2,W
87454,22,SCO2,2022-12-03,Cove Rangers,Partick Thistle,1,1,0,D
87455,22,SCO2,2022-12-03,Inverness CT,FC Dundee,0,1,-1,L
87456,22,SCO2,2022-12-03,Queens Park,Hamilton Academical,4,0,4,W
87457,22,SCO2,2022-12-17,Partick Thistle,Ayr United,3,2,1,W
87458,22,SCO2,2022-12-17,Raith Rovers,Arbroath,1,1,0,D
87459,22,SCO2,2022-12-23,Arbroath,Queens Park,1,4,-3,L
87460,22,SCO2,2022-12-23,Ayr United,FC Dundee,0,2,-2,L
87461,22,SCO2,2022-12-23,Cove Rangers,Hamilton Academical,2,0,2,W
87462,22,SCO2,2022-12-23,Partick Thistle,Inverness CT,5,1,4,W
87463,22,SCO2,2022-12-23,Raith Rovers,Greenock Morton,2,2,0,D
87464,22,SCO2,2023-01-02,FC Dundee,Arbroath,2,4,-2,L
87465,22,SCO2,2023-01-02,Hamilton Academical,Raith Rovers,0,1,-1,L
87466,22,SCO2,2023-01-02,Inverness CT,Cove Rangers,6,1,5,W
87467,22,SCO2,2023-01-02,Queens Park,Partick Thistle,2,0,2,W
87468,22,SCO2,2023-01-06,Raith Rovers,FC Dundee,1,1,0,D
87469,22,SCO2,2023-01-07,Arbroath,Inverness CT,1,4,-3,L
87470,22,SCO2,2023-01-07,Ayr United,Hamilton Academical,1,0,1,W
87471,22,SCO2,2023-01-07,Partick Thistle,Greenock Morton,2,1,1,W
87472,22,SCO2,2023-01-07,Queens Park,Cove Rangers,6,0,6,W
87473,22,SCO2,2023-01-14,Ayr United,Arbroath,2,2,0,D
87474,22,SCO2,2023-01-14,Cove Rangers,Raith Rovers,2,2,0,D
87475,22,SCO2,2023-01-14,Hamilton Academical,Greenock Morton,1,0,1,W
87476,22,SCO2,2023-01-14,Inverness CT,Queens Park,0,0,0,D
87477,22,SCO2,2023-01-27,Cove Rangers,Ayr United,0,5,-5,L
87478,22,SCO2,2023-01-28,FC Dundee,Queens Park,3,0,3,W
87479,22,SCO2,2023-01-28,Greenock Morton,Arbroath,1,2,-1,L
87480,22,SCO2,2023-01-28,Partick Thistle,Hamilton Academical,0,1,-1,L
87481,22,SCO2,2023-01-28,Raith Rovers,Inverness CT,2,2,0,D
87482,22,SCO2,2023-02-03,Queens Park,Ayr United,2,0,2,W
87483,22,SCO2,2023-02-04,Arbroath,Raith Rovers,1,2,-1,L
87484,22,SCO2,2023-02-04,Hamilton Academical,FC Dundee,1,1,0,D
87485,22,SCO2,2023-02-04,Inverness CT,Greenock Morton,2,2,0,D
87486,22,SCO2,2023-02-04,Partick Thistle,Cove Rangers,0,1,-1,L
87487,22,SCO2,2023-02-11,Greenock Morton,Queens Park,3,2,1,W
87488,22,SCO2,2023-02-12,FC Dundee,Cove Rangers,3,0,3,W
87489,22,SCO2,2023-02-17,Greenock Morton,FC Dundee,1,0,1,W
87490,22,SCO2,2023-02-17,Queens Park,Raith Rovers,1,1,0,D
87491,22,SCO2,2023-02-18,Ayr United,Partick Thistle,0,1,-1,L
87492,22,SCO2,2023-02-18,Cove Rangers,Arbroath,1,1,0,D
87493,22,SCO2,2023-02-18,Inverness CT,Hamilton Academical,0,3,-3,L
87494,22,SCO2,2023-02-21,Hamilton Academical,Inverness CT,2,1,1,W
87495,22,SCO2,2023-02-24,Raith Rovers,Ayr United,0,0,0,D
87496,22,SCO2,2023-02-25,Arbroath,Partick Thistle,0,0,0,D
87497,22,SCO2,2023-02-25,FC Dundee,Inverness CT,1,1,0,D
87498,22,SCO2,2023-02-25,Hamilton Academical,Queens Park,1,4,-3,L
87499,22,SCO2,2023-02-25,Greenock Morton,Cove Rangers,2,1,1,W
87500,22,SCO2,2023-02-28,FC Dundee,Partick Thistle,1,3,-2,L
87501,22,SCO2,2023-03-03,Hamilton Academical,Arbroath,0,0,0,D
87502,22,SCO2,2023-03-04,Ayr United,Inverness CT,1,2,-1,L
87503,22,SCO2,2023-03-04,Cove Rangers,FC Dundee,0,2,-2,L
87504,22,SCO2,2023-03-04,Partick Thistle,Raith Rovers,3,0,3,W
87505,22,SCO2,2023-03-04,Queens Park,Greenock Morton,2,2,0,D
87506,22,SCO2,2023-03-07,Greenock Morton,Ayr United,1,3,-2,L
87507,22,SCO2,2023-03-10,Queens Park,Cove Rangers,1,0,1,W
87508,22,SCO2,2023-03-11,Greenock Morton,Partick Thistle,0,0,0,D
87509,22,SCO2,2023-03-17,Arbroath,Greenock Morton,1,1,0,D
87510,22,SCO2,2023-03-18,Hamilton Academical,Ayr United,0,2,-2,L
87511,22,SCO2,2023-03-18,Partick Thistle,FC Dundee,0,0,0,D
87512,22,SCO2,2023-03-18,Queens Park,Inverness CT,2,1,1,W
87513,22,SCO2,2023-03-18,Raith Rovers,Cove Rangers,6,1,5,W
87514,22,SCO2,2023-03-21,FC Dundee,Ayr United,3,1,2,W
87515,22,SCO2,2023-03-24,Ayr United,Cove Rangers,3,0,3,W
87516,22,SCO2,2023-03-24,Inverness CT,Partick Thistle,1,0,1,W
87517,22,SCO2,2023-03-24,Queens Park,Arbroath,0,1,-1,L
87518,22,SCO2,2023-03-31,Arbroath,Ayr United,2,0,2,W
87519,22,SCO2,2023-04-01,Cove Rangers,Partick Thistle,0,5,-5,L
87520,22,SCO2,2023-04-01,FC Dundee,Hamilton Academical,7,0,7,W
87521,22,SCO2,2023-04-01,Greenock Morton,Inverness CT,1,2,-1,L
87522,22,SCO2,2023-04-01,Raith Rovers,Queens Park,2,0,2,W
