,Sea,Lge,Date,HT,AT,HS,AS,GD,WDL
229618,4,CHL1,2004-02-06,Santiago Wanderers,CD Cobreloa,1,0,1,W
229619,4,CHL1,2004-02-07,Union Espanola,CD Palestino,3,5,-2,L
229620,4,CHL1,2004-02-07,Deportes Temuco,Universidad de Concepcion,0,5,-5,L
229621,4,CHL1,2004-02-07,Universidad Catolica,Audax Italiano,3,2,1,W
229622,4,CHL1,2004-02-07,CSD Rangers,La Serena,1,4,-3,L
229623,4,CHL1,2004-02-07,Coquimbo Unido,CD Cobresal,2,1,1,W
229624,4,CHL1,2004-02-08,Puerto Montt,Everton CD,3,2,1,W
229625,4,CHL1,2004-02-08,CD Huachipato,Union San Felipe,0,0,0,D
229626,4,CHL1,2004-02-08,Colo Colo,Universidad de Chile,0,4,-4,L
229627,4,CHL1,2004-02-13,Audax Italiano,Coquimbo Unido,5,2,3,W
229628,4,CHL1,2004-02-14,CD Palestino,Puerto Montt,2,0,2,W
229629,4,CHL1,2004-02-14,Universidad de Chile,CSD Rangers,2,0,2,W
229630,4,CHL1,2004-02-14,Universidad de Concepcion,Santiago Wanderers,2,1,1,W
229631,4,CHL1,2004-02-14,La Serena,Union Espanola,2,4,-2,L
229632,4,CHL1,2004-02-14,CD Cobresal,Colo Colo,0,1,-1,L
229633,4,CHL1,2004-02-15,Everton CD,Union San Felipe,0,1,-1,L
229634,4,CHL1,2004-02-15,CD Cobreloa,Universidad Catolica,2,1,1,W
229635,4,CHL1,2004-02-15,Deportes Temuco,CD Huachipato,1,3,-2,L
229636,4,CHL1,2004-02-20,Santiago Wanderers,Deportes Temuco,2,0,2,W
229637,4,CHL1,2004-02-21,CSD Rangers,CD Cobresal,2,4,-2,L
229638,4,CHL1,2004-02-21,Union Espanola,Universidad de Chile,3,1,2,W
229639,4,CHL1,2004-02-21,Union San Felipe,CD Palestino,2,3,-1,L
229640,4,CHL1,2004-02-21,Universidad Catolica,Universidad de Concepcion,3,4,-1,L
229641,4,CHL1,2004-02-21,Coquimbo Unido,CD Cobreloa,3,3,0,D
229642,4,CHL1,2004-02-22,Puerto Montt,La Serena,1,2,-1,L
229643,4,CHL1,2004-02-22,CD Huachipato,Everton CD,2,4,-2,L
229644,4,CHL1,2004-02-22,Colo Colo,Audax Italiano,2,1,1,W
229645,4,CHL1,2004-02-27,CD Palestino,Everton CD,4,0,4,W
229646,4,CHL1,2004-02-27,Universidad de Concepcion,Coquimbo Unido,5,0,5,W
229647,4,CHL1,2004-02-28,Deportes Temuco,Universidad Catolica,1,0,1,W
229648,4,CHL1,2004-02-28,Universidad de Chile,Puerto Montt,6,1,5,W
229649,4,CHL1,2004-02-28,Santiago Wanderers,CD Huachipato,0,2,-2,L
229650,4,CHL1,2004-02-28,La Serena,Union San Felipe,3,0,3,W
229651,4,CHL1,2004-02-29,CD Cobresal,Union Espanola,3,4,-1,L
229652,4,CHL1,2004-02-29,Audax Italiano,CSD Rangers,3,1,2,W
229653,4,CHL1,2004-02-29,CD Cobreloa,Colo Colo,3,0,3,W
229654,4,CHL1,2004-03-05,CD Huachipato,CD Palestino,3,2,1,W
229655,4,CHL1,2004-03-06,Union San Felipe,Universidad de Chile,1,0,1,W
229656,4,CHL1,2004-03-06,Colo Colo,Universidad de Concepcion,0,2,-2,L
229657,4,CHL1,2004-03-06,Union Espanola,Audax Italiano,2,0,2,W
229658,4,CHL1,2004-03-06,Everton CD,La Serena,2,0,2,W
229659,4,CHL1,2004-03-06,Coquimbo Unido,Deportes Temuco,4,3,1,W
229660,4,CHL1,2004-03-07,Puerto Montt,CD Cobresal,4,0,4,W
229661,4,CHL1,2004-03-07,Universidad Catolica,Santiago Wanderers,0,1,-1,L
229662,4,CHL1,2004-03-07,CSD Rangers,CD Cobreloa,0,2,-2,L
229663,4,CHL1,2004-03-09,La Serena,CD Palestino,3,2,1,W
229664,4,CHL1,2004-03-09,Universidad de Chile,Everton CD,0,0,0,D
229665,4,CHL1,2004-03-10,CD Cobresal,Union San Felipe,2,2,0,D
229666,4,CHL1,2004-03-10,Universidad Catolica,CD Huachipato,5,1,4,W
229667,4,CHL1,2004-03-10,Universidad de Concepcion,CSD Rangers,0,0,0,D
229668,4,CHL1,2004-03-10,Audax Italiano,Puerto Montt,2,2,0,D
229669,4,CHL1,2004-03-10,Santiago Wanderers,Coquimbo Unido,2,2,0,D
229670,4,CHL1,2004-03-10,Deportes Temuco,Colo Colo,0,1,-1,L
229671,4,CHL1,2004-03-13,Coquimbo Unido,Universidad Catolica,3,2,1,W
229672,4,CHL1,2004-03-13,Everton CD,CD Cobresal,1,0,1,W
229673,4,CHL1,2004-03-13,Union Espanola,Universidad de Concepcion,2,2,0,D
229674,4,CHL1,2004-03-14,Puerto Montt,CD Cobreloa,1,1,0,D
229675,4,CHL1,2004-03-14,CD Huachipato,La Serena,4,2,2,W
229676,4,CHL1,2004-03-14,CSD Rangers,Deportes Temuco,2,3,-1,L
229677,4,CHL1,2004-03-14,Union San Felipe,Audax Italiano,1,1,0,D
229678,4,CHL1,2004-03-14,CD Palestino,Universidad de Chile,2,3,-1,L
229679,4,CHL1,2004-03-14,Colo Colo,Santiago Wanderers,4,1,3,W
229680,4,CHL1,2004-03-17,CD Cobreloa,Union Espanola,2,2,0,D
229681,4,CHL1,2004-03-19,Coquimbo Unido,CD Huachipato,3,2,1,W
229682,4,CHL1,2004-03-20,Universidad de Chile,La Serena,3,1,2,W
229683,4,CHL1,2004-03-21,Universidad de Concepcion,Puerto Montt,1,1,0,D
229684,4,CHL1,2004-03-21,Deportes Temuco,Union Espanola,2,2,0,D
229685,4,CHL1,2004-03-21,CD Cobresal,CD Palestino,3,3,0,D
229686,4,CHL1,2004-03-21,CD Cobreloa,Union San Felipe,3,1,2,W
229687,4,CHL1,2004-03-21,Santiago Wanderers,CSD Rangers,3,0,3,W
229688,4,CHL1,2004-03-21,Audax Italiano,Everton CD,1,1,0,D
229689,4,CHL1,2004-03-21,Universidad Catolica,Colo Colo,1,2,-1,L
229690,4,CHL1,2004-03-27,CD Palestino,Universidad de Concepcion,0,1,-1,L
229691,4,CHL1,2004-04-02,Union Espanola,Santiago Wanderers,0,1,-1,L
229692,4,CHL1,2004-04-03,CD Huachipato,Universidad de Chile,2,1,1,W
229693,4,CHL1,2004-04-03,Colo Colo,Coquimbo Unido,2,1,1,W
229694,4,CHL1,2004-04-04,La Serena,CD Cobresal,4,3,1,W
229695,4,CHL1,2004-04-04,Puerto Montt,Deportes Temuco,0,1,-1,L
229696,4,CHL1,2004-04-04,Everton CD,CD Cobreloa,1,3,-2,L
229697,4,CHL1,2004-04-04,CD Palestino,Audax Italiano,3,5,-2,L
229698,4,CHL1,2004-04-04,Union San Felipe,Universidad de Concepcion,1,0,1,W
229699,4,CHL1,2004-04-04,CSD Rangers,Universidad Catolica,2,1,1,W
229700,4,CHL1,2004-04-09,Coquimbo Unido,CSD Rangers,4,2,2,W
229701,4,CHL1,2004-04-09,Audax Italiano,La Serena,3,3,0,D
229702,4,CHL1,2004-04-09,Universidad de Concepcion,Everton CD,2,4,-2,L
229703,4,CHL1,2004-04-10,Universidad Catolica,Union Espanola,0,4,-4,L
229704,4,CHL1,2004-04-10,CD Cobresal,Universidad de Chile,0,1,-1,L
229705,4,CHL1,2004-04-11,CD Cobreloa,CD Palestino,6,1,5,W
229706,4,CHL1,2004-04-11,Deportes Temuco,Union San Felipe,1,0,1,W
229707,4,CHL1,2004-04-11,Santiago Wanderers,Puerto Montt,5,0,5,W
229708,4,CHL1,2004-04-11,Colo Colo,CD Huachipato,2,4,-2,L
229709,4,CHL1,2004-04-14,Universidad de Chile,Audax Italiano,0,1,-1,L
229710,4,CHL1,2004-04-14,CD Huachipato,CD Cobresal,3,1,2,W
229711,4,CHL1,2004-04-14,Puerto Montt,Universidad Catolica,1,1,0,D
229712,4,CHL1,2004-04-14,Union Espanola,Coquimbo Unido,2,1,1,W
229713,4,CHL1,2004-04-14,Union San Felipe,Santiago Wanderers,0,2,-2,L
229714,4,CHL1,2004-04-14,Everton CD,Deportes Temuco,5,0,5,W
229715,4,CHL1,2004-04-15,CSD Rangers,Colo Colo,1,2,-1,L
229716,4,CHL1,2004-04-15,La Serena,CD Cobreloa,1,2,-1,L
229717,4,CHL1,2004-04-17,Universidad Catolica,Union San Felipe,4,0,4,W
229718,4,CHL1,2004-04-17,Audax Italiano,CD Cobresal,4,0,4,W
229719,4,CHL1,2004-04-17,Colo Colo,Union Espanola,4,1,3,W
229720,4,CHL1,2004-04-18,Coquimbo Unido,Puerto Montt,4,0,4,W
229721,4,CHL1,2004-04-18,Universidad de Concepcion,La Serena,5,0,5,W
229722,4,CHL1,2004-04-18,Deportes Temuco,CD Palestino,2,1,1,W
229723,4,CHL1,2004-04-18,CSD Rangers,CD Huachipato,2,2,0,D
229724,4,CHL1,2004-04-18,Santiago Wanderers,Everton CD,4,0,4,W
229725,4,CHL1,2004-04-18,CD Cobreloa,Universidad de Chile,3,0,3,W
229726,4,CHL1,2004-04-21,CD Huachipato,Audax Italiano,2,0,2,W
229727,4,CHL1,2004-04-21,CD Cobresal,CD Cobreloa,2,3,-1,L
229728,4,CHL1,2004-04-21,Union Espanola,CSD Rangers,1,2,-1,L
229729,4,CHL1,2004-04-22,Union San Felipe,Coquimbo Unido,2,1,1,W
229730,4,CHL1,2004-04-22,La Serena,Deportes Temuco,2,2,0,D
229731,4,CHL1,2004-04-22,Universidad de Chile,Universidad de Concepcion,3,1,2,W
229732,4,CHL1,2004-04-22,CD Palestino,Santiago Wanderers,2,4,-2,L
229733,4,CHL1,2004-04-23,Everton CD,Universidad Catolica,2,0,2,W
229734,4,CHL1,2004-04-24,Deportes Temuco,Universidad de Chile,3,3,0,D
229735,4,CHL1,2004-04-24,Universidad de Concepcion,CD Cobresal,0,0,0,D
229736,4,CHL1,2004-04-24,Union Espanola,CD Huachipato,2,1,1,W
229737,4,CHL1,2004-04-25,Universidad Catolica,CD Palestino,2,1,1,W
229738,4,CHL1,2004-04-25,CD Cobreloa,Audax Italiano,1,1,0,D
229739,4,CHL1,2004-04-25,CSD Rangers,Puerto Montt,3,2,1,W
229740,4,CHL1,2004-04-25,Santiago Wanderers,La Serena,5,0,5,W
229741,4,CHL1,2004-04-25,Coquimbo Unido,Everton CD,2,0,2,W
229742,4,CHL1,2004-04-25,Colo Colo,Union San Felipe,1,1,0,D
229743,4,CHL1,2004-04-29,Puerto Montt,Colo Colo,3,3,0,D
229744,4,CHL1,2004-04-30,La Serena,Universidad Catolica,1,4,-3,L
229745,4,CHL1,2004-04-30,Universidad de Chile,Santiago Wanderers,2,2,0,D
229746,4,CHL1,2004-05-02,Puerto Montt,Union Espanola,4,1,3,W
229747,4,CHL1,2004-05-02,Union San Felipe,CSD Rangers,0,2,-2,L
229748,4,CHL1,2004-05-02,CD Palestino,Coquimbo Unido,2,3,-1,L
229749,4,CHL1,2004-05-02,CD Huachipato,CD Cobreloa,1,2,-1,L
229750,4,CHL1,2004-05-02,CD Cobresal,Deportes Temuco,0,3,-3,L
229751,4,CHL1,2004-05-02,Audax Italiano,Universidad de Concepcion,0,2,-2,L
229752,4,CHL1,2004-05-02,Everton CD,Colo Colo,0,2,-2,L
229753,4,CHL1,2004-05-04,Universidad Catolica,Universidad de Chile,1,2,-1,L
229754,4,CHL1,2004-05-05,Universidad de Concepcion,CD Cobreloa,3,0,3,W
229755,4,CHL1,2004-05-05,Puerto Montt,CD Huachipato,2,1,1,W
229756,4,CHL1,2004-05-06,Santiago Wanderers,CD Cobresal,2,0,2,W
229757,4,CHL1,2004-05-06,Colo Colo,CD Palestino,2,1,1,W
229758,4,CHL1,2004-05-06,CSD Rangers,Everton CD,1,0,1,W
229759,4,CHL1,2004-05-06,Union Espanola,Union San Felipe,2,2,0,D
229760,4,CHL1,2004-05-06,Deportes Temuco,Audax Italiano,2,1,1,W
229761,4,CHL1,2004-05-07,Coquimbo Unido,La Serena,4,3,1,W
229762,4,CHL1,2004-05-08,CD Cobresal,Universidad Catolica,0,1,-1,L
229763,4,CHL1,2004-05-09,Everton CD,Union Espanola,0,0,0,D
229764,4,CHL1,2004-05-09,Union San Felipe,Puerto Montt,1,2,-1,L
229765,4,CHL1,2004-05-09,CD Palestino,CSD Rangers,0,0,0,D
229766,4,CHL1,2004-05-09,CD Huachipato,Universidad de Concepcion,2,2,0,D
229767,4,CHL1,2004-05-09,La Serena,Colo Colo,1,1,0,D
229768,4,CHL1,2004-05-09,CD Cobreloa,Deportes Temuco,3,0,3,W
229769,4,CHL1,2004-05-09,Universidad de Chile,Coquimbo Unido,1,0,1,W
229770,4,CHL1,2004-05-10,Audax Italiano,Santiago Wanderers,1,1,0,D
229771,4,CHL1,2004-07-31,CD Cobreloa,Santiago Wanderers,1,1,0,D
229772,4,CHL1,2004-07-31,CD Palestino,Union Espanola,2,1,1,W
229773,4,CHL1,2004-07-31,Audax Italiano,Universidad Catolica,2,3,-1,L
229774,4,CHL1,2004-08-01,Everton CD,Puerto Montt,1,1,0,D
229775,4,CHL1,2004-08-01,Universidad de Concepcion,Deportes Temuco,0,0,0,D
229776,4,CHL1,2004-08-01,Union San Felipe,CD Huachipato,1,0,1,W
229777,4,CHL1,2004-08-01,Universidad de Chile,Colo Colo,0,1,-1,L
229778,4,CHL1,2004-08-01,La Serena,CSD Rangers,1,1,0,D
229779,4,CHL1,2004-08-01,CD Cobresal,Coquimbo Unido,2,1,1,W
229780,4,CHL1,2004-08-07,CSD Rangers,Universidad de Chile,0,1,-1,L
229781,4,CHL1,2004-08-07,Puerto Montt,CD Palestino,1,0,1,W
229782,4,CHL1,2004-08-07,CD Huachipato,Deportes Temuco,2,2,0,D
229783,4,CHL1,2004-08-07,Coquimbo Unido,Audax Italiano,1,3,-2,L
229784,4,CHL1,2004-08-07,Universidad Catolica,CD Cobreloa,2,1,1,W
229785,4,CHL1,2004-08-07,Union San Felipe,Everton CD,1,1,0,D
229786,4,CHL1,2004-08-08,Union Espanola,La Serena,1,1,0,D
229787,4,CHL1,2004-08-08,Santiago Wanderers,Universidad de Concepcion,0,1,-1,L
229788,4,CHL1,2004-08-08,Colo Colo,CD Cobresal,4,0,4,W
229789,4,CHL1,2004-08-10,Universidad de Concepcion,Universidad Catolica,4,1,3,W
229790,4,CHL1,2004-08-11,CD Palestino,Union San Felipe,2,1,1,W
229791,4,CHL1,2004-08-11,CD Cobreloa,Coquimbo Unido,3,1,2,W
229792,4,CHL1,2004-08-11,Universidad de Chile,Union Espanola,2,2,0,D
229793,4,CHL1,2004-08-11,Deportes Temuco,Santiago Wanderers,3,3,0,D
229794,4,CHL1,2004-08-12,Everton CD,CD Huachipato,2,0,2,W
229795,4,CHL1,2004-08-12,La Serena,Puerto Montt,0,1,-1,L
229796,4,CHL1,2004-08-12,CD Cobresal,CSD Rangers,2,1,1,W
229797,4,CHL1,2004-08-12,Audax Italiano,Colo Colo,1,2,-1,L
229798,4,CHL1,2004-08-14,Puerto Montt,Universidad de Chile,2,0,2,W
229799,4,CHL1,2004-08-14,Universidad Catolica,Deportes Temuco,3,2,1,W
229800,4,CHL1,2004-08-15,Colo Colo,CD Cobreloa,2,2,0,D
229801,4,CHL1,2004-08-15,CD Huachipato,Santiago Wanderers,1,2,-1,L
229802,4,CHL1,2004-08-15,Union San Felipe,La Serena,2,0,2,W
229803,4,CHL1,2004-08-15,CSD Rangers,Audax Italiano,1,2,-1,L
229804,4,CHL1,2004-08-15,Everton CD,CD Palestino,0,1,-1,L
229805,4,CHL1,2004-08-15,Coquimbo Unido,Universidad de Concepcion,2,0,2,W
229806,4,CHL1,2004-08-15,Union Espanola,CD Cobresal,1,2,-1,L
229807,4,CHL1,2004-08-20,CD Palestino,CD Huachipato,2,3,-1,L
229808,4,CHL1,2004-08-21,Universidad de Concepcion,Colo Colo,2,0,2,W
229809,4,CHL1,2004-08-21,Universidad de Chile,Union San Felipe,3,0,3,W
229810,4,CHL1,2004-08-22,La Serena,Everton CD,3,0,3,W
229811,4,CHL1,2004-08-22,CD Cobreloa,CSD Rangers,5,2,3,W
229812,4,CHL1,2004-08-22,Audax Italiano,Union Espanola,1,1,0,D
229813,4,CHL1,2004-08-22,Deportes Temuco,Coquimbo Unido,1,1,0,D
229814,4,CHL1,2004-08-22,Santiago Wanderers,Universidad Catolica,1,3,-2,L
229815,4,CHL1,2004-08-22,CD Cobresal,Puerto Montt,4,2,2,W
229816,4,CHL1,2004-08-27,Union San Felipe,CD Cobresal,1,1,0,D
229817,4,CHL1,2004-08-28,CD Palestino,La Serena,5,1,4,W
229818,4,CHL1,2004-08-28,CD Huachipato,Universidad Catolica,1,2,-1,L
229819,4,CHL1,2004-08-28,CSD Rangers,Universidad de Concepcion,2,1,1,W
229820,4,CHL1,2004-08-28,Union Espanola,CD Cobreloa,2,0,2,W
229821,4,CHL1,2004-08-28,Colo Colo,Deportes Temuco,2,1,1,W
229822,4,CHL1,2004-08-28,Coquimbo Unido,Santiago Wanderers,3,2,1,W
229823,4,CHL1,2004-08-29,Puerto Montt,Audax Italiano,0,2,-2,L
229824,4,CHL1,2004-08-29,Everton CD,Universidad de Chile,0,0,0,D
229825,4,CHL1,2004-09-07,CD Cobresal,Everton CD,0,1,-1,L
229826,4,CHL1,2004-09-08,CD Cobreloa,Puerto Montt,2,1,1,W
229827,4,CHL1,2004-09-08,Universidad de Chile,CD Palestino,4,1,3,W
229828,4,CHL1,2004-09-08,Deportes Temuco,CSD Rangers,2,2,0,D
229829,4,CHL1,2004-09-09,Audax Italiano,Union San Felipe,3,1,2,W
229830,4,CHL1,2004-09-09,La Serena,CD Huachipato,1,3,-2,L
229831,4,CHL1,2004-09-09,Universidad Catolica,Coquimbo Unido,3,3,0,D
229832,4,CHL1,2004-09-11,CD Palestino,CD Cobresal,1,0,1,W
229833,4,CHL1,2004-09-11,Puerto Montt,Universidad de Concepcion,0,0,0,D
229834,4,CHL1,2004-09-11,Union San Felipe,CD Cobreloa,1,3,-2,L
229835,4,CHL1,2004-09-12,La Serena,Universidad de Chile,1,3,-2,L
229836,4,CHL1,2004-09-12,CD Huachipato,Coquimbo Unido,1,0,1,W
229837,4,CHL1,2004-09-12,Everton CD,Audax Italiano,4,2,2,W
229838,4,CHL1,2004-09-12,Union Espanola,Deportes Temuco,2,3,-1,L
229839,4,CHL1,2004-09-12,CSD Rangers,Santiago Wanderers,4,2,2,W
229840,4,CHL1,2004-09-12,Colo Colo,Universidad Catolica,1,1,0,D
229841,4,CHL1,2004-09-16,Audax Italiano,CD Palestino,0,0,0,D
229842,4,CHL1,2004-09-17,Universidad de Chile,CD Huachipato,2,1,1,W
229843,4,CHL1,2004-09-17,Deportes Temuco,Puerto Montt,4,2,2,W
229844,4,CHL1,2004-09-17,Santiago Wanderers,Union Espanola,0,1,-1,L
229845,4,CHL1,2004-09-17,Universidad de Concepcion,Union San Felipe,1,1,0,D
229846,4,CHL1,2004-09-17,CD Cobresal,La Serena,6,1,5,W
229847,4,CHL1,2004-09-17,CD Cobreloa,Everton CD,6,0,6,W
229848,4,CHL1,2004-09-17,Universidad Catolica,CSD Rangers,0,0,0,D
229849,4,CHL1,2004-09-24,CD Palestino,CD Cobreloa,1,1,0,D
229850,4,CHL1,2004-09-25,CD Huachipato,Colo Colo,2,2,0,D
229851,4,CHL1,2004-09-25,Union Espanola,Universidad Catolica,1,2,-1,L
229852,4,CHL1,2004-09-25,Everton CD,Universidad de Concepcion,2,1,1,W
229853,4,CHL1,2004-09-26,Union San Felipe,Deportes Temuco,1,0,1,W
229854,4,CHL1,2004-09-26,CSD Rangers,Coquimbo Unido,0,0,0,D
229855,4,CHL1,2004-09-26,Puerto Montt,Santiago Wanderers,1,0,1,W
229856,4,CHL1,2004-09-26,La Serena,Audax Italiano,3,1,2,W
229857,4,CHL1,2004-09-26,Universidad de Chile,CD Cobresal,2,0,2,W
229858,4,CHL1,2004-09-30,Santiago Wanderers,Colo Colo,1,2,-1,L
229859,4,CHL1,2004-10-01,Universidad de Concepcion,CD Palestino,2,0,2,W
229860,4,CHL1,2004-10-02,Universidad Catolica,Puerto Montt,0,0,0,D
229861,4,CHL1,2004-10-02,Audax Italiano,Universidad de Chile,1,1,0,D
229862,4,CHL1,2004-10-03,Coquimbo Unido,Union Espanola,2,2,0,D
229863,4,CHL1,2004-10-03,Colo Colo,CSD Rangers,0,0,0,D
229864,4,CHL1,2004-10-03,CD Cobresal,CD Huachipato,1,3,-2,L
229865,4,CHL1,2004-10-03,CD Cobreloa,La Serena,1,1,0,D
229866,4,CHL1,2004-10-03,Santiago Wanderers,Union San Felipe,2,4,-2,L
229867,4,CHL1,2004-10-03,Deportes Temuco,Everton CD,2,1,1,W
229868,4,CHL1,2004-10-09,Universidad de Concepcion,Union Espanola,1,0,1,W
229869,4,CHL1,2004-10-16,Puerto Montt,Coquimbo Unido,0,2,-2,L
229870,4,CHL1,2004-10-16,CD Palestino,Deportes Temuco,1,2,-1,L
229871,4,CHL1,2004-10-16,CD Cobresal,Audax Italiano,1,1,0,D
229872,4,CHL1,2004-10-16,CD Huachipato,CSD Rangers,4,0,4,W
229873,4,CHL1,2004-10-16,Union Espanola,Colo Colo,3,0,3,W
229874,4,CHL1,2004-10-16,La Serena,Universidad de Concepcion,0,1,-1,L
229875,4,CHL1,2004-10-17,Union San Felipe,Universidad Catolica,1,0,1,W
229876,4,CHL1,2004-10-17,Everton CD,Santiago Wanderers,0,1,-1,L
229877,4,CHL1,2004-10-17,Universidad de Chile,CD Cobreloa,2,1,1,W
229878,4,CHL1,2004-10-20,CD Cobreloa,CD Cobresal,1,1,0,D
229879,4,CHL1,2004-10-20,Audax Italiano,CD Huachipato,3,0,3,W
229880,4,CHL1,2004-10-20,CSD Rangers,Union Espanola,3,2,1,W
229881,4,CHL1,2004-10-20,Deportes Temuco,La Serena,3,3,0,D
229882,4,CHL1,2004-10-20,Santiago Wanderers,CD Palestino,2,0,2,W
229883,4,CHL1,2004-10-20,Coquimbo Unido,Union San Felipe,0,0,0,D
229884,4,CHL1,2004-10-20,Colo Colo,Puerto Montt,1,0,1,W
229885,4,CHL1,2004-10-21,Universidad Catolica,Everton CD,5,0,5,W
229886,4,CHL1,2004-10-23,Audax Italiano,CD Cobreloa,2,2,0,D
229887,4,CHL1,2004-10-23,Universidad de Chile,Deportes Temuco,2,2,0,D
229888,4,CHL1,2004-10-24,CD Cobresal,Universidad de Concepcion,3,2,1,W
229889,4,CHL1,2004-10-24,Union San Felipe,Colo Colo,1,5,-4,L
229890,4,CHL1,2004-10-24,Puerto Montt,CSD Rangers,3,0,3,W
229891,4,CHL1,2004-10-24,CD Huachipato,Union Espanola,0,1,-1,L
229892,4,CHL1,2004-10-24,Everton CD,Coquimbo Unido,2,0,2,W
229893,4,CHL1,2004-10-24,La Serena,Santiago Wanderers,3,2,1,W
229894,4,CHL1,2004-10-24,CD Palestino,Universidad Catolica,0,3,-3,L
229895,4,CHL1,2004-10-27,Deportes Temuco,CD Cobresal,3,3,0,D
229896,4,CHL1,2004-10-28,CD Cobreloa,CD Huachipato,2,0,2,W
229897,4,CHL1,2004-10-28,Universidad de Concepcion,Audax Italiano,1,3,-2,L
229898,4,CHL1,2004-10-28,Union Espanola,Puerto Montt,0,0,0,D
229899,4,CHL1,2004-10-28,Colo Colo,Everton CD,1,1,0,D
229900,4,CHL1,2004-10-29,Universidad Catolica,La Serena,4,1,3,W
229901,4,CHL1,2004-10-29,CSD Rangers,Union San Felipe,1,1,0,D
229902,4,CHL1,2004-10-29,Santiago Wanderers,Universidad de Chile,1,2,-1,L
229903,4,CHL1,2004-10-29,Coquimbo Unido,CD Palestino,2,2,0,D
229904,4,CHL1,2004-11-02,CD Huachipato,Puerto Montt,3,1,2,W
229905,4,CHL1,2004-11-02,CD Palestino,Colo Colo,2,3,-1,L
229906,4,CHL1,2004-11-03,CD Cobresal,Santiago Wanderers,5,1,4,W
229907,4,CHL1,2004-11-03,CD Cobreloa,Universidad de Concepcion,2,3,-1,L
229908,4,CHL1,2004-11-03,Everton CD,CSD Rangers,4,0,4,W
229909,4,CHL1,2004-11-03,Audax Italiano,Deportes Temuco,4,0,4,W
229910,4,CHL1,2004-11-03,Union San Felipe,Union Espanola,0,2,-2,L
229911,4,CHL1,2004-11-03,La Serena,Coquimbo Unido,2,1,1,W
229912,4,CHL1,2004-11-04,Universidad de Chile,Universidad Catolica,0,0,0,D
229913,4,CHL1,2004-11-06,Santiago Wanderers,Audax Italiano,3,2,1,W
229914,4,CHL1,2004-11-06,Colo Colo,La Serena,3,1,2,W
229915,4,CHL1,2004-11-07,Coquimbo Unido,Universidad de Chile,1,3,-2,L
229916,4,CHL1,2004-11-07,Puerto Montt,Union San Felipe,1,1,0,D
229917,4,CHL1,2004-11-07,Deportes Temuco,CD Cobreloa,4,4,0,D
229918,4,CHL1,2004-11-07,Union Espanola,Everton CD,2,1,1,W
229919,4,CHL1,2004-11-07,Universidad de Concepcion,CD Huachipato,2,0,2,W
229920,4,CHL1,2004-11-07,CSD Rangers,CD Palestino,2,3,-1,L
229921,4,CHL1,2004-11-07,Universidad Catolica,CD Cobresal,0,1,-1,L
229922,4,CHL1,2004-11-10,Coquimbo Unido,Colo Colo,1,0,1,W
229923,4,CHL1,2004-11-14,Universidad de Concepcion,Universidad de Chile,0,0,0,D
229924,5,CHL1,2005-01-21,CD Huachipato,La Serena,4,1,3,W
229925,5,CHL1,2005-01-22,CD Palestino,CSD Rangers,3,1,2,W
229926,5,CHL1,2005-01-22,Deportes Temuco,CD Cobresal,1,1,0,D
229927,5,CHL1,2005-01-22,Coquimbo Unido,Deportes Concepcion,2,0,2,W
229928,5,CHL1,2005-01-23,Everton CD,Universidad de Chile,3,2,1,W
229929,5,CHL1,2005-01-23,Union San Felipe,Santiago Wanderers,3,2,1,W
229930,5,CHL1,2005-01-23,Colo Colo,Puerto Montt,2,0,2,W
229931,5,CHL1,2005-01-23,Universidad Catolica,Deportes Melipilla,5,0,5,W
229932,5,CHL1,2005-01-28,Audax Italiano,Everton CD,1,1,0,D
229933,5,CHL1,2005-01-28,CSD Rangers,Union Espanola,0,0,0,D
229934,5,CHL1,2005-01-29,Santiago Wanderers,Colo Colo,1,1,0,D
229935,5,CHL1,2005-01-29,CD Cobreloa,CD Palestino,1,0,1,W
229936,5,CHL1,2005-01-29,Puerto Montt,Universidad Catolica,1,2,-1,L
229937,5,CHL1,2005-01-29,Deportes Concepcion,CD Huachipato,1,1,0,D
229938,5,CHL1,2005-01-29,Deportes Melipilla,Deportes Temuco,0,0,0,D
229939,5,CHL1,2005-01-30,La Serena,Universidad de Concepcion,2,0,2,W
229940,5,CHL1,2005-01-30,CD Cobresal,Coquimbo Unido,2,1,1,W
229941,5,CHL1,2005-01-30,Universidad de Chile,Union San Felipe,2,0,2,W
229942,5,CHL1,2005-02-01,Union Espanola,Audax Italiano,3,3,0,D
229943,5,CHL1,2005-02-01,Everton CD,Universidad de Concepcion,1,1,0,D
229944,5,CHL1,2005-02-02,CD Huachipato,CD Cobreloa,5,4,1,W
229945,5,CHL1,2005-02-02,Deportes Temuco,Universidad Catolica,1,2,-1,L
229946,5,CHL1,2005-02-02,Puerto Montt,Deportes Melipilla,0,1,-1,L
229947,5,CHL1,2005-02-02,Deportes Concepcion,Santiago Wanderers,2,1,1,W
229948,5,CHL1,2005-02-02,CSD Rangers,La Serena,1,2,-1,L
229949,5,CHL1,2005-02-03,CD Palestino,Union San Felipe,1,2,-1,L
229950,5,CHL1,2005-02-03,Coquimbo Unido,Universidad de Chile,1,3,-2,L
229951,5,CHL1,2005-02-05,Audax Italiano,Colo Colo,1,1,0,D
229952,5,CHL1,2005-02-05,Santiago Wanderers,Everton CD,4,1,3,W
229953,5,CHL1,2005-02-06,Union San Felipe,CSD Rangers,0,1,-1,L
229954,5,CHL1,2005-02-06,CD Cobresal,Puerto Montt,3,0,3,W
229955,5,CHL1,2005-02-06,Universidad de Concepcion,CD Cobreloa,0,1,-1,L
229956,5,CHL1,2005-02-06,Deportes Melipilla,Coquimbo Unido,0,1,-1,L
229957,5,CHL1,2005-02-06,Deportes Temuco,CD Huachipato,1,2,-1,L
229958,5,CHL1,2005-02-06,Universidad de Chile,CD Palestino,2,0,2,W
229959,5,CHL1,2005-02-06,Universidad Catolica,Union Espanola,1,1,0,D
229960,5,CHL1,2005-02-06,La Serena,Deportes Concepcion,2,2,0,D
229961,5,CHL1,2005-02-11,CSD Rangers,Deportes Melipilla,1,1,0,D
229962,5,CHL1,2005-02-12,Union Espanola,Everton CD,2,2,0,D
229963,5,CHL1,2005-02-12,CD Cobreloa,Deportes Temuco,5,4,1,W
229964,5,CHL1,2005-02-12,Puerto Montt,Universidad de Chile,0,1,-1,L
229965,5,CHL1,2005-02-12,Union San Felipe,La Serena,0,0,0,D
229966,5,CHL1,2005-02-12,Santiago Wanderers,CD Cobresal,1,3,-2,L
229967,5,CHL1,2005-02-12,Coquimbo Unido,Audax Italiano,1,0,1,W
229968,5,CHL1,2005-02-13,Colo Colo,Universidad de Concepcion,0,1,-1,L
229969,5,CHL1,2005-02-13,CD Palestino,CD Huachipato,2,3,-1,L
229970,5,CHL1,2005-02-13,Deportes Concepcion,Universidad Catolica,1,0,1,W
229971,5,CHL1,2005-02-19,CD Huachipato,CSD Rangers,0,1,-1,L
229972,5,CHL1,2005-02-19,Audax Italiano,CD Palestino,0,2,-2,L
229973,5,CHL1,2005-02-19,Universidad de Concepcion,Union San Felipe,2,0,2,W
229974,5,CHL1,2005-02-19,Everton CD,Puerto Montt,3,2,1,W
229975,5,CHL1,2005-02-19,La Serena,Colo Colo,3,7,-4,L
229976,5,CHL1,2005-02-20,CD Cobresal,Union Espanola,4,3,1,W
229977,5,CHL1,2005-02-20,Deportes Melipilla,CD Cobreloa,0,1,-1,L
229978,5,CHL1,2005-02-20,Universidad Catolica,Santiago Wanderers,3,0,3,W
229979,5,CHL1,2005-02-20,Deportes Temuco,Coquimbo Unido,2,1,1,W
229980,5,CHL1,2005-02-26,Union San Felipe,Universidad Catolica,0,2,-2,L
229981,5,CHL1,2005-02-26,Union Espanola,La Serena,1,2,-1,L
229982,5,CHL1,2005-02-26,Santiago Wanderers,Deportes Temuco,0,1,-1,L
229983,5,CHL1,2005-02-26,CSD Rangers,Audax Italiano,2,0,2,W
229984,5,CHL1,2005-02-26,Colo Colo,Everton CD,2,1,1,W
229985,5,CHL1,2005-02-26,Coquimbo Unido,Universidad de Concepcion,3,1,2,W
229986,5,CHL1,2005-02-27,CD Huachipato,CD Cobresal,0,2,-2,L
229987,5,CHL1,2005-02-27,CD Palestino,Puerto Montt,0,3,-3,L
229988,5,CHL1,2005-02-27,CD Cobreloa,Universidad de Chile,1,1,0,D
229989,5,CHL1,2005-02-27,Deportes Concepcion,Deportes Melipilla,0,0,0,D
229990,5,CHL1,2005-03-02,Universidad de Concepcion,Audax Italiano,3,0,3,W
229991,5,CHL1,2005-03-02,Colo Colo,CD Cobresal,2,2,0,D
229992,5,CHL1,2005-03-05,CD Cobreloa,CSD Rangers,1,1,0,D
229993,5,CHL1,2005-03-05,Deportes Temuco,Colo Colo,1,2,-1,L
229994,5,CHL1,2005-03-05,Everton CD,Coquimbo Unido,0,1,-1,L
229995,5,CHL1,2005-03-05,Universidad de Chile,Santiago Wanderers,3,0,3,W
229996,5,CHL1,2005-03-05,La Serena,CD Palestino,4,0,4,W
229997,5,CHL1,2005-03-06,Puerto Montt,Union San Felipe,1,0,1,W
229998,5,CHL1,2005-03-06,CD Cobresal,Deportes Concepcion,0,1,-1,L
229999,5,CHL1,2005-03-06,Deportes Melipilla,Union Espanola,1,2,-1,L
230000,5,CHL1,2005-03-06,Universidad de Concepcion,CD Huachipato,2,0,2,W
230001,5,CHL1,2005-03-06,Universidad Catolica,Audax Italiano,2,1,1,W
230002,5,CHL1,2005-03-11,CSD Rangers,Universidad de Concepcion,1,1,0,D
230003,5,CHL1,2005-03-12,Audax Italiano,Deportes Temuco,1,2,-1,L
230004,5,CHL1,2005-03-12,CD Huachipato,Universidad de Chile,1,0,1,W
230005,5,CHL1,2005-03-12,Union Espanola,Coquimbo Unido,4,2,2,W
230006,5,CHL1,2005-03-12,La Serena,Universidad Catolica,0,1,-1,L
230007,5,CHL1,2005-03-12,Union San Felipe,Everton CD,0,2,-2,L
230008,5,CHL1,2005-03-13,Santiago Wanderers,Deportes Melipilla,3,0,3,W
230009,5,CHL1,2005-03-13,Deportes Concepcion,Puerto Montt,1,1,0,D
230010,5,CHL1,2005-03-13,CD Palestino,CD Cobresal,0,0,0,D
230011,5,CHL1,2005-03-13,Colo Colo,CD Cobreloa,2,0,2,W
230012,5,CHL1,2005-03-18,Everton CD,CD Huachipato,1,3,-2,L
230013,5,CHL1,2005-03-18,CD Cobreloa,Deportes Concepcion,2,1,1,W
230014,5,CHL1,2005-03-19,Universidad Catolica,Colo Colo,1,0,1,W
230015,5,CHL1,2005-03-19,Coquimbo Unido,Union San Felipe,1,0,1,W
230016,5,CHL1,2005-03-19,CD Cobresal,La Serena,0,1,-1,L
230017,5,CHL1,2005-03-20,Puerto Montt,Santiago Wanderers,3,1,2,W
230018,5,CHL1,2005-03-20,Deportes Melipilla,CD Palestino,1,3,-2,L
230019,5,CHL1,2005-03-20,Deportes Temuco,CSD Rangers,1,1,0,D
230020,5,CHL1,2005-03-20,Universidad de Concepcion,Union Espanola,0,0,0,D
230021,5,CHL1,2005-03-20,Universidad de Chile,Audax Italiano,3,1,2,W
230022,5,CHL1,2005-04-02,CD Palestino,Universidad Catolica,0,1,-1,L
230023,5,CHL1,2005-04-02,Audax Italiano,CD Cobreloa,3,0,3,W
230024,5,CHL1,2005-04-02,Colo Colo,Coquimbo Unido,2,0,2,W
230025,5,CHL1,2005-04-02,Union San Felipe,CD Cobresal,1,2,-1,L
230026,5,CHL1,2005-04-02,Everton CD,Deportes Temuco,3,0,3,W
230027,5,CHL1,2005-04-02,La Serena,Santiago Wanderers,2,3,-1,L
230028,5,CHL1,2005-04-03,CD Huachipato,Puerto Montt,1,4,-3,L
230029,5,CHL1,2005-04-03,Universidad de Concepcion,Deportes Melipilla,1,2,-1,L
230030,5,CHL1,2005-04-03,CSD Rangers,Deportes Concepcion,1,1,0,D
230031,5,CHL1,2005-04-03,Union Espanola,Universidad de Chile,0,2,-2,L
230032,5,CHL1,2005-04-09,Coquimbo Unido,CSD Rangers,0,0,0,D
230033,5,CHL1,2005-04-09,CD Cobreloa,Union San Felipe,1,1,0,D
230034,5,CHL1,2005-04-09,CD Cobresal,Universidad de Concepcion,1,0,1,W
230035,5,CHL1,2005-04-09,Deportes Temuco,Union Espanola,1,2,-1,L
230036,5,CHL1,2005-04-09,Universidad Catolica,CD Huachipato,2,0,2,W
230037,5,CHL1,2005-04-09,Deportes Concepcion,Audax Italiano,0,2,-2,L
230038,5,CHL1,2005-04-10,Puerto Montt,La Serena,3,0,3,W
230039,5,CHL1,2005-04-10,Santiago Wanderers,CD Palestino,1,2,-1,L
230040,5,CHL1,2005-04-10,Colo Colo,Universidad de Chile,1,1,0,D
230041,5,CHL1,2005-04-10,Deportes Melipilla,Everton CD,0,3,-3,L
230042,5,CHL1,2005-04-13,Union Espanola,CD Cobreloa,1,0,1,W
230043,5,CHL1,2005-04-16,Everton CD,CD Cobreloa,1,0,1,W
230044,5,CHL1,2005-04-16,CD Huachipato,Deportes Melipilla,3,0,3,W
230045,5,CHL1,2005-04-16,CD Palestino,Colo Colo,1,0,1,W
230046,5,CHL1,2005-04-16,Audax Italiano,CD Cobresal,3,2,1,W
230047,5,CHL1,2005-04-16,Coquimbo Unido,Universidad Catolica,0,3,-3,L
230048,5,CHL1,2005-04-16,Union San Felipe,Deportes Concepcion,3,1,2,W
230049,5,CHL1,2005-04-17,CSD Rangers,Santiago Wanderers,0,2,-2,L
230050,5,CHL1,2005-04-17,Union Espanola,Puerto Montt,4,1,3,W
230051,5,CHL1,2005-04-17,Universidad de Concepcion,Deportes Temuco,3,3,0,D
230052,5,CHL1,2005-04-17,Universidad de Chile,La Serena,1,3,-2,L
230053,5,CHL1,2005-04-22,CD Cobresal,Everton CD,2,2,0,D
230054,5,CHL1,2005-04-22,CD Cobreloa,Coquimbo Unido,4,0,4,W
230055,5,CHL1,2005-04-23,Universidad Catolica,Universidad de Concepcion,5,2,3,W
230056,5,CHL1,2005-04-23,Colo Colo,Union Espanola,4,2,2,W
230057,5,CHL1,2005-04-23,Union San Felipe,Deportes Temuco,1,0,1,W
230058,5,CHL1,2005-04-23,La Serena,Audax Italiano,1,1,0,D
230059,5,CHL1,2005-04-24,Deportes Melipilla,Universidad de Chile,1,1,0,D
230060,5,CHL1,2005-04-24,Puerto Montt,CSD Rangers,1,2,-1,L
230061,5,CHL1,2005-04-24,Santiago Wanderers,CD Huachipato,2,0,2,W
230062,5,CHL1,2005-04-24,Deportes Concepcion,CD Palestino,2,0,2,W
230063,5,CHL1,2005-04-27,Universidad de Chile,Deportes Concepcion,1,0,1,W
230064,5,CHL1,2005-04-29,CD Cobreloa,CD Cobresal,2,1,1,W
230065,5,CHL1,2005-04-29,Deportes Temuco,La Serena,1,1,0,D
230066,5,CHL1,2005-04-30,Everton CD,Deportes Concepcion,1,1,0,D
230067,5,CHL1,2005-04-30,CSD Rangers,Colo Colo,3,2,1,W
230068,5,CHL1,2005-04-30,CD Huachipato,Union San Felipe,2,0,2,W
230069,5,CHL1,2005-04-30,Union Espanola,Santiago Wanderers,0,1,-1,L
230070,5,CHL1,2005-04-30,Universidad de Concepcion,Puerto Montt,4,3,1,W
230071,5,CHL1,2005-04-30,Universidad de Chile,Universidad Catolica,2,1,1,W
230072,5,CHL1,2005-04-30,Coquimbo Unido,CD Palestino,2,1,1,W
230073,5,CHL1,2005-04-30,Audax Italiano,Deportes Melipilla,1,3,-2,L
230074,5,CHL1,2005-05-06,CSD Rangers,CD Cobresal,2,3,-1,L
230075,5,CHL1,2005-05-07,CD Huachipato,Coquimbo Unido,3,2,1,W
230076,5,CHL1,2005-05-07,CD Palestino,Everton CD,1,1,0,D
230077,5,CHL1,2005-05-07,Universidad de Chile,Deportes Temuco,3,2,1,W
230078,5,CHL1,2005-05-07,Deportes Concepcion,Colo Colo,2,0,2,W
230079,5,CHL1,2005-05-07,La Serena,Deportes Melipilla,1,0,1,W
230080,5,CHL1,2005-05-08,Puerto Montt,Audax Italiano,2,2,0,D
230081,5,CHL1,2005-05-08,Union San Felipe,Union Espanola,2,1,1,W
230082,5,CHL1,2005-05-08,Santiago Wanderers,Universidad de Concepcion,3,0,3,W
230083,5,CHL1,2005-05-08,Universidad Catolica,CD Cobreloa,4,1,3,W
230084,5,CHL1,2005-05-13,CD Cobreloa,La Serena,5,0,5,W
230085,5,CHL1,2005-05-14,CD Cobresal,Universidad Catolica,0,0,0,D
230086,5,CHL1,2005-05-14,Colo Colo,CD Huachipato,1,0,1,W
230087,5,CHL1,2005-05-14,Coquimbo Unido,Puerto Montt,4,1,3,W
230088,5,CHL1,2005-05-15,Union Espanola,Deportes Concepcion,1,2,-1,L
230089,5,CHL1,2005-05-15,Deportes Melipilla,Union San Felipe,1,0,1,W
230090,5,CHL1,2005-05-15,Everton CD,CSD Rangers,1,3,-2,L
230091,5,CHL1,2005-05-15,Deportes Temuco,CD Palestino,1,1,0,D
230092,5,CHL1,2005-05-15,Audax Italiano,Santiago Wanderers,1,1,0,D
230093,5,CHL1,2005-05-15,Universidad de Concepcion,Universidad de Chile,0,3,-3,L
230094,5,CHL1,2005-05-21,CD Huachipato,Audax Italiano,2,0,2,W
230095,5,CHL1,2005-05-21,Universidad Catolica,Everton CD,1,2,-1,L
230096,5,CHL1,2005-05-21,Deportes Melipilla,CD Cobresal,1,2,-1,L
230097,5,CHL1,2005-05-21,CD Palestino,Union Espanola,2,3,-1,L
230098,5,CHL1,2005-05-21,La Serena,Coquimbo Unido,2,2,0,D
230099,5,CHL1,2005-05-22,Santiago Wanderers,CD Cobreloa,1,2,-1,L
230100,5,CHL1,2005-05-22,Puerto Montt,Deportes Temuco,1,1,0,D
230101,5,CHL1,2005-05-22,Deportes Concepcion,Universidad de Concepcion,1,2,-1,L
230102,5,CHL1,2005-05-23,Union San Felipe,Colo Colo,2,3,-1,L
230103,5,CHL1,2005-05-28,Colo Colo,Deportes Melipilla,2,2,0,D
230104,5,CHL1,2005-05-28,Everton CD,La Serena,3,1,2,W
230105,5,CHL1,2005-05-28,Coquimbo Unido,Santiago Wanderers,3,1,2,W
230106,5,CHL1,2005-05-28,CD Cobresal,Universidad de Chile,2,4,-2,L
230107,5,CHL1,2005-05-29,CSD Rangers,Universidad Catolica,1,3,-2,L
230108,5,CHL1,2005-05-29,CD Cobreloa,Puerto Montt,4,3,1,W
230109,5,CHL1,2005-05-29,Audax Italiano,Union San Felipe,1,1,0,D
230110,5,CHL1,2005-05-29,Deportes Temuco,Deportes Concepcion,1,1,0,D
230111,5,CHL1,2005-05-29,Universidad de Concepcion,CD Palestino,0,2,-2,L
230112,5,CHL1,2005-05-29,Union Espanola,CD Huachipato,2,1,1,W
230113,5,CHL1,2005-06-01,Universidad de Chile,CSD Rangers,1,2,-1,L
230114,5,CHL1,2005-07-15,CD Palestino,Santiago Wanderers,4,0,4,W
230115,5,CHL1,2005-07-16,Universidad de Chile,Universidad de Concepcion,1,0,1,W
230116,5,CHL1,2005-07-16,Audax Italiano,Universidad Catolica,0,4,-4,L
230117,5,CHL1,2005-07-17,Puerto Montt,CD Cobreloa,1,0,1,W
230118,5,CHL1,2005-07-17,Deportes Concepcion,CSD Rangers,1,1,0,D
230119,5,CHL1,2005-07-17,Deportes Melipilla,CD Huachipato,1,0,1,W
230120,5,CHL1,2005-07-17,La Serena,Union San Felipe,1,1,0,D
230121,5,CHL1,2005-07-17,Everton CD,Colo Colo,1,3,-2,L
230122,5,CHL1,2005-07-22,Santiago Wanderers,Deportes Concepcion,1,1,0,D
230123,5,CHL1,2005-07-23,CD Huachipato,CD Palestino,0,0,0,D
230124,5,CHL1,2005-07-23,Colo Colo,La Serena,1,1,0,D
230125,5,CHL1,2005-07-23,CD Cobreloa,Deportes Melipilla,3,1,2,W
230126,5,CHL1,2005-07-23,Universidad Catolica,Coquimbo Unido,1,0,1,W
230127,5,CHL1,2005-07-24,CSD Rangers,Puerto Montt,3,0,3,W
230128,5,CHL1,2005-07-24,Universidad de Concepcion,Everton CD,2,1,1,W
230129,5,CHL1,2005-07-24,Deportes Temuco,Audax Italiano,1,0,1,W
230130,5,CHL1,2005-07-24,Union San Felipe,Universidad de Chile,4,1,3,W
230131,5,CHL1,2005-07-29,Everton CD,Union San Felipe,3,1,2,W
230132,5,CHL1,2005-07-30,Universidad de Chile,Puerto Montt,4,2,2,W
230133,5,CHL1,2005-07-30,CD Palestino,CD Cobreloa,1,1,0,D
230134,5,CHL1,2005-07-30,Coquimbo Unido,Colo Colo,2,4,-2,L
230135,5,CHL1,2005-07-31,Universidad de Concepcion,CSD Rangers,2,1,1,W
230136,5,CHL1,2005-07-31,Deportes Melipilla,Santiago Wanderers,0,1,-1,L
230137,5,CHL1,2005-07-31,CD Cobresal,CD Huachipato,2,0,2,W
230138,5,CHL1,2005-07-31,Audax Italiano,Deportes Concepcion,6,0,6,W
230139,5,CHL1,2005-07-31,La Serena,Union Espanola,1,1,0,D
230140,5,CHL1,2005-07-31,Universidad Catolica,Deportes Temuco,2,0,2,W
230141,5,CHL1,2005-08-06,CD Huachipato,Universidad de Concepcion,2,0,2,W
230142,5,CHL1,2005-08-06,Colo Colo,Audax Italiano,3,0,3,W
230143,5,CHL1,2005-08-06,Union Espanola,Deportes Melipilla,2,1,1,W
230144,5,CHL1,2005-08-06,Coquimbo Unido,Deportes Temuco,3,0,3,W
230145,5,CHL1,2005-08-06,Union San Felipe,CD Palestino,1,1,0,D
230146,5,CHL1,2005-08-07,Puerto Montt,CD Cobresal,1,0,1,W
230147,5,CHL1,2005-08-07,CSD Rangers,Universidad de Chile,1,3,-2,L
230148,5,CHL1,2005-08-07,Deportes Concepcion,La Serena,2,1,1,W
230149,5,CHL1,2005-08-07,CD Cobreloa,Everton CD,1,1,0,D
230150,5,CHL1,2005-08-07,Santiago Wanderers,Universidad Catolica,0,2,-2,L
230151,5,CHL1,2005-08-13,Universidad de Concepcion,Colo Colo,1,2,-1,L
230152,5,CHL1,2005-08-13,Audax Italiano,Coquimbo Unido,0,0,0,D
230153,5,CHL1,2005-08-13,CD Palestino,Deportes Concepcion,0,2,-2,L
230154,5,CHL1,2005-08-14,Universidad Catolica,Puerto Montt,1,0,1,W
230155,5,CHL1,2005-08-14,Union San Felipe,CD Huachipato,2,3,-1,L
230156,5,CHL1,2005-08-14,CD Cobresal,Santiago Wanderers,1,2,-1,L
230157,5,CHL1,2005-08-14,La Serena,CSD Rangers,0,1,-1,L
230158,5,CHL1,2005-08-14,Deportes Temuco,Deportes Melipilla,1,0,1,W
230159,5,CHL1,2005-08-14,Everton CD,Union Espanola,0,0,0,D
230160,5,CHL1,2005-08-14,Universidad de Chile,CD Cobreloa,0,0,0,D
230161,5,CHL1,2005-08-20,Union Espanola,Universidad de Concepcion,3,2,1,W
230162,5,CHL1,2005-08-20,CD Cobreloa,Universidad Catolica,0,2,-2,L
230163,5,CHL1,2005-08-20,Deportes Concepcion,Universidad de Chile,3,1,2,W
230164,5,CHL1,2005-08-20,Coquimbo Unido,CD Cobresal,1,1,0,D
230165,5,CHL1,2005-08-21,Puerto Montt,CD Palestino,2,0,2,W
230166,5,CHL1,2005-08-21,CD Huachipato,Everton CD,3,1,2,W
230167,5,CHL1,2005-08-21,CSD Rangers,Union San Felipe,2,1,1,W
230168,5,CHL1,2005-08-21,Deportes Melipilla,La Serena,1,0,1,W
230169,5,CHL1,2005-08-21,Santiago Wanderers,Audax Italiano,0,2,-2,L
230170,5,CHL1,2005-08-21,Colo Colo,Deportes Temuco,4,0,4,W
230171,5,CHL1,2005-08-27,Puerto Montt,Union Espanola,2,1,1,W
230172,5,CHL1,2005-08-27,CD Cobresal,Union San Felipe,3,0,3,W
230173,5,CHL1,2005-08-28,La Serena,CD Huachipato,2,3,-1,L
230174,5,CHL1,2005-08-28,Deportes Temuco,CD Cobreloa,2,1,1,W
230175,5,CHL1,2005-09-03,CD Cobresal,Deportes Temuco,4,1,3,W
230176,5,CHL1,2005-09-03,Coquimbo Unido,Union Espanola,1,1,0,D
230177,5,CHL1,2005-09-03,Universidad Catolica,Deportes Concepcion,0,0,0,D
230178,5,CHL1,2005-09-08,Universidad de Chile,Colo Colo,1,0,1,W
230179,5,CHL1,2005-09-10,CD Huachipato,Universidad Catolica,0,0,0,D
230180,5,CHL1,2005-09-10,Union Espanola,Deportes Temuco,1,1,0,D
230181,5,CHL1,2005-09-10,Deportes Concepcion,Coquimbo Unido,3,0,3,W
230182,5,CHL1,2005-09-10,La Serena,CD Cobresal,2,3,-1,L
230183,5,CHL1,2005-09-11,Union San Felipe,Universidad de Concepcion,2,1,1,W
230184,5,CHL1,2005-09-11,CSD Rangers,Everton CD,1,1,0,D
230185,5,CHL1,2005-09-11,CD Cobreloa,Audax Italiano,1,2,-1,L
230186,5,CHL1,2005-09-11,Deportes Melipilla,Puerto Montt,1,0,1,W
230187,5,CHL1,2005-09-11,Santiago Wanderers,Universidad de Chile,0,1,-1,L
230188,5,CHL1,2005-09-13,Colo Colo,CD Palestino,4,1,3,W
230189,5,CHL1,2005-09-16,Universidad de Chile,Deportes Melipilla,2,1,1,W
230190,5,CHL1,2005-09-16,Deportes Temuco,Union San Felipe,1,0,1,W
230191,5,CHL1,2005-09-17,Coquimbo Unido,CD Cobreloa,2,2,0,D
230192,5,CHL1,2005-09-17,Puerto Montt,Deportes Concepcion,1,1,0,D
230193,5,CHL1,2005-09-17,CD Cobresal,Colo Colo,2,2,0,D
230194,5,CHL1,2005-09-17,Universidad de Concepcion,La Serena,1,3,-2,L
230195,5,CHL1,2005-09-17,Audax Italiano,CD Huachipato,1,0,1,W
230196,5,CHL1,2005-09-17,Union Espanola,CD Palestino,4,1,3,W
230197,5,CHL1,2005-09-18,Everton CD,Santiago Wanderers,0,1,-1,L
230198,5,CHL1,2005-09-21,Audax Italiano,CSD Rangers,2,2,0,D
230199,5,CHL1,2005-09-24,Deportes Concepcion,CD Cobresal,1,0,1,W
230200,5,CHL1,2005-09-24,CD Cobreloa,Universidad de Concepcion,2,0,2,W
230201,5,CHL1,2005-09-24,CD Palestino,Universidad de Chile,1,1,0,D
230202,5,CHL1,2005-09-24,La Serena,Everton CD,0,0,0,D
230203,5,CHL1,2005-09-24,Santiago Wanderers,Puerto Montt,3,1,2,W
230204,5,CHL1,2005-09-25,CSD Rangers,Deportes Temuco,5,1,4,W
230205,5,CHL1,2005-09-25,Union San Felipe,Coquimbo Unido,2,1,1,W
230206,5,CHL1,2005-09-25,Deportes Melipilla,Audax Italiano,1,0,1,W
230207,5,CHL1,2005-09-25,CD Huachipato,Union Espanola,3,1,2,W
230208,5,CHL1,2005-09-25,Colo Colo,Universidad Catolica,0,0,0,D
230209,5,CHL1,2005-09-27,Deportes Concepcion,CD Cobreloa,1,0,1,W
230210,5,CHL1,2005-09-28,CD Cobresal,Deportes Melipilla,2,0,2,W
230211,5,CHL1,2005-09-28,Puerto Montt,Colo Colo,0,3,-3,L
230212,5,CHL1,2005-09-28,Deportes Temuco,Universidad de Concepcion,1,2,-1,L
230213,5,CHL1,2005-09-28,Santiago Wanderers,CSD Rangers,1,1,0,D
230214,5,CHL1,2005-09-28,Union Espanola,Union San Felipe,0,1,-1,L
230215,5,CHL1,2005-09-28,Audax Italiano,La Serena,0,0,0,D
230216,5,CHL1,2005-09-29,Coquimbo Unido,Everton CD,2,2,0,D
230217,5,CHL1,2005-09-29,Universidad de Chile,CD Huachipato,2,1,1,W
230218,5,CHL1,2005-09-29,Universidad Catolica,CD Palestino,3,0,3,W
230219,5,CHL1,2005-10-01,CD Huachipato,Colo Colo,2,2,0,D
230220,5,CHL1,2005-10-01,CD Cobreloa,Santiago Wanderers,3,0,3,W
230221,5,CHL1,2005-10-01,Deportes Melipilla,Deportes Concepcion,1,0,1,W
230222,5,CHL1,2005-10-01,Union San Felipe,Puerto Montt,1,1,0,D
230223,5,CHL1,2005-10-01,La Serena,Deportes Temuco,2,0,2,W
230224,5,CHL1,2005-10-02,Universidad de Concepcion,Universidad Catolica,0,1,-1,L
230225,5,CHL1,2005-10-02,CSD Rangers,Coquimbo Unido,0,1,-1,L
230226,5,CHL1,2005-10-02,Everton CD,CD Cobresal,3,1,2,W
230227,5,CHL1,2005-10-02,Universidad de Chile,Union Espanola,5,3,2,W
230228,5,CHL1,2005-10-02,CD Palestino,Audax Italiano,4,0,4,W
230229,5,CHL1,2005-10-07,Union Espanola,CD Cobresal,2,1,1,W
230230,5,CHL1,2005-10-07,Universidad de Concepcion,Santiago Wanderers,1,0,1,W
230231,5,CHL1,2005-10-08,CD Palestino,Coquimbo Unido,3,1,2,W
230232,5,CHL1,2005-10-09,Everton CD,Deportes Melipilla,1,1,0,D
230233,5,CHL1,2005-10-09,Universidad Catolica,CSD Rangers,3,0,3,W
230234,5,CHL1,2005-10-14,Puerto Montt,CD Huachipato,0,1,-1,L
230235,5,CHL1,2005-10-15,Deportes Concepcion,Union San Felipe,1,1,0,D
230236,5,CHL1,2005-10-15,CD Palestino,Deportes Melipilla,0,0,0,D
230237,5,CHL1,2005-10-16,Santiago Wanderers,Union Espanola,1,1,0,D
230238,5,CHL1,2005-10-16,CD Cobresal,CD Cobreloa,3,1,2,W
230239,5,CHL1,2005-10-16,Deportes Temuco,Everton CD,0,3,-3,L
230240,5,CHL1,2005-10-16,Coquimbo Unido,La Serena,1,2,-1,L
230241,5,CHL1,2005-10-16,Audax Italiano,Universidad de Concepcion,1,1,0,D
230242,5,CHL1,2005-10-16,Colo Colo,CSD Rangers,4,1,3,W
230243,5,CHL1,2005-10-22,CD Huachipato,Deportes Concepcion,3,1,2,W
230244,5,CHL1,2005-10-22,Union Espanola,Colo Colo,1,3,-2,L
230245,5,CHL1,2005-10-22,Deportes Temuco,Santiago Wanderers,1,0,1,W
230246,5,CHL1,2005-10-22,CSD Rangers,CD Palestino,2,2,0,D
230247,5,CHL1,2005-10-22,Everton CD,Audax Italiano,2,1,1,W
230248,5,CHL1,2005-10-22,Union San Felipe,CD Cobreloa,1,1,0,D
230249,5,CHL1,2005-10-22,La Serena,Puerto Montt,2,0,2,W
230250,5,CHL1,2005-10-22,Universidad de Concepcion,Coquimbo Unido,1,1,0,D
230251,5,CHL1,2005-10-23,Deportes Melipilla,Universidad Catolica,0,1,-1,L
230252,5,CHL1,2005-10-23,Universidad de Chile,CD Cobresal,1,1,0,D
230253,5,CHL1,2005-10-25,Colo Colo,Union San Felipe,5,0,5,W
230254,5,CHL1,2005-10-26,CD Cobreloa,Union Espanola,4,1,3,W
230255,5,CHL1,2005-10-26,CD Huachipato,Deportes Temuco,5,1,4,W
230256,5,CHL1,2005-10-26,Audax Italiano,Universidad de Chile,1,1,0,D
230257,5,CHL1,2005-10-26,Puerto Montt,Universidad de Concepcion,1,2,-1,L
230258,5,CHL1,2005-10-26,CD Palestino,La Serena,3,4,-1,L
230259,5,CHL1,2005-10-26,Deportes Melipilla,CSD Rangers,4,1,3,W
230260,5,CHL1,2005-10-26,Universidad Catolica,CD Cobresal,1,0,1,W
230261,5,CHL1,2005-10-26,Santiago Wanderers,Coquimbo Unido,2,0,2,W
230262,5,CHL1,2005-10-27,Deportes Concepcion,Everton CD,2,1,1,W
230263,5,CHL1,2005-10-29,Deportes Temuco,Universidad de Chile,1,2,-1,L
230264,5,CHL1,2005-10-29,Audax Italiano,Puerto Montt,3,3,0,D
230265,5,CHL1,2005-10-30,La Serena,CD Cobreloa,1,0,1,W
230266,5,CHL1,2005-10-30,Universidad de Concepcion,Deportes Concepcion,3,3,0,D
230267,5,CHL1,2005-10-30,Everton CD,Universidad Catolica,1,2,-1,L
230268,5,CHL1,2005-10-30,CD Cobresal,CD Palestino,1,1,0,D
230269,5,CHL1,2005-10-30,Union San Felipe,Deportes Melipilla,2,0,2,W
230270,5,CHL1,2005-10-30,Union Espanola,CSD Rangers,2,1,1,W
230271,5,CHL1,2005-10-30,Colo Colo,Santiago Wanderers,1,1,0,D
230272,5,CHL1,2005-10-30,Coquimbo Unido,CD Huachipato,0,1,-1,L
230273,5,CHL1,2005-11-01,Universidad de Chile,Everton CD,1,1,0,D
230274,5,CHL1,2005-11-02,CD Cobresal,Audax Italiano,2,1,1,W
230275,5,CHL1,2005-11-02,Universidad Catolica,Union San Felipe,5,1,4,W
230276,5,CHL1,2005-11-02,Deportes Concepcion,Union Espanola,2,1,1,W
230277,5,CHL1,2005-11-03,CD Cobreloa,Colo Colo,0,1,-1,L
230278,5,CHL1,2005-11-03,CSD Rangers,CD Huachipato,1,1,0,D
230279,5,CHL1,2005-11-04,Coquimbo Unido,Deportes Melipilla,2,1,1,W
230280,5,CHL1,2005-11-05,Union Espanola,Universidad Catolica,0,0,0,D
230281,5,CHL1,2005-11-05,La Serena,Universidad de Chile,2,3,-1,L
230282,5,CHL1,2005-11-06,CD Huachipato,Santiago Wanderers,2,1,1,W
230283,5,CHL1,2005-11-06,Union San Felipe,Audax Italiano,2,0,2,W
230284,5,CHL1,2005-11-06,Deportes Temuco,Puerto Montt,4,1,3,W
230285,5,CHL1,2005-11-06,Universidad de Concepcion,CD Cobresal,4,1,3,W
230286,5,CHL1,2005-11-06,Everton CD,CD Palestino,0,0,0,D
230287,5,CHL1,2005-11-06,Colo Colo,Deportes Concepcion,2,1,1,W
230288,5,CHL1,2005-11-06,CSD Rangers,CD Cobreloa,0,1,-1,L
230289,5,CHL1,2005-11-12,CD Palestino,Deportes Temuco,1,0,1,W
230290,5,CHL1,2005-11-12,Santiago Wanderers,La Serena,0,0,0,D
230291,5,CHL1,2005-11-12,Deportes Melipilla,Universidad de Concepcion,1,2,-1,L
230292,5,CHL1,2005-11-13,Universidad Catolica,Universidad de Chile,2,1,1,W
230293,5,CHL1,2005-11-13,Puerto Montt,Coquimbo Unido,1,0,1,W
230294,5,CHL1,2005-11-18,Universidad Catolica,La Serena,3,0,3,W
230295,5,CHL1,2005-11-19,Deportes Concepcion,Deportes Temuco,3,1,2,W
230296,5,CHL1,2005-11-19,Santiago Wanderers,Union San Felipe,3,1,2,W
230297,5,CHL1,2005-11-19,Puerto Montt,Everton CD,0,1,-1,L
230298,5,CHL1,2005-11-19,CD Cobresal,CSD Rangers,2,0,2,W
230299,5,CHL1,2005-11-19,CD Cobreloa,CD Huachipato,2,1,1,W
230300,5,CHL1,2005-11-20,Deportes Melipilla,Colo Colo,2,3,-1,L
230301,5,CHL1,2005-11-20,Universidad de Chile,Coquimbo Unido,3,0,3,W
230302,5,CHL1,2005-11-20,CD Palestino,Universidad de Concepcion,1,2,-1,L
230303,5,CHL1,2005-11-20,Audax Italiano,Union Espanola,4,5,-1,L
230304,6,CHL1,2006-01-27,Higgins,Colo Colo,1,3,-2,L
230305,6,CHL1,2006-01-28,CD Huachipato,Antofagasta,2,0,2,W
230306,6,CHL1,2006-01-28,CD Palestino,Santiago Wanderers,3,0,3,W
230307,6,CHL1,2006-01-28,Puerto Montt,Audax Italiano,0,3,-3,L
230308,6,CHL1,2006-01-28,Universidad de Chile,Union Espanola,1,0,1,W
230309,6,CHL1,2006-01-29,Coquimbo Unido,Universidad de Concepcion,1,1,0,D
230310,6,CHL1,2006-01-29,Santiago Morning,CSD Rangers,4,3,1,W
230311,6,CHL1,2006-01-29,CD Cobresal,CD Cobreloa,2,4,-2,L
230312,6,CHL1,2006-01-30,Everton CD,Universidad Catolica,1,0,1,W
230313,6,CHL1,2006-02-03,Audax Italiano,Everton CD,3,0,3,W
230314,6,CHL1,2006-02-04,CSD Rangers,Universidad de Chile,1,2,-1,L
230315,6,CHL1,2006-02-04,Universidad Catolica,Puerto Montt,1,1,0,D
230316,6,CHL1,2006-02-04,Santiago Wanderers,Higgins,0,0,0,D
230317,6,CHL1,2006-02-05,CD Cobreloa,Coquimbo Unido,3,1,2,W
230318,6,CHL1,2006-02-05,Antofagasta,CD Palestino,3,1,2,W
230319,6,CHL1,2006-02-05,Colo Colo,CD Huachipato,0,2,-2,L
230320,6,CHL1,2006-02-05,Universidad de Concepcion,Santiago Morning,1,0,1,W
230321,6,CHL1,2006-02-05,La Serena,CD Cobresal,1,1,0,D
230322,6,CHL1,2006-02-10,Santiago Morning,CD Cobreloa,1,1,0,D
230323,6,CHL1,2006-02-11,CD Huachipato,Audax Italiano,1,3,-2,L
230324,6,CHL1,2006-02-11,CD Palestino,Coquimbo Unido,3,1,2,W
230325,6,CHL1,2006-02-11,Universidad Catolica,Union Espanola,2,1,1,W
230326,6,CHL1,2006-02-11,Puerto Montt,CSD Rangers,4,1,3,W
230327,6,CHL1,2006-02-11,Higgins,CD Cobresal,0,1,-1,L
230328,6,CHL1,2006-02-11,Everton CD,Antofagasta,2,0,2,W
230329,6,CHL1,2006-02-11,La Serena,Colo Colo,3,3,0,D
230330,6,CHL1,2006-02-12,Universidad de Chile,Universidad de Concepcion,2,1,1,W
230331,6,CHL1,2006-02-17,Union Espanola,CD Huachipato,1,0,1,W
230332,6,CHL1,2006-02-18,Colo Colo,Everton CD,5,3,2,W
230333,6,CHL1,2006-02-18,Audax Italiano,Higgins,3,0,3,W
230334,6,CHL1,2006-02-18,CSD Rangers,La Serena,1,0,1,W
230335,6,CHL1,2006-02-18,Coquimbo Unido,Universidad Catolica,1,1,0,D
230336,6,CHL1,2006-02-19,CD Cobresal,Puerto Montt,3,2,1,W
230337,6,CHL1,2006-02-19,Antofagasta,Santiago Morning,1,1,0,D
230338,6,CHL1,2006-02-19,Santiago Wanderers,Universidad de Chile,0,1,-1,L
230339,6,CHL1,2006-02-19,Universidad de Concepcion,CD Palestino,3,2,1,W
230340,6,CHL1,2006-02-24,Universidad de Chile,Audax Italiano,2,2,0,D
230341,6,CHL1,2006-02-25,CD Huachipato,Everton CD,2,0,2,W
230342,6,CHL1,2006-02-25,Puerto Montt,Coquimbo Unido,0,1,-1,L
230343,6,CHL1,2006-02-25,Santiago Morning,CD Cobresal,1,1,0,D
230344,6,CHL1,2006-02-25,Higgins,CD Cobreloa,0,3,-3,L
230345,6,CHL1,2006-02-25,La Serena,Union Espanola,3,0,3,W
230346,6,CHL1,2006-02-25,CD Palestino,Colo Colo,1,4,-3,L
230347,6,CHL1,2006-02-26,Santiago Wanderers,CSD Rangers,1,1,0,D
230348,6,CHL1,2006-02-26,Universidad Catolica,Antofagasta,5,2,3,W
230349,6,CHL1,2006-03-03,Audax Italiano,La Serena,3,2,1,W
230350,6,CHL1,2006-03-04,CD Cobreloa,Universidad Catolica,2,3,-1,L
230351,6,CHL1,2006-03-04,Coquimbo Unido,CD Huachipato,2,2,0,D
230352,6,CHL1,2006-03-04,Colo Colo,Santiago Wanderers,5,0,5,W
230353,6,CHL1,2006-03-05,Puerto Montt,Santiago Morning,3,1,2,W
230354,6,CHL1,2006-03-05,Antofagasta,Higgins,1,2,-1,L
230355,6,CHL1,2006-03-05,CD Cobresal,Universidad de Chile,3,3,0,D
230356,6,CHL1,2006-03-05,Universidad de Concepcion,CSD Rangers,1,3,-2,L
230357,6,CHL1,2006-03-05,Union Espanola,CD Palestino,2,3,-1,L
230358,6,CHL1,2006-03-10,Santiago Morning,Audax Italiano,1,2,-1,L
230359,6,CHL1,2006-03-11,CD Cobresal,Everton CD,0,0,0,D
230360,6,CHL1,2006-03-11,CD Huachipato,CD Cobreloa,4,2,2,W
230361,6,CHL1,2006-03-11,Higgins,Universidad de Concepcion,0,2,-2,L
230362,6,CHL1,2006-03-11,CSD Rangers,Union Espanola,1,3,-2,L
230363,6,CHL1,2006-03-11,La Serena,Antofagasta,3,1,2,W
230364,6,CHL1,2006-03-12,Universidad de Chile,Puerto Montt,2,1,1,W
230365,6,CHL1,2006-03-12,Santiago Wanderers,Coquimbo Unido,2,1,1,W
230366,6,CHL1,2006-03-12,CD Palestino,Universidad Catolica,0,1,-1,L
230367,6,CHL1,2006-03-17,Universidad Catolica,La Serena,2,0,2,W
230368,6,CHL1,2006-03-18,CD Huachipato,Santiago Morning,3,1,2,W
230369,6,CHL1,2006-03-18,Union Espanola,Santiago Wanderers,1,0,1,W
230370,6,CHL1,2006-03-18,Colo Colo,CD Cobresal,3,0,3,W
230371,6,CHL1,2006-03-18,Coquimbo Unido,Higgins,2,1,1,W
230372,6,CHL1,2006-03-19,CD Cobreloa,CSD Rangers,5,1,4,W
230373,6,CHL1,2006-03-19,Antofagasta,Universidad de Chile,0,1,-1,L
230374,6,CHL1,2006-03-19,Universidad de Concepcion,Puerto Montt,2,2,0,D
230375,6,CHL1,2006-03-19,Everton CD,CD Palestino,1,1,0,D
230376,6,CHL1,2006-03-24,CSD Rangers,Audax Italiano,3,0,3,W
230377,6,CHL1,2006-03-24,Union Espanola,Universidad de Concepcion,1,0,1,W
230378,6,CHL1,2006-03-25,Higgins,Universidad Catolica,2,2,0,D
230379,6,CHL1,2006-03-25,La Serena,CD Huachipato,1,2,-1,L
230380,6,CHL1,2006-03-26,Puerto Montt,Everton CD,1,1,0,D
230381,6,CHL1,2006-03-26,CD Cobresal,Coquimbo Unido,2,0,2,W
230382,6,CHL1,2006-03-26,Santiago Wanderers,CD Cobreloa,3,0,3,W
230383,6,CHL1,2006-03-26,Universidad de Chile,CD Palestino,2,1,1,W
230384,6,CHL1,2006-03-31,Universidad de Concepcion,CD Cobresal,2,1,1,W
230385,6,CHL1,2006-04-01,CD Huachipato,Universidad de Chile,2,0,2,W
230386,6,CHL1,2006-04-01,CD Palestino,Puerto Montt,1,5,-4,L
230387,6,CHL1,2006-04-01,CD Cobreloa,La Serena,2,2,0,D
230388,6,CHL1,2006-04-01,Coquimbo Unido,Santiago Morning,1,1,0,D
230389,6,CHL1,2006-04-02,Antofagasta,Santiago Wanderers,2,1,1,W
230390,6,CHL1,2006-04-02,Everton CD,Higgins,0,2,-2,L
230391,6,CHL1,2006-04-02,Colo Colo,CSD Rangers,7,2,5,W
230392,6,CHL1,2006-04-02,Audax Italiano,Union Espanola,1,1,0,D
230393,6,CHL1,2006-04-07,Union Espanola,Everton CD,3,3,0,D
230394,6,CHL1,2006-04-08,Santiago Wanderers,CD Huachipato,1,0,1,W
230395,6,CHL1,2006-04-08,Universidad de Concepcion,CD Cobreloa,1,0,1,W
230396,6,CHL1,2006-04-08,Higgins,La Serena,3,2,1,W
230397,6,CHL1,2006-04-08,CSD Rangers,Antofagasta,2,2,0,D
230398,6,CHL1,2006-04-08,Coquimbo Unido,Audax Italiano,1,0,1,W
230399,6,CHL1,2006-04-09,Universidad de Chile,Colo Colo,1,3,-2,L
230400,6,CHL1,2006-04-09,CD Cobresal,CD Palestino,4,0,4,W
230401,6,CHL1,2006-04-09,Santiago Morning,Universidad Catolica,1,0,1,W
230402,6,CHL1,2006-04-14,La Serena,Santiago Wanderers,2,1,1,W
230403,6,CHL1,2006-04-14,CD Cobreloa,Union Espanola,1,0,1,W
230404,6,CHL1,2006-04-15,Universidad Catolica,CSD Rangers,2,1,1,W
230405,6,CHL1,2006-04-15,CD Palestino,Santiago Morning,1,0,1,W
230406,6,CHL1,2006-04-15,Universidad de Chile,Higgins,2,2,0,D
230407,6,CHL1,2006-04-16,CD Huachipato,Puerto Montt,3,2,1,W
230408,6,CHL1,2006-04-16,Antofagasta,CD Cobresal,3,1,2,W
230409,6,CHL1,2006-04-16,Everton CD,Universidad de Concepcion,1,2,-1,L
230410,6,CHL1,2006-04-16,Audax Italiano,Colo Colo,1,3,-2,L
230411,6,CHL1,2006-04-21,CD Cobresal,CD Huachipato,1,2,-1,L
230412,6,CHL1,2006-04-22,Universidad de Concepcion,Antofagasta,2,2,0,D
230413,6,CHL1,2006-04-22,Santiago Wanderers,Audax Italiano,1,2,-1,L
230414,6,CHL1,2006-04-22,CD Palestino,CD Cobreloa,0,2,-2,L
230415,6,CHL1,2006-04-22,Coquimbo Unido,Universidad de Chile,0,0,0,D
230416,6,CHL1,2006-04-22,Higgins,Union Espanola,1,3,-2,L
230417,6,CHL1,2006-04-23,Santiago Morning,Everton CD,1,2,-1,L
230418,6,CHL1,2006-04-23,Puerto Montt,La Serena,2,3,-1,L
230419,6,CHL1,2006-04-23,Colo Colo,Universidad Catolica,2,3,-1,L
230420,6,CHL1,2006-04-29,Union Espanola,Colo Colo,1,0,1,W
230421,6,CHL1,2006-04-29,CSD Rangers,CD Cobresal,1,2,-1,L
230422,6,CHL1,2006-04-29,Universidad Catolica,Santiago Wanderers,0,2,-2,L
230423,6,CHL1,2006-04-29,La Serena,Universidad de Concepcion,1,1,0,D
230424,6,CHL1,2006-04-30,CD Huachipato,CD Palestino,1,0,1,W
230425,6,CHL1,2006-04-30,CD Cobreloa,Puerto Montt,2,1,1,W
230426,6,CHL1,2006-04-30,Antofagasta,Audax Italiano,1,1,0,D
230427,6,CHL1,2006-04-30,Universidad de Chile,Santiago Morning,2,0,2,W
230428,6,CHL1,2006-04-30,Everton CD,Coquimbo Unido,1,0,1,W
230429,6,CHL1,2006-05-06,Universidad de Concepcion,CD Huachipato,2,2,0,D
230430,6,CHL1,2006-05-06,Audax Italiano,Universidad Catolica,0,0,0,D
230431,6,CHL1,2006-05-06,Higgins,CSD Rangers,2,0,2,W
230432,6,CHL1,2006-05-06,Coquimbo Unido,Union Espanola,1,1,0,D
230433,6,CHL1,2006-05-07,Santiago Morning,La Serena,2,2,0,D
230434,6,CHL1,2006-05-07,Puerto Montt,Antofagasta,3,3,0,D
230435,6,CHL1,2006-05-07,Colo Colo,CD Cobreloa,2,0,2,W
230436,6,CHL1,2006-05-07,CD Cobresal,Santiago Wanderers,2,1,1,W
230437,6,CHL1,2006-05-07,Everton CD,Universidad de Chile,1,1,0,D
230438,6,CHL1,2006-05-11,Santiago Morning,Colo Colo,0,3,-3,L
230439,6,CHL1,2006-05-13,CSD Rangers,CD Huachipato,1,3,-2,L
230440,6,CHL1,2006-05-13,Union Espanola,CD Cobresal,3,0,3,W
230441,6,CHL1,2006-05-13,Audax Italiano,CD Palestino,2,2,0,D
230442,6,CHL1,2006-05-13,Higgins,Puerto Montt,1,1,0,D
230443,6,CHL1,2006-05-13,La Serena,Everton CD,2,2,0,D
230444,6,CHL1,2006-05-14,Universidad Catolica,Universidad de Chile,0,2,-2,L
230445,6,CHL1,2006-05-14,Santiago Wanderers,Universidad de Concepcion,1,4,-3,L
230446,6,CHL1,2006-05-14,Antofagasta,CD Cobreloa,1,1,0,D
230447,6,CHL1,2006-05-14,Colo Colo,Coquimbo Unido,5,1,4,W
230448,6,CHL1,2006-05-18,Universidad de Chile,La Serena,2,1,1,W
230449,6,CHL1,2006-05-19,Puerto Montt,Colo Colo,0,1,-1,L
230450,6,CHL1,2006-05-20,Universidad de Concepcion,Universidad Catolica,1,1,0,D
230451,6,CHL1,2006-05-20,CD Palestino,CSD Rangers,2,2,0,D
230452,6,CHL1,2006-05-20,Everton CD,Santiago Wanderers,2,0,2,W
230453,6,CHL1,2006-05-20,Coquimbo Unido,Antofagasta,0,1,-1,L
230454,6,CHL1,2006-05-21,CD Huachipato,Higgins,0,0,0,D
230455,6,CHL1,2006-05-21,Santiago Morning,Union Espanola,0,0,0,D
230456,6,CHL1,2006-05-21,CD Cobreloa,Audax Italiano,0,1,-1,L
230457,6,CHL1,2006-05-27,CD Cobreloa,Universidad de Chile,2,1,1,W
230458,6,CHL1,2006-05-27,Union Espanola,Puerto Montt,3,1,2,W
230459,6,CHL1,2006-05-27,Audax Italiano,Universidad de Concepcion,1,2,-1,L
230460,6,CHL1,2006-05-27,Higgins,CD Palestino,0,0,0,D
230461,6,CHL1,2006-05-28,Santiago Wanderers,Santiago Morning,2,0,2,W
230462,6,CHL1,2006-05-28,Colo Colo,Antofagasta,3,0,3,W
230463,6,CHL1,2006-05-28,CSD Rangers,Everton CD,2,0,2,W
230464,6,CHL1,2006-05-28,La Serena,Coquimbo Unido,2,1,1,W
230465,6,CHL1,2006-05-28,Universidad Catolica,CD Cobresal,2,0,2,W
230466,6,CHL1,2006-06-03,Puerto Montt,Santiago Wanderers,4,0,4,W
230467,6,CHL1,2006-06-03,CD Huachipato,Universidad Catolica,1,2,-1,L
230468,6,CHL1,2006-06-03,Coquimbo Unido,CSD Rangers,0,0,0,D
230469,6,CHL1,2006-06-04,Santiago Morning,Higgins,0,3,-3,L
230470,6,CHL1,2006-06-04,CD Palestino,La Serena,1,2,-1,L
230471,6,CHL1,2006-06-04,Everton CD,CD Cobreloa,0,2,-2,L
230472,6,CHL1,2006-06-04,Antofagasta,Union Espanola,3,0,3,W
230473,6,CHL1,2006-06-04,Universidad de Concepcion,Colo Colo,3,2,1,W
230474,6,CHL1,2006-06-04,CD Cobresal,Audax Italiano,2,4,-2,L
230475,6,CHL1,2006-07-15,Union Espanola,Coquimbo Unido,1,1,0,D
230476,6,CHL1,2006-07-16,CSD Rangers,CD Palestino,3,1,2,W
230477,6,CHL1,2006-07-16,CD Cobreloa,CD Huachipato,1,1,0,D
230478,6,CHL1,2006-07-16,CD Cobresal,Antofagasta,1,0,1,W
230479,6,CHL1,2006-07-16,Everton CD,Puerto Montt,1,2,-1,L
230480,6,CHL1,2006-07-16,La Serena,Audax Italiano,2,1,1,W
230481,6,CHL1,2006-07-16,Santiago Morning,Santiago Wanderers,1,1,0,D
230482,6,CHL1,2006-07-22,Santiago Wanderers,La Serena,2,0,2,W
230483,6,CHL1,2006-07-22,Higgins,Santiago Morning,4,2,2,W
230484,6,CHL1,2006-07-22,Audax Italiano,CSD Rangers,1,0,1,W
230485,6,CHL1,2006-07-22,Coquimbo Unido,Everton CD,0,0,0,D
230486,6,CHL1,2006-07-23,Puerto Montt,CD Cobreloa,4,1,3,W
230487,6,CHL1,2006-07-23,Universidad de Concepcion,Union Espanola,4,2,2,W
230488,6,CHL1,2006-07-23,CD Huachipato,CD Cobresal,1,1,0,D
230489,6,CHL1,2006-07-23,Antofagasta,Colo Colo,1,1,0,D
230490,6,CHL1,2006-07-23,CD Palestino,Universidad de Chile,1,0,1,W
230491,6,CHL1,2006-07-29,CD Palestino,Antofagasta,1,1,0,D
230492,6,CHL1,2006-07-29,Universidad Catolica,Higgins,0,1,-1,L
230493,6,CHL1,2006-07-29,Audax Italiano,Puerto Montt,1,1,0,D
230494,6,CHL1,2006-07-29,Union Espanola,La Serena,1,3,-2,L
230495,6,CHL1,2006-07-30,CSD Rangers,Santiago Wanderers,3,1,2,W
230496,6,CHL1,2006-07-30,Everton CD,Colo Colo,3,0,3,W
230497,6,CHL1,2006-07-30,CD Cobresal,Santiago Morning,3,0,3,W
230498,6,CHL1,2006-07-30,CD Cobreloa,Universidad de Concepcion,1,0,1,W
230499,6,CHL1,2006-07-30,Universidad de Chile,CD Huachipato,0,2,-2,L
230500,6,CHL1,2006-08-02,Universidad Catolica,Universidad de Concepcion,0,2,-2,L
230501,6,CHL1,2006-08-05,Union Espanola,Audax Italiano,0,1,-1,L
230502,6,CHL1,2006-08-05,Puerto Montt,Universidad de Chile,3,0,3,W
230503,6,CHL1,2006-08-05,Higgins,Everton CD,2,0,2,W
230504,6,CHL1,2006-08-06,Santiago Morning,Universidad de Concepcion,1,1,0,D
230505,6,CHL1,2006-08-06,Colo Colo,CD Palestino,1,3,-2,L
230506,6,CHL1,2006-08-06,Antofagasta,CSD Rangers,1,1,0,D
230507,6,CHL1,2006-08-06,La Serena,CD Cobreloa,3,6,-3,L
230508,6,CHL1,2006-08-06,Santiago Wanderers,Universidad Catolica,1,1,0,D
230509,6,CHL1,2006-08-09,Colo Colo,Higgins,4,1,3,W
230510,6,CHL1,2006-08-12,CD Palestino,CD Cobresal,1,0,1,W
230511,6,CHL1,2006-08-12,Universidad Catolica,Santiago Morning,1,0,1,W
230512,6,CHL1,2006-08-12,Audax Italiano,Antofagasta,1,1,0,D
230513,6,CHL1,2006-08-12,Coquimbo Unido,Colo Colo,1,4,-3,L
230514,6,CHL1,2006-08-13,Puerto Montt,Union Espanola,0,1,-1,L
230515,6,CHL1,2006-08-13,Everton CD,CD Huachipato,1,3,-2,L
230516,6,CHL1,2006-08-13,Universidad de Chile,CD Cobreloa,1,1,0,D
230517,6,CHL1,2006-08-13,CSD Rangers,Higgins,1,1,0,D
230518,6,CHL1,2006-08-19,Universidad Catolica,CD Palestino,1,0,1,W
230519,6,CHL1,2006-08-19,Higgins,Coquimbo Unido,3,0,3,W
230520,6,CHL1,2006-08-19,Santiago Wanderers,Puerto Montt,3,0,3,W
230521,6,CHL1,2006-08-20,Santiago Morning,CD Huachipato,3,4,-1,L
230522,6,CHL1,2006-08-20,Colo Colo,Union Espanola,1,0,1,W
230523,6,CHL1,2006-08-20,CD Cobresal,CSD Rangers,0,0,0,D
230524,6,CHL1,2006-08-20,CD Cobreloa,Everton CD,3,0,3,W
230525,6,CHL1,2006-08-20,Antofagasta,Universidad de Concepcion,3,2,1,W
230526,6,CHL1,2006-08-20,La Serena,Universidad de Chile,3,0,3,W
230527,6,CHL1,2006-08-26,Puerto Montt,Higgins,1,1,0,D
230528,6,CHL1,2006-08-26,Union Espanola,Antofagasta,3,3,0,D
230529,6,CHL1,2006-08-26,CD Palestino,Audax Italiano,0,3,-3,L
230530,6,CHL1,2006-08-26,Everton CD,Santiago Morning,1,1,0,D
230531,6,CHL1,2006-08-26,Universidad de Concepcion,Santiago Wanderers,1,2,-1,L
230532,6,CHL1,2006-08-26,Coquimbo Unido,CD Cobresal,1,0,1,W
230533,6,CHL1,2006-08-27,CSD Rangers,Colo Colo,0,0,0,D
230534,6,CHL1,2006-08-27,CD Huachipato,La Serena,2,0,2,W
230535,6,CHL1,2006-08-27,Universidad de Chile,Universidad Catolica,1,0,1,W
230536,6,CHL1,2006-08-30,Universidad de Concepcion,La Serena,4,1,3,W
230537,6,CHL1,2006-09-02,Universidad Catolica,Coquimbo Unido,0,0,0,D
230538,6,CHL1,2006-09-02,Higgins,Santiago Wanderers,1,0,1,W
230539,6,CHL1,2006-09-03,Santiago Morning,Antofagasta,1,4,-3,L
230540,6,CHL1,2006-09-03,Everton CD,Union Espanola,1,2,-1,L
230541,6,CHL1,2006-09-03,Colo Colo,Puerto Montt,4,1,3,W
230542,6,CHL1,2006-09-03,CD Cobresal,Universidad de Concepcion,4,1,3,W
230543,6,CHL1,2006-09-03,CD Cobreloa,CD Palestino,1,0,1,W
230544,6,CHL1,2006-09-03,La Serena,CSD Rangers,1,2,-1,L
230545,6,CHL1,2006-09-03,Audax Italiano,Universidad de Chile,0,1,-1,L
230546,6,CHL1,2006-09-09,Union Espanola,Santiago Morning,1,2,-1,L
230547,6,CHL1,2006-09-09,CSD Rangers,Universidad Catolica,1,1,0,D
230548,6,CHL1,2006-09-09,Universidad de Chile,CD Cobresal,2,0,2,W
230549,6,CHL1,2006-09-10,Santiago Wanderers,Colo Colo,1,0,1,W
230550,6,CHL1,2006-09-10,Puerto Montt,CD Huachipato,2,1,1,W
230551,6,CHL1,2006-09-10,Antofagasta,Everton CD,0,0,0,D
230552,6,CHL1,2006-09-10,CD Palestino,Higgins,0,0,0,D
230553,6,CHL1,2006-09-10,Coquimbo Unido,La Serena,4,3,1,W
230554,6,CHL1,2006-09-10,Audax Italiano,CD Cobreloa,5,3,2,W
230555,6,CHL1,2006-09-15,Colo Colo,Universidad de Concepcion,4,2,2,W
230556,6,CHL1,2006-09-16,Higgins,Universidad de Chile,2,0,2,W
230557,6,CHL1,2006-09-16,CD Cobreloa,Antofagasta,3,1,2,W
230558,6,CHL1,2006-09-16,Universidad Catolica,Audax Italiano,5,1,4,W
230559,6,CHL1,2006-09-16,La Serena,Puerto Montt,0,0,0,D
230560,6,CHL1,2006-09-17,Santiago Morning,Coquimbo Unido,2,2,0,D
230561,6,CHL1,2006-09-17,CD Huachipato,Santiago Wanderers,2,3,-1,L
230562,6,CHL1,2006-09-17,Everton CD,CSD Rangers,3,0,3,W
230563,6,CHL1,2006-09-17,CD Cobresal,Union Espanola,2,4,-2,L
230564,6,CHL1,2006-09-23,Union Espanola,CD Cobreloa,0,3,-3,L
230565,6,CHL1,2006-09-23,Audax Italiano,CD Cobresal,5,0,5,W
230566,6,CHL1,2006-09-23,Puerto Montt,Universidad Catolica,3,1,2,W
230567,6,CHL1,2006-09-23,La Serena,CD Palestino,1,1,0,D
230568,6,CHL1,2006-09-24,CSD Rangers,Santiago Morning,3,1,2,W
230569,6,CHL1,2006-09-24,Universidad de Concepcion,Higgins,0,0,0,D
230570,6,CHL1,2006-09-24,Santiago Wanderers,Everton CD,1,1,0,D
230571,6,CHL1,2006-09-24,Antofagasta,CD Huachipato,2,0,2,W
230572,6,CHL1,2006-09-24,Universidad de Chile,Coquimbo Unido,1,2,-1,L
230573,6,CHL1,2006-09-30,CD Huachipato,Colo Colo,1,2,-1,L
230574,6,CHL1,2006-09-30,CD Palestino,Universidad de Concepcion,2,2,0,D
230575,6,CHL1,2006-09-30,Union Espanola,Universidad Catolica,1,1,0,D
230576,6,CHL1,2006-09-30,Higgins,Antofagasta,3,1,2,W
230577,6,CHL1,2006-09-30,Coquimbo Unido,Puerto Montt,0,1,-1,L
230578,6,CHL1,2006-10-01,CD Cobreloa,Santiago Wanderers,3,1,2,W
230579,6,CHL1,2006-10-01,Everton CD,Audax Italiano,4,3,1,W
230580,6,CHL1,2006-10-01,CD Cobresal,La Serena,1,1,0,D
230581,6,CHL1,2006-10-01,Universidad de Chile,CSD Rangers,4,0,4,W
230582,6,CHL1,2006-10-14,Puerto Montt,CD Cobresal,2,0,2,W
230583,6,CHL1,2006-10-14,Universidad Catolica,Everton CD,2,1,1,W
230584,6,CHL1,2006-10-14,Audax Italiano,CD Huachipato,2,1,1,W
230585,6,CHL1,2006-10-14,La Serena,Higgins,4,4,0,D
230586,6,CHL1,2006-10-14,Universidad de Concepcion,Universidad de Chile,2,2,0,D
230587,6,CHL1,2006-10-15,CSD Rangers,CD Cobreloa,1,3,-2,L
230588,6,CHL1,2006-10-15,Antofagasta,Coquimbo Unido,0,1,-1,L
230589,6,CHL1,2006-10-15,Santiago Wanderers,CD Palestino,2,0,2,W
230590,6,CHL1,2006-10-15,Colo Colo,Santiago Morning,2,2,0,D
230591,6,CHL1,2006-10-21,CD Cobresal,Universidad Catolica,1,2,-1,L
230592,6,CHL1,2006-10-21,Higgins,Audax Italiano,1,0,1,W
230593,6,CHL1,2006-10-21,Coquimbo Unido,CD Palestino,3,0,3,W
230594,6,CHL1,2006-10-22,Santiago Morning,Puerto Montt,2,0,2,W
230595,6,CHL1,2006-10-22,CD Cobreloa,Colo Colo,2,2,0,D
230596,6,CHL1,2006-10-22,CSD Rangers,Universidad de Concepcion,2,1,1,W
230597,6,CHL1,2006-10-22,CD Huachipato,Union Espanola,1,0,1,W
230598,6,CHL1,2006-10-22,Everton CD,La Serena,1,1,0,D
230599,6,CHL1,2006-10-22,Universidad de Chile,Santiago Wanderers,2,0,2,W
230600,6,CHL1,2006-10-28,CD Cobreloa,Higgins,3,1,2,W
230601,6,CHL1,2006-10-28,CD Palestino,Everton CD,1,1,0,D
230602,6,CHL1,2006-10-28,Universidad Catolica,CD Huachipato,3,1,2,W
230603,6,CHL1,2006-10-28,Union Espanola,CSD Rangers,0,0,0,D
230604,6,CHL1,2006-10-28,Universidad de Concepcion,Coquimbo Unido,3,2,1,W
230605,6,CHL1,2006-10-28,Audax Italiano,Santiago Morning,1,2,-1,L
230606,6,CHL1,2006-10-29,Santiago Wanderers,CD Cobresal,1,0,1,W
230607,6,CHL1,2006-10-29,Antofagasta,Puerto Montt,3,1,2,W
230608,6,CHL1,2006-10-29,Colo Colo,Universidad de Chile,4,2,2,W
230609,6,CHL1,2006-10-31,Coquimbo Unido,CD Cobreloa,1,1,0,D
230610,6,CHL1,2006-10-31,Antofagasta,Universidad Catolica,1,2,-1,L
230611,6,CHL1,2006-11-01,Puerto Montt,Universidad de Concepcion,1,0,1,W
230612,6,CHL1,2006-11-01,CD Huachipato,CSD Rangers,1,3,-2,L
230613,6,CHL1,2006-11-01,Colo Colo,La Serena,4,4,0,D
230614,6,CHL1,2006-11-01,Santiago Morning,CD Palestino,0,1,-1,L
230615,6,CHL1,2006-11-01,CD Cobresal,Higgins,2,1,1,W
230616,6,CHL1,2006-11-01,Audax Italiano,Santiago Wanderers,2,0,2,W
230617,6,CHL1,2006-11-01,Union Espanola,Universidad de Chile,2,6,-4,L
230618,6,CHL1,2006-11-04,Universidad de Chile,Everton CD,1,2,-1,L
230619,6,CHL1,2006-11-04,Higgins,CD Huachipato,3,2,1,W
230620,6,CHL1,2006-11-04,La Serena,Santiago Morning,1,0,1,W
230621,6,CHL1,2006-11-05,CD Cobreloa,CD Cobresal,3,1,2,W
230622,6,CHL1,2006-11-05,CSD Rangers,Coquimbo Unido,1,2,-1,L
230623,6,CHL1,2006-11-05,Universidad Catolica,Colo Colo,0,1,-1,L
230624,6,CHL1,2006-11-05,CD Palestino,Union Espanola,1,0,1,W
230625,6,CHL1,2006-11-05,Universidad de Concepcion,Audax Italiano,1,0,1,W
230626,6,CHL1,2006-11-05,Santiago Wanderers,Antofagasta,1,0,1,W
230627,6,CHL1,2006-11-10,Coquimbo Unido,Santiago Wanderers,2,0,2,W
230628,6,CHL1,2006-11-11,Puerto Montt,CD Palestino,2,1,1,W
230629,6,CHL1,2006-11-11,CD Huachipato,Universidad de Concepcion,2,3,-1,L
230630,6,CHL1,2006-11-11,Universidad Catolica,CD Cobreloa,1,0,1,W
230631,6,CHL1,2006-11-11,Everton CD,CD Cobresal,2,0,2,W
230632,6,CHL1,2006-11-11,Colo Colo,Audax Italiano,2,3,-1,L
230633,6,CHL1,2006-11-12,Antofagasta,La Serena,3,2,1,W
230634,6,CHL1,2006-11-12,Santiago Morning,Universidad de Chile,1,0,1,W
230635,6,CHL1,2006-11-12,Union Espanola,Higgins,0,2,-2,L
230636,6,CHL1,2006-11-15,CD Huachipato,Coquimbo Unido,0,1,-1,L
230637,6,CHL1,2006-11-18,CD Palestino,CD Huachipato,2,4,-2,L
230638,6,CHL1,2006-11-18,Audax Italiano,Coquimbo Unido,2,0,2,W
230639,6,CHL1,2006-11-18,La Serena,Universidad Catolica,2,3,-1,L
230640,6,CHL1,2006-11-19,CSD Rangers,Puerto Montt,1,2,-1,L
230641,6,CHL1,2006-11-19,Santiago Wanderers,Union Espanola,2,2,0,D
230642,6,CHL1,2006-11-19,CD Cobreloa,Santiago Morning,2,1,1,W
230643,6,CHL1,2006-11-19,Universidad de Chile,Antofagasta,1,0,1,W
230644,6,CHL1,2006-11-19,Universidad de Concepcion,Everton CD,5,1,4,W
230645,6,CHL1,2006-11-22,CD Cobresal,Colo Colo,4,1,3,W
230646,7,CHL1,2007-01-27,Deportes Melipilla,Colo Colo,1,2,-1,L
230647,7,CHL1,2007-01-27,CD Cobreloa,Antofagasta,7,1,6,W
230648,7,CHL1,2007-01-27,Puerto Montt,Deportivo Nublense,1,1,0,D
230649,7,CHL1,2007-01-27,Union Espanola,La Serena,1,0,1,W
230650,7,CHL1,2007-01-27,Coquimbo Unido,CD Huachipato,1,3,-2,L
230651,7,CHL1,2007-01-28,CD Cobresal,Audax Italiano,1,3,-2,L
230652,7,CHL1,2007-01-28,Universidad Catolica,Santiago Wanderers,1,0,1,W
230653,7,CHL1,2007-01-28,Lota Schwager,CD Palestino,3,3,0,D
230654,7,CHL1,2007-01-28,Universidad de Chile,Universidad de Concepcion,1,0,1,W
230655,7,CHL1,2007-01-29,Everton CD,Higgins,2,0,2,W
230656,7,CHL1,2007-02-03,La Serena,Universidad Catolica,1,2,-1,L
230657,7,CHL1,2007-02-03,Audax Italiano,Lota Schwager,3,2,1,W
230658,7,CHL1,2007-02-03,CD Palestino,Puerto Montt,1,2,-1,L
230659,7,CHL1,2007-02-03,Higgins,Santiago Wanderers,3,2,1,W
230660,7,CHL1,2007-02-03,Universidad de Concepcion,Coquimbo Unido,0,0,0,D
230661,7,CHL1,2007-02-03,Union Espanola,Everton CD,1,0,1,W
230662,7,CHL1,2007-02-03,Colo Colo,Deportes Concepcion,4,0,4,W
230663,7,CHL1,2007-02-04,CD Huachipato,CD Cobresal,1,0,1,W
230664,7,CHL1,2007-02-04,Deportivo Nublense,Deportes Melipilla,1,1,0,D
230665,7,CHL1,2007-02-10,Deportes Concepcion,La Serena,1,1,0,D
230666,7,CHL1,2007-02-10,Coquimbo Unido,Colo Colo,0,3,-3,L
230667,7,CHL1,2007-02-10,Deportes Melipilla,Union Espanola,2,1,1,W
230668,7,CHL1,2007-02-10,Santiago Wanderers,Antofagasta,0,0,0,D
230669,7,CHL1,2007-02-11,CD Cobreloa,CD Huachipato,3,1,2,W
230670,7,CHL1,2007-02-11,CD Cobresal,Higgins,2,0,2,W
230671,7,CHL1,2007-02-11,Lota Schwager,Deportivo Nublense,1,1,0,D
230672,7,CHL1,2007-02-11,Universidad Catolica,CD Palestino,2,0,2,W
230673,7,CHL1,2007-02-11,Everton CD,Universidad de Concepcion,2,1,1,W
230674,7,CHL1,2007-02-17,Puerto Montt,Universidad de Chile,2,0,2,W
230675,7,CHL1,2007-02-17,Colo Colo,CD Cobresal,4,2,2,W
230676,7,CHL1,2007-02-17,Higgins,Union Espanola,3,0,3,W
230677,7,CHL1,2007-02-17,La Serena,CD Cobreloa,2,4,-2,L
230678,7,CHL1,2007-02-18,CD Palestino,Coquimbo Unido,3,2,1,W
230679,7,CHL1,2007-02-18,Antofagasta,Deportes Melipilla,2,1,1,W
230680,7,CHL1,2007-02-18,CD Huachipato,Deportivo Nublense,1,1,0,D
230681,7,CHL1,2007-02-18,Audax Italiano,Everton CD,4,2,2,W
230682,7,CHL1,2007-02-18,Universidad Catolica,Lota Schwager,2,0,2,W
230683,7,CHL1,2007-02-18,Deportes Concepcion,Santiago Wanderers,1,0,1,W
230684,7,CHL1,2007-02-24,CD Cobreloa,Higgins,5,0,5,W
230685,7,CHL1,2007-02-24,Universidad de Chile,La Serena,0,0,0,D
230686,7,CHL1,2007-02-24,CD Huachipato,Deportes Concepcion,3,0,3,W
230687,7,CHL1,2007-02-24,Deportes Melipilla,CD Cobresal,2,0,2,W
230688,7,CHL1,2007-02-24,Union Espanola,Audax Italiano,2,2,0,D
230689,7,CHL1,2007-02-24,Coquimbo Unido,Antofagasta,2,1,1,W
230690,7,CHL1,2007-02-25,Everton CD,Universidad Catolica,1,0,1,W
230691,7,CHL1,2007-02-25,Santiago Wanderers,Puerto Montt,1,1,0,D
230692,7,CHL1,2007-02-25,Deportivo Nublense,CD Palestino,1,0,1,W
230693,7,CHL1,2007-02-27,Lota Schwager,Deportes Melipilla,1,4,-3,L
230694,7,CHL1,2007-02-27,CD Cobresal,CD Cobreloa,1,0,1,W
230695,7,CHL1,2007-02-28,CD Palestino,CD Huachipato,1,1,0,D
230696,7,CHL1,2007-02-28,Deportivo Nublense,Universidad Catolica,3,3,0,D
230697,7,CHL1,2007-02-28,Puerto Montt,Universidad de Concepcion,1,3,-2,L
230698,7,CHL1,2007-02-28,Colo Colo,Union Espanola,2,1,1,W
230699,7,CHL1,2007-02-28,Santiago Wanderers,Coquimbo Unido,3,1,2,W
230700,7,CHL1,2007-02-28,La Serena,Higgins,2,1,1,W
230701,7,CHL1,2007-02-28,Antofagasta,Everton CD,1,1,0,D
230702,7,CHL1,2007-03-01,Deportes Concepcion,Universidad de Chile,1,0,1,W
230703,7,CHL1,2007-03-03,Higgins,Lota Schwager,3,3,0,D
230704,7,CHL1,2007-03-03,Union Espanola,CD Cobresal,1,0,1,W
230705,7,CHL1,2007-03-03,Colo Colo,Antofagasta,3,0,3,W
230706,7,CHL1,2007-03-04,Everton CD,Deportivo Nublense,1,2,-1,L
230707,7,CHL1,2007-03-04,CD Cobreloa,Puerto Montt,2,0,2,W
230708,7,CHL1,2007-03-04,Deportes Melipilla,Deportes Concepcion,1,1,0,D
230709,7,CHL1,2007-03-04,CD Huachipato,Santiago Wanderers,1,0,1,W
230710,7,CHL1,2007-03-04,Universidad de Concepcion,CD Palestino,0,0,0,D
230711,7,CHL1,2007-03-04,Universidad Catolica,Universidad de Chile,0,0,0,D
230712,7,CHL1,2007-03-04,Coquimbo Unido,Audax Italiano,1,1,0,D
230713,7,CHL1,2007-03-09,Universidad de Chile,CD Cobreloa,0,1,-1,L
230714,7,CHL1,2007-03-09,Audax Italiano,CD Huachipato,1,0,1,W
230715,7,CHL1,2007-03-10,La Serena,Everton CD,1,1,0,D
230716,7,CHL1,2007-03-11,Antofagasta,Higgins,1,1,0,D
230717,7,CHL1,2007-03-11,Lota Schwager,Universidad de Concepcion,2,4,-2,L
230718,7,CHL1,2007-03-11,Deportivo Nublense,Colo Colo,0,2,-2,L
230719,7,CHL1,2007-03-11,Santiago Wanderers,Deportes Melipilla,3,2,1,W
230720,7,CHL1,2007-03-11,CD Cobresal,Coquimbo Unido,3,0,3,W
230721,7,CHL1,2007-03-11,Deportes Concepcion,Universidad Catolica,0,1,-1,L
230722,7,CHL1,2007-03-14,Universidad de Concepcion,Colo Colo,0,2,-2,L
230723,7,CHL1,2007-03-17,CD Palestino,Deportes Melipilla,1,1,0,D
230724,7,CHL1,2007-03-17,Colo Colo,Lota Schwager,2,2,0,D
230725,7,CHL1,2007-03-17,Union Espanola,Deportivo Nublense,2,2,0,D
230726,7,CHL1,2007-03-18,Everton CD,Santiago Wanderers,1,1,0,D
230727,7,CHL1,2007-03-18,CD Huachipato,Puerto Montt,3,1,2,W
230728,7,CHL1,2007-03-18,Coquimbo Unido,La Serena,0,1,-1,L
230729,7,CHL1,2007-03-18,Universidad de Concepcion,CD Cobresal,3,1,2,W
230730,7,CHL1,2007-03-18,CD Cobreloa,Deportes Concepcion,3,0,3,W
230731,7,CHL1,2007-03-18,Audax Italiano,Antofagasta,0,0,0,D
230732,7,CHL1,2007-03-25,Puerto Montt,Union Espanola,2,5,-3,L
230733,7,CHL1,2007-03-30,Universidad de Chile,CD Huachipato,1,0,1,W
230734,7,CHL1,2007-03-31,Puerto Montt,Everton CD,1,3,-2,L
230735,7,CHL1,2007-03-31,CD Cobresal,Universidad Catolica,1,1,0,D
230736,7,CHL1,2007-03-31,CD Palestino,Audax Italiano,0,2,-2,L
230737,7,CHL1,2007-03-31,Deportes Concepcion,Higgins,1,2,-1,L
230738,7,CHL1,2007-04-01,Antofagasta,Union Espanola,0,1,-1,L
230739,7,CHL1,2007-04-01,Lota Schwager,Coquimbo Unido,1,3,-2,L
230740,7,CHL1,2007-04-01,Deportivo Nublense,Universidad de Concepcion,2,0,2,W
230741,7,CHL1,2007-04-01,Santiago Wanderers,CD Cobreloa,1,1,0,D
230742,7,CHL1,2007-04-03,CD Huachipato,La Serena,2,1,1,W
230743,7,CHL1,2007-04-03,Higgins,CD Palestino,4,1,3,W
230744,7,CHL1,2007-04-04,CD Cobreloa,Deportivo Nublense,1,2,-1,L
230745,7,CHL1,2007-04-04,Universidad de Concepcion,Santiago Wanderers,3,1,2,W
230746,7,CHL1,2007-04-04,Audax Italiano,Deportes Concepcion,2,0,2,W
230747,7,CHL1,2007-04-04,Everton CD,CD Cobresal,0,0,0,D
230748,7,CHL1,2007-04-04,Union Espanola,Lota Schwager,4,0,4,W
230749,7,CHL1,2007-04-04,Universidad Catolica,Antofagasta,0,0,0,D
230750,7,CHL1,2007-04-05,Universidad de Chile,Deportes Melipilla,3,0,3,W
230751,7,CHL1,2007-04-06,Coquimbo Unido,Puerto Montt,2,0,2,W
230752,7,CHL1,2007-04-07,Universidad Catolica,CD Huachipato,2,0,2,W
230753,7,CHL1,2007-04-07,CD Palestino,La Serena,3,2,1,W
230754,7,CHL1,2007-04-08,Antofagasta,Deportes Concepcion,3,1,2,W
230755,7,CHL1,2007-04-08,Santiago Wanderers,Universidad de Chile,0,2,-2,L
230756,7,CHL1,2007-04-08,Lota Schwager,Everton CD,2,0,2,W
230757,7,CHL1,2007-04-08,Deportes Melipilla,CD Cobreloa,2,1,1,W
230758,7,CHL1,2007-04-08,Deportivo Nublense,Audax Italiano,3,2,1,W
230759,7,CHL1,2007-04-08,Colo Colo,Puerto Montt,3,0,3,W
230760,7,CHL1,2007-04-08,Universidad de Concepcion,Union Espanola,0,2,-2,L
230761,7,CHL1,2007-04-08,Coquimbo Unido,Higgins,1,2,-1,L
230762,7,CHL1,2007-04-11,La Serena,Colo Colo,1,1,0,D
230763,7,CHL1,2007-04-14,Puerto Montt,Lota Schwager,0,1,-1,L
230764,7,CHL1,2007-04-14,Union Espanola,CD Palestino,1,1,0,D
230765,7,CHL1,2007-04-14,Higgins,Universidad de Concepcion,4,2,2,W
230766,7,CHL1,2007-04-14,Deportes Concepcion,CD Cobresal,1,1,0,D
230767,7,CHL1,2007-04-15,Everton CD,Colo Colo,0,3,-3,L
230768,7,CHL1,2007-04-15,CD Huachipato,Antofagasta,3,1,2,W
230769,7,CHL1,2007-04-15,CD Cobreloa,Coquimbo Unido,5,1,4,W
230770,7,CHL1,2007-04-15,Universidad de Chile,Deportivo Nublense,1,1,0,D
230771,7,CHL1,2007-04-15,La Serena,Deportes Melipilla,2,1,1,W
230772,7,CHL1,2007-04-15,Audax Italiano,Universidad Catolica,1,3,-2,L
230773,7,CHL1,2007-04-21,Lota Schwager,CD Huachipato,1,2,-1,L
230774,7,CHL1,2007-04-21,Colo Colo,Higgins,6,2,4,W
230775,7,CHL1,2007-04-21,Coquimbo Unido,Everton CD,0,1,-1,L
230776,7,CHL1,2007-04-21,Santiago Wanderers,Audax Italiano,1,2,-1,L
230777,7,CHL1,2007-04-22,Antofagasta,La Serena,4,1,3,W
230778,7,CHL1,2007-04-22,Deportes Concepcion,Union Espanola,3,2,1,W
230779,7,CHL1,2007-04-22,Deportes Melipilla,Universidad de Concepcion,3,2,1,W
230780,7,CHL1,2007-04-22,CD Palestino,Universidad de Chile,1,1,0,D
230781,7,CHL1,2007-04-22,CD Cobresal,Puerto Montt,1,0,1,W
230782,7,CHL1,2007-04-22,Universidad Catolica,CD Cobreloa,2,1,1,W
230783,7,CHL1,2007-04-28,CD Palestino,Antofagasta,4,1,3,W
230784,7,CHL1,2007-04-28,Union Espanola,Coquimbo Unido,1,2,-1,L
230785,7,CHL1,2007-04-28,CD Cobresal,Lota Schwager,6,0,6,W
230786,7,CHL1,2007-04-28,Universidad de Concepcion,Universidad Catolica,2,4,-2,L
230787,7,CHL1,2007-04-28,Everton CD,Deportes Melipilla,2,2,0,D
230788,7,CHL1,2007-04-28,Higgins,Deportivo Nublense,0,1,-1,L
230789,7,CHL1,2007-04-29,La Serena,Santiago Wanderers,2,1,1,W
230790,7,CHL1,2007-04-29,Puerto Montt,Deportes Concepcion,3,1,2,W
230791,7,CHL1,2007-04-29,Universidad de Chile,Colo Colo,0,0,0,D
230792,7,CHL1,2007-04-29,Audax Italiano,CD Cobreloa,2,0,2,W
230793,7,CHL1,2007-05-02,Antofagasta,Universidad de Chile,1,1,0,D
230794,7,CHL1,2007-05-05,CD Cobreloa,Colo Colo,2,2,0,D
230795,7,CHL1,2007-05-05,Deportes Concepcion,Lota Schwager,3,2,1,W
230796,7,CHL1,2007-05-06,CD Huachipato,Everton CD,3,0,3,W
230797,7,CHL1,2007-05-06,Deportivo Nublense,CD Cobresal,1,1,0,D
230798,7,CHL1,2007-05-06,La Serena,Puerto Montt,3,0,3,W
230799,7,CHL1,2007-05-06,Deportes Melipilla,Higgins,2,0,2,W
230800,7,CHL1,2007-05-06,Santiago Wanderers,CD Palestino,1,2,-1,L
230801,7,CHL1,2007-05-06,Audax Italiano,Universidad de Concepcion,0,0,0,D
230802,7,CHL1,2007-05-06,Universidad Catolica,Union Espanola,1,0,1,W
230803,7,CHL1,2007-05-07,Universidad de Chile,Coquimbo Unido,2,0,2,W
230804,7,CHL1,2007-05-12,CD Palestino,Deportes Concepcion,2,0,2,W
230805,7,CHL1,2007-05-12,Universidad de Concepcion,CD Huachipato,2,3,-1,L
230806,7,CHL1,2007-05-12,Colo Colo,Santiago Wanderers,3,1,2,W
230807,7,CHL1,2007-05-12,Higgins,Audax Italiano,1,2,-1,L
230808,7,CHL1,2007-05-12,Coquimbo Unido,Deportes Melipilla,0,4,-4,L
230809,7,CHL1,2007-05-13,Everton CD,CD Cobreloa,1,1,0,D
230810,7,CHL1,2007-05-13,Puerto Montt,Universidad Catolica,0,1,-1,L
230811,7,CHL1,2007-05-13,Antofagasta,Deportivo Nublense,3,1,2,W
230812,7,CHL1,2007-05-13,Lota Schwager,Universidad de Chile,1,2,-1,L
230813,7,CHL1,2007-05-13,CD Cobresal,La Serena,2,1,1,W
230814,7,CHL1,2007-05-16,Universidad de Chile,Audax Italiano,2,2,0,D
230815,7,CHL1,2007-05-19,Universidad Catolica,Higgins,4,1,3,W
230816,7,CHL1,2007-05-19,Santiago Wanderers,Lota Schwager,5,2,3,W
230817,7,CHL1,2007-05-20,La Serena,Universidad de Concepcion,1,0,1,W
230818,7,CHL1,2007-05-20,Antofagasta,CD Cobresal,0,1,-1,L
230819,7,CHL1,2007-05-20,Deportivo Nublense,Coquimbo Unido,2,1,1,W
230820,7,CHL1,2007-05-20,CD Huachipato,Union Espanola,2,1,1,W
230821,7,CHL1,2007-05-20,Deportes Concepcion,Everton CD,1,1,0,D
230822,7,CHL1,2007-05-20,Deportes Melipilla,Puerto Montt,2,1,1,W
230823,7,CHL1,2007-05-20,CD Cobreloa,CD Palestino,3,2,1,W
230824,7,CHL1,2007-05-20,Audax Italiano,Colo Colo,1,0,1,W
230825,7,CHL1,2007-05-23,Higgins,Universidad de Chile,1,0,1,W
230826,7,CHL1,2007-05-26,Puerto Montt,Antofagasta,3,1,2,W
230827,7,CHL1,2007-05-26,Union Espanola,Universidad de Chile,2,1,1,W
230828,7,CHL1,2007-05-26,Higgins,CD Huachipato,0,0,0,D
230829,7,CHL1,2007-05-27,Universidad de Concepcion,CD Cobreloa,1,1,0,D
230830,7,CHL1,2007-05-27,Deportivo Nublense,Deportes Concepcion,2,3,-1,L
230831,7,CHL1,2007-05-27,Everton CD,CD Palestino,1,1,0,D
230832,7,CHL1,2007-05-27,CD Cobresal,Santiago Wanderers,3,1,2,W
230833,7,CHL1,2007-05-27,Deportes Melipilla,Audax Italiano,1,3,-2,L
230834,7,CHL1,2007-05-27,Lota Schwager,La Serena,2,2,0,D
230835,7,CHL1,2007-05-27,Colo Colo,Universidad Catolica,2,1,1,W
230836,7,CHL1,2007-06-09,Universidad de Chile,Everton CD,2,4,-2,L
230837,7,CHL1,2007-06-09,Puerto Montt,Audax Italiano,0,4,-4,L
230838,7,CHL1,2007-06-09,CD Palestino,CD Cobresal,1,1,0,D
230839,7,CHL1,2007-06-09,Universidad Catolica,Deportes Melipilla,4,1,3,W
230840,7,CHL1,2007-06-09,Deportes Concepcion,Coquimbo Unido,2,1,1,W
230841,7,CHL1,2007-06-09,La Serena,Deportivo Nublense,6,2,4,W
230842,7,CHL1,2007-06-10,Santiago Wanderers,Union Espanola,1,0,1,W
230843,7,CHL1,2007-06-10,CD Huachipato,Colo Colo,2,2,0,D
230844,7,CHL1,2007-06-10,CD Cobreloa,Lota Schwager,2,1,1,W
230845,7,CHL1,2007-06-10,Antofagasta,Universidad de Concepcion,3,2,1,W
230846,7,CHL1,2007-06-16,CD Cobresal,Universidad de Chile,4,1,3,W
230847,7,CHL1,2007-06-16,Coquimbo Unido,Universidad Catolica,0,2,-2,L
230848,7,CHL1,2007-06-16,Colo Colo,CD Palestino,1,0,1,W
230849,7,CHL1,2007-06-16,Audax Italiano,La Serena,2,1,1,W
230850,7,CHL1,2007-06-16,Higgins,Puerto Montt,2,1,1,W
230851,7,CHL1,2007-06-17,Union Espanola,CD Cobreloa,1,1,0,D
230852,7,CHL1,2007-06-17,Universidad de Concepcion,Deportes Concepcion,0,0,0,D
230853,7,CHL1,2007-06-17,Deportivo Nublense,Santiago Wanderers,2,1,1,W
230854,7,CHL1,2007-06-17,Deportes Melipilla,CD Huachipato,2,4,-2,L
230855,7,CHL1,2007-06-17,Lota Schwager,Antofagasta,1,1,0,D
230856,7,CHL1,2007-07-21,Universidad de Concepcion,Universidad de Chile,1,1,0,D
230857,7,CHL1,2007-07-21,CD Palestino,Lota Schwager,2,2,0,D
230858,7,CHL1,2007-07-21,Deportivo Nublense,Puerto Montt,2,1,1,W
230859,7,CHL1,2007-07-21,Higgins,Everton CD,2,0,2,W
230860,7,CHL1,2007-07-22,La Serena,Union Espanola,2,1,1,W
230861,7,CHL1,2007-07-22,CD Huachipato,Coquimbo Unido,2,1,1,W
230862,7,CHL1,2007-07-22,Antofagasta,CD Cobreloa,2,0,2,W
230863,7,CHL1,2007-07-22,Santiago Wanderers,Universidad Catolica,1,0,1,W
230864,7,CHL1,2007-07-22,Audax Italiano,CD Cobresal,2,1,1,W
230865,7,CHL1,2007-07-25,Colo Colo,Deportes Melipilla,4,1,3,W
230866,7,CHL1,2007-07-28,Lota Schwager,Audax Italiano,1,2,-1,L
230867,7,CHL1,2007-07-28,Universidad de Chile,Antofagasta,2,0,2,W
230868,7,CHL1,2007-07-28,Coquimbo Unido,Universidad de Concepcion,0,1,-1,L
230869,7,CHL1,2007-07-28,Universidad Catolica,La Serena,3,1,2,W
230870,7,CHL1,2007-07-29,Puerto Montt,CD Palestino,2,1,1,W
230871,7,CHL1,2007-07-29,Everton CD,Union Espanola,0,0,0,D
230872,7,CHL1,2007-07-29,Santiago Wanderers,Higgins,2,3,-1,L
230873,7,CHL1,2007-07-29,Deportes Concepcion,Colo Colo,0,3,-3,L
230874,7,CHL1,2007-07-29,Deportes Melipilla,Deportivo Nublense,2,0,2,W
230875,7,CHL1,2007-08-04,CD Huachipato,CD Cobreloa,3,0,3,W
230876,7,CHL1,2007-08-04,Union Espanola,Deportes Melipilla,1,2,-1,L
230877,7,CHL1,2007-08-04,Higgins,CD Cobresal,1,1,0,D
230878,7,CHL1,2007-08-04,Universidad de Concepcion,Everton CD,1,1,0,D
230879,7,CHL1,2007-08-04,Audax Italiano,Universidad de Chile,1,1,0,D
230880,7,CHL1,2007-08-05,La Serena,Deportes Concepcion,2,1,1,W
230881,7,CHL1,2007-08-05,Colo Colo,Coquimbo Unido,2,1,1,W
230882,7,CHL1,2007-08-05,Deportivo Nublense,Lota Schwager,3,2,1,W
230883,7,CHL1,2007-08-05,Antofagasta,Santiago Wanderers,5,0,5,W
230884,7,CHL1,2007-08-05,CD Palestino,Universidad Catolica,1,1,0,D
230885,7,CHL1,2007-08-11,Lota Schwager,Universidad Catolica,0,1,-1,L
230886,7,CHL1,2007-08-11,Union Espanola,Higgins,1,2,-1,L
230887,7,CHL1,2007-08-11,Santiago Wanderers,Deportes Concepcion,0,0,0,D
230888,7,CHL1,2007-08-11,Coquimbo Unido,CD Palestino,2,3,-1,L
230889,7,CHL1,2007-08-11,Universidad de Chile,Puerto Montt,1,0,1,W
230890,7,CHL1,2007-08-12,Everton CD,Audax Italiano,1,2,-1,L
230891,7,CHL1,2007-08-12,Deportes Melipilla,Antofagasta,1,1,0,D
230892,7,CHL1,2007-08-12,Deportivo Nublense,CD Huachipato,2,1,1,W
230893,7,CHL1,2007-08-12,CD Cobresal,Colo Colo,2,1,1,W
230894,7,CHL1,2007-08-12,CD Cobreloa,La Serena,2,0,2,W
230895,7,CHL1,2007-08-15,Puerto Montt,Santiago Wanderers,0,0,0,D
230896,7,CHL1,2007-08-15,Universidad Catolica,Everton CD,3,1,2,W
230897,7,CHL1,2007-08-15,Colo Colo,Universidad de Concepcion,2,2,0,D
230898,7,CHL1,2007-08-15,CD Palestino,Deportivo Nublense,1,1,0,D
230899,7,CHL1,2007-08-15,Antofagasta,Coquimbo Unido,0,1,-1,L
230900,7,CHL1,2007-08-15,CD Cobresal,Deportes Melipilla,2,0,2,W
230901,7,CHL1,2007-08-15,Deportes Concepcion,CD Huachipato,4,3,1,W
230902,7,CHL1,2007-08-15,La Serena,Universidad de Chile,1,1,0,D
230903,7,CHL1,2007-08-17,Audax Italiano,Union Espanola,2,0,2,W
230904,7,CHL1,2007-08-18,Universidad Catolica,Deportivo Nublense,3,0,3,W
230905,7,CHL1,2007-08-18,Higgins,La Serena,1,0,1,W
230906,7,CHL1,2007-08-18,Universidad de Concepcion,Puerto Montt,2,0,2,W
230907,7,CHL1,2007-08-18,Universidad de Chile,Deportes Concepcion,5,2,3,W
230908,7,CHL1,2007-08-19,Everton CD,Antofagasta,0,1,-1,L
230909,7,CHL1,2007-08-19,Deportes Melipilla,Lota Schwager,0,0,0,D
230910,7,CHL1,2007-08-19,CD Huachipato,CD Palestino,2,1,1,W
230911,7,CHL1,2007-08-19,Coquimbo Unido,Santiago Wanderers,0,3,-3,L
230912,7,CHL1,2007-08-19,CD Cobreloa,CD Cobresal,2,2,0,D
230913,7,CHL1,2007-08-19,Union Espanola,Colo Colo,2,2,0,D
230914,7,CHL1,2007-08-25,Audax Italiano,Coquimbo Unido,2,1,1,W
230915,7,CHL1,2007-08-25,CD Palestino,Universidad de Concepcion,0,1,-1,L
230916,7,CHL1,2007-08-25,Antofagasta,Colo Colo,1,1,0,D
230917,7,CHL1,2007-08-25,Deportes Concepcion,Deportes Melipilla,3,1,2,W
230918,7,CHL1,2007-08-25,Santiago Wanderers,CD Huachipato,0,1,-1,L
230919,7,CHL1,2007-08-26,Puerto Montt,CD Cobreloa,0,1,-1,L
230920,7,CHL1,2007-08-26,Lota Schwager,Higgins,1,1,0,D
230921,7,CHL1,2007-08-26,Deportivo Nublense,Everton CD,1,1,0,D
230922,7,CHL1,2007-08-26,Universidad de Chile,Universidad Catolica,1,2,-1,L
230923,7,CHL1,2007-08-26,CD Cobresal,Union Espanola,1,0,1,W
230924,7,CHL1,2007-09-01,Universidad Catolica,Deportes Concepcion,2,3,-1,L
230925,7,CHL1,2007-09-01,CD Huachipato,Audax Italiano,1,1,0,D
230926,7,CHL1,2007-09-01,Colo Colo,Deportivo Nublense,3,1,2,W
230927,7,CHL1,2007-09-01,CD Cobreloa,Universidad de Chile,1,1,0,D
230928,7,CHL1,2007-09-01,Union Espanola,Puerto Montt,4,1,3,W
230929,7,CHL1,2007-09-01,Higgins,Antofagasta,2,1,1,W
230930,7,CHL1,2007-09-01,Universidad de Concepcion,Lota Schwager,2,0,2,W
230931,7,CHL1,2007-09-02,Coquimbo Unido,CD Cobresal,1,2,-1,L
230932,7,CHL1,2007-09-02,Everton CD,La Serena,0,1,-1,L
230933,7,CHL1,2007-09-02,Deportes Melipilla,Santiago Wanderers,3,0,3,W
230934,7,CHL1,2007-09-08,CD Cobresal,CD Huachipato,2,1,1,W
230935,7,CHL1,2007-09-08,Higgins,CD Cobreloa,2,2,0,D
230936,7,CHL1,2007-09-09,La Serena,Coquimbo Unido,2,2,0,D
230937,7,CHL1,2007-09-13,Deportes Concepcion,CD Cobreloa,1,4,-3,L
230938,7,CHL1,2007-09-15,CD Cobresal,Universidad de Concepcion,2,2,0,D
230939,7,CHL1,2007-09-16,Santiago Wanderers,Everton CD,2,1,1,W
230940,7,CHL1,2007-09-16,Puerto Montt,CD Huachipato,4,1,3,W
230941,7,CHL1,2007-09-16,Deportivo Nublense,Union Espanola,2,3,-1,L
230942,7,CHL1,2007-09-16,Lota Schwager,Colo Colo,0,1,-1,L
230943,7,CHL1,2007-09-16,Antofagasta,Audax Italiano,1,3,-2,L
230944,7,CHL1,2007-09-16,Deportes Melipilla,CD Palestino,1,2,-1,L
230945,7,CHL1,2007-09-22,Universidad Catolica,CD Cobresal,2,0,2,W
230946,7,CHL1,2007-09-22,CD Cobreloa,Santiago Wanderers,1,0,1,W
230947,7,CHL1,2007-09-22,Colo Colo,La Serena,2,0,2,W
230948,7,CHL1,2007-09-22,Union Espanola,Antofagasta,0,0,0,D
230949,7,CHL1,2007-09-22,Universidad de Concepcion,Deportivo Nublense,2,2,0,D
230950,7,CHL1,2007-09-22,Higgins,Deportes Concepcion,1,1,0,D
230951,7,CHL1,2007-09-23,Audax Italiano,CD Palestino,2,1,1,W
230952,7,CHL1,2007-09-23,Everton CD,Puerto Montt,1,0,1,W
230953,7,CHL1,2007-09-23,Coquimbo Unido,Lota Schwager,0,1,-1,L
230954,7,CHL1,2007-09-23,CD Huachipato,Universidad de Chile,2,3,-1,L
230955,7,CHL1,2007-09-25,CD Palestino,Higgins,1,0,1,W
230956,7,CHL1,2007-09-26,Santiago Wanderers,Universidad de Concepcion,0,3,-3,L
230957,7,CHL1,2007-09-26,Antofagasta,Universidad Catolica,0,0,0,D
230958,7,CHL1,2007-09-26,Deportivo Nublense,CD Cobreloa,3,2,1,W
230959,7,CHL1,2007-09-26,Lota Schwager,Union Espanola,1,1,0,D
230960,7,CHL1,2007-09-26,Puerto Montt,Coquimbo Unido,0,1,-1,L
230961,7,CHL1,2007-09-26,CD Cobresal,Everton CD,3,1,2,W
230962,7,CHL1,2007-09-26,Deportes Melipilla,Universidad de Chile,1,3,-2,L
230963,7,CHL1,2007-09-27,La Serena,CD Huachipato,4,1,3,W
230964,7,CHL1,2007-09-27,Deportes Concepcion,Audax Italiano,2,1,1,W
230965,7,CHL1,2007-09-29,Puerto Montt,Colo Colo,0,2,-2,L
230966,7,CHL1,2007-09-29,Higgins,Coquimbo Unido,2,1,1,W
230967,7,CHL1,2007-09-29,Union Espanola,Universidad de Concepcion,0,2,-2,L
230968,7,CHL1,2007-09-30,La Serena,CD Palestino,1,0,1,W
230969,7,CHL1,2007-09-30,Deportes Concepcion,Antofagasta,1,1,0,D
230970,7,CHL1,2007-09-30,Everton CD,Lota Schwager,4,2,2,W
230971,7,CHL1,2007-09-30,CD Huachipato,Universidad Catolica,0,0,0,D
230972,7,CHL1,2007-09-30,CD Cobreloa,Deportes Melipilla,5,1,4,W
230973,7,CHL1,2007-09-30,Universidad de Chile,Santiago Wanderers,2,0,2,W
230974,7,CHL1,2007-09-30,Audax Italiano,Deportivo Nublense,5,0,5,W
230975,7,CHL1,2007-10-03,CD Palestino,Union Espanola,1,2,-1,L
230976,7,CHL1,2007-10-03,Deportivo Nublense,Universidad de Chile,1,2,-1,L
230977,7,CHL1,2007-10-03,CD Cobresal,Deportes Concepcion,5,0,5,W
230978,7,CHL1,2007-10-03,Lota Schwager,Puerto Montt,0,0,0,D
230979,7,CHL1,2007-10-03,Colo Colo,Everton CD,2,2,0,D
230980,7,CHL1,2007-10-04,Coquimbo Unido,CD Cobreloa,2,1,1,W
230981,7,CHL1,2007-10-04,Universidad de Concepcion,Higgins,1,2,-1,L
230982,7,CHL1,2007-10-04,Universidad Catolica,Audax Italiano,1,2,-1,L
230983,7,CHL1,2007-10-05,Deportes Melipilla,La Serena,3,3,0,D
230984,7,CHL1,2007-10-06,Union Espanola,Deportes Concepcion,1,5,-4,L
230985,7,CHL1,2007-10-07,Universidad de Chile,CD Palestino,3,1,2,W
230986,7,CHL1,2007-10-07,Everton CD,Coquimbo Unido,3,1,2,W
230987,7,CHL1,2007-10-07,Puerto Montt,CD Cobresal,1,0,1,W
230988,7,CHL1,2007-10-07,Higgins,Colo Colo,2,1,1,W
230989,7,CHL1,2007-10-07,CD Huachipato,Lota Schwager,2,2,0,D
230990,7,CHL1,2007-10-07,Audax Italiano,Santiago Wanderers,7,1,6,W
230991,7,CHL1,2007-10-07,CD Cobreloa,Universidad Catolica,3,1,2,W
230992,7,CHL1,2007-10-07,Universidad de Concepcion,Deportes Melipilla,1,1,0,D
230993,7,CHL1,2007-10-07,La Serena,Antofagasta,0,2,-2,L
230994,7,CHL1,2007-10-15,Deportivo Nublense,Higgins,1,1,0,D
230995,7,CHL1,2007-10-20,CD Cobreloa,Audax Italiano,3,3,0,D
230996,7,CHL1,2007-10-20,Universidad Catolica,Universidad de Concepcion,1,1,0,D
230997,7,CHL1,2007-10-20,Deportes Melipilla,Everton CD,3,0,3,W
230998,7,CHL1,2007-10-21,Deportes Concepcion,Puerto Montt,0,0,0,D
230999,7,CHL1,2007-10-21,Coquimbo Unido,Union Espanola,1,3,-2,L
231000,7,CHL1,2007-10-21,Santiago Wanderers,La Serena,3,2,1,W
231001,7,CHL1,2007-10-21,Antofagasta,CD Palestino,0,1,-1,L
231002,7,CHL1,2007-10-21,Colo Colo,Universidad de Chile,2,2,0,D
231003,7,CHL1,2007-10-21,Lota Schwager,CD Cobresal,0,2,-2,L
231004,7,CHL1,2007-10-23,Puerto Montt,La Serena,2,0,2,W
231005,7,CHL1,2007-10-24,Union Espanola,Universidad Catolica,1,3,-2,L
231006,7,CHL1,2007-10-24,Higgins,Deportes Melipilla,3,0,3,W
231007,7,CHL1,2007-10-24,CD Palestino,Santiago Wanderers,6,0,6,W
231008,7,CHL1,2007-10-24,CD Cobresal,Deportivo Nublense,2,2,0,D
231009,7,CHL1,2007-10-24,Lota Schwager,Deportes Concepcion,2,1,1,W
231010,7,CHL1,2007-10-24,Coquimbo Unido,Universidad de Chile,0,1,-1,L
231011,7,CHL1,2007-10-25,Universidad de Concepcion,Audax Italiano,2,3,-1,L
231012,7,CHL1,2007-10-25,Everton CD,CD Huachipato,1,3,-2,L
231013,7,CHL1,2007-10-25,Colo Colo,CD Cobreloa,1,1,0,D
231014,7,CHL1,2007-10-27,Santiago Wanderers,Colo Colo,0,4,-4,L
231015,7,CHL1,2007-10-27,Deportes Concepcion,CD Palestino,0,2,-2,L
231016,7,CHL1,2007-10-27,Universidad Catolica,Puerto Montt,3,1,2,W
231017,7,CHL1,2007-10-28,La Serena,CD Cobresal,1,1,0,D
231018,7,CHL1,2007-10-28,Universidad de Chile,Lota Schwager,2,1,1,W
231019,7,CHL1,2007-10-28,CD Cobreloa,Everton CD,2,1,1,W
231020,7,CHL1,2007-10-28,Deportivo Nublense,Antofagasta,4,0,4,W
231021,7,CHL1,2007-10-28,Deportes Melipilla,Coquimbo Unido,4,0,4,W
231022,7,CHL1,2007-10-28,CD Huachipato,Universidad de Concepcion,2,0,2,W
231023,7,CHL1,2007-10-28,Audax Italiano,Higgins,2,0,2,W
231024,7,CHL1,2007-10-31,CD Cobresal,Antofagasta,1,1,0,D
231025,7,CHL1,2007-10-31,Lota Schwager,Santiago Wanderers,1,1,0,D
231026,7,CHL1,2007-10-31,CD Palestino,CD Cobreloa,1,1,0,D
231027,7,CHL1,2007-10-31,Puerto Montt,Deportes Melipilla,1,1,0,D
231028,7,CHL1,2007-10-31,Union Espanola,CD Huachipato,1,2,-1,L
231029,7,CHL1,2007-10-31,Universidad de Concepcion,La Serena,2,1,1,W
231030,7,CHL1,2007-10-31,Coquimbo Unido,Deportivo Nublense,0,1,-1,L
231031,7,CHL1,2007-11-01,Higgins,Universidad Catolica,1,2,-1,L
231032,7,CHL1,2007-11-01,Everton CD,Deportes Concepcion,1,3,-2,L
231033,7,CHL1,2007-11-01,Colo Colo,Audax Italiano,1,4,-3,L
231034,7,CHL1,2007-11-03,Universidad de Chile,Union Espanola,3,2,1,W
231035,7,CHL1,2007-11-04,CD Palestino,Everton CD,1,0,1,W
231036,7,CHL1,2007-11-04,CD Cobreloa,Universidad de Concepcion,0,0,0,D
231037,7,CHL1,2007-11-04,La Serena,Lota Schwager,0,2,-2,L
231038,7,CHL1,2007-11-04,CD Huachipato,Higgins,0,0,0,D
231039,7,CHL1,2007-11-04,Universidad Catolica,Colo Colo,0,1,-1,L
231040,7,CHL1,2007-11-04,Deportes Concepcion,Deportivo Nublense,3,1,2,W
231041,7,CHL1,2007-11-04,Santiago Wanderers,CD Cobresal,1,1,0,D
231042,7,CHL1,2007-11-04,Antofagasta,Puerto Montt,1,1,0,D
231043,7,CHL1,2007-11-04,Audax Italiano,Deportes Melipilla,1,1,0,D
231044,7,CHL1,2007-11-07,Universidad de Chile,Higgins,2,2,0,D
231045,7,CHL1,2007-11-10,Universidad de Concepcion,Antofagasta,1,0,1,W
231046,7,CHL1,2007-11-10,Coquimbo Unido,Deportes Concepcion,3,1,2,W
231047,7,CHL1,2007-11-11,Everton CD,Universidad de Chile,1,3,-2,L
231048,7,CHL1,2007-11-11,Deportivo Nublense,La Serena,3,4,-1,L
231049,7,CHL1,2007-11-11,Deportes Melipilla,Universidad Catolica,3,2,1,W
231050,7,CHL1,2007-11-11,CD Cobresal,CD Palestino,1,1,0,D
231051,7,CHL1,2007-11-11,Audax Italiano,Puerto Montt,1,1,0,D
231052,7,CHL1,2007-11-11,Union Espanola,Santiago Wanderers,1,1,0,D
231053,7,CHL1,2007-11-11,Lota Schwager,CD Cobreloa,3,1,2,W
231054,7,CHL1,2007-11-11,Colo Colo,CD Huachipato,4,0,4,W
231055,7,CHL1,2007-11-17,Antofagasta,CD Huachipato,3,1,2,W
231056,7,CHL1,2007-11-24,Universidad de Chile,CD Cobresal,3,0,3,W
231057,7,CHL1,2007-11-24,La Serena,Audax Italiano,0,1,-1,L
231058,7,CHL1,2007-11-24,Deportes Concepcion,Universidad de Concepcion,1,3,-2,L
231059,7,CHL1,2007-11-25,Puerto Montt,Higgins,3,0,3,W
231060,7,CHL1,2007-11-25,Santiago Wanderers,Deportivo Nublense,0,2,-2,L
231061,7,CHL1,2007-11-25,CD Huachipato,Deportes Melipilla,2,3,-1,L
231062,7,CHL1,2007-11-25,Antofagasta,Lota Schwager,2,1,1,W
231063,7,CHL1,2007-11-25,CD Palestino,Colo Colo,0,1,-1,L
231064,7,CHL1,2007-11-25,CD Cobreloa,Union Espanola,3,2,1,W
231065,7,CHL1,2007-11-25,Universidad Catolica,Coquimbo Unido,3,0,3,W
231066,8,CHL1,2008-01-25,CD Provincial Osorno,Colo Colo,0,3,-3,L
231067,8,CHL1,2008-01-26,CD Palestino,Antofagasta,1,1,0,D
231068,8,CHL1,2008-01-26,Audax Italiano,La Serena,0,0,0,D
231069,8,CHL1,2008-01-27,Deportes Melipilla,Union Espanola,1,2,-1,L
231070,8,CHL1,2008-01-27,Universidad de Concepcion,Higgins,0,0,0,D
231071,8,CHL1,2008-01-27,CSD Rangers,Deportivo Nublense,0,0,0,D
231072,8,CHL1,2008-01-27,CD Cobresal,Everton CD,4,0,4,W
231073,8,CHL1,2008-01-27,CD Cobreloa,CD Huachipato,0,0,0,D
231074,8,CHL1,2008-01-27,Universidad de Chile,Deportes Concepcion,2,1,1,W
231075,8,CHL1,2008-01-27,Universidad Catolica,Santiago Morning,8,2,6,W
231076,8,CHL1,2008-02-01,Union Espanola,Audax Italiano,1,0,1,W
231077,8,CHL1,2008-02-02,La Serena,CSD Rangers,1,0,1,W
231078,8,CHL1,2008-02-02,Everton CD,Universidad Catolica,0,2,-2,L
231079,8,CHL1,2008-02-02,Colo Colo,Deportes Melipilla,4,3,1,W
231080,8,CHL1,2008-02-02,Higgins,CD Palestino,0,2,-2,L
231081,8,CHL1,2008-02-02,Deportes Concepcion,Santiago Morning,2,1,1,W
231082,8,CHL1,2008-02-03,CD Cobresal,CD Cobreloa,1,0,1,W
231083,8,CHL1,2008-02-03,Antofagasta,Universidad de Concepcion,3,3,0,D
231084,8,CHL1,2008-02-03,Deportivo Nublense,Universidad de Chile,0,0,0,D
231085,8,CHL1,2008-02-03,CD Huachipato,CD Provincial Osorno,0,2,-2,L
231086,8,CHL1,2008-02-08,Universidad Catolica,Union Espanola,1,2,-1,L
231087,8,CHL1,2008-02-09,CSD Rangers,Antofagasta,1,0,1,W
231088,8,CHL1,2008-02-09,CD Palestino,Colo Colo,1,0,1,W
231089,8,CHL1,2008-02-09,Deportes Melipilla,La Serena,2,3,-1,L
231090,8,CHL1,2008-02-09,Universidad de Concepcion,Everton CD,1,3,-2,L
231091,8,CHL1,2008-02-10,Universidad de Chile,CD Cobresal,1,0,1,W
231092,8,CHL1,2008-02-10,CD Cobreloa,Higgins,1,2,-1,L
231093,8,CHL1,2008-02-10,Santiago Morning,CD Huachipato,2,2,0,D
231094,8,CHL1,2008-02-10,Deportivo Nublense,CD Provincial Osorno,2,0,2,W
231095,8,CHL1,2008-02-10,Audax Italiano,Deportes Concepcion,3,2,1,W
231096,8,CHL1,2008-02-13,La Serena,Universidad Catolica,1,1,0,D
231097,8,CHL1,2008-02-13,CD Cobresal,Higgins,0,0,0,D
231098,8,CHL1,2008-02-13,CD Huachipato,Antofagasta,3,1,2,W
231099,8,CHL1,2008-02-13,Santiago Morning,CD Palestino,1,1,0,D
231100,8,CHL1,2008-02-13,Union Espanola,CD Cobreloa,0,1,-1,L
231101,8,CHL1,2008-02-13,CD Provincial Osorno,CSD Rangers,2,1,1,W
231102,8,CHL1,2008-02-13,Colo Colo,Universidad de Concepcion,1,0,1,W
231103,8,CHL1,2008-02-13,Deportes Concepcion,Deportivo Nublense,0,0,0,D
231104,8,CHL1,2008-02-14,Everton CD,Universidad de Chile,3,1,2,W
231105,8,CHL1,2008-02-16,Audax Italiano,CD Cobresal,4,1,3,W
231106,8,CHL1,2008-02-16,Universidad de Concepcion,CD Huachipato,2,0,2,W
231107,8,CHL1,2008-02-16,Universidad Catolica,CD Provincial Osorno,2,0,2,W
231108,8,CHL1,2008-02-17,Universidad de Chile,Union Espanola,2,0,2,W
231109,8,CHL1,2008-02-17,CD Cobreloa,La Serena,2,2,0,D
231110,8,CHL1,2008-02-17,CSD Rangers,Colo Colo,2,2,0,D
231111,8,CHL1,2008-02-17,CD Palestino,Everton CD,1,2,-1,L
231112,8,CHL1,2008-02-17,Deportivo Nublense,Deportes Melipilla,2,0,2,W
231113,8,CHL1,2008-02-17,Antofagasta,Santiago Morning,1,2,-1,L
231114,8,CHL1,2008-02-17,Higgins,Deportes Concepcion,1,0,1,W
231115,8,CHL1,2008-02-23,CD Palestino,CSD Rangers,0,2,-2,L
231116,8,CHL1,2008-02-23,Deportes Concepcion,Universidad Catolica,2,1,1,W
231117,8,CHL1,2008-02-23,CD Provincial Osorno,Universidad de Concepcion,1,3,-2,L
231118,8,CHL1,2008-02-24,La Serena,Everton CD,1,0,1,W
231119,8,CHL1,2008-02-24,CD Cobresal,Union Espanola,3,0,3,W
231120,8,CHL1,2008-02-24,Deportes Melipilla,Universidad de Chile,0,3,-3,L
231121,8,CHL1,2008-02-24,CD Huachipato,Audax Italiano,1,4,-3,L
231122,8,CHL1,2008-02-24,Antofagasta,CD Cobreloa,1,1,0,D
231123,8,CHL1,2008-02-24,Santiago Morning,Higgins,2,3,-1,L
231124,8,CHL1,2008-02-24,Colo Colo,Deportivo Nublense,1,4,-3,L
231125,8,CHL1,2008-02-27,Deportes Melipilla,Audax Italiano,1,0,1,W
231126,8,CHL1,2008-02-29,Union Espanola,Santiago Morning,0,1,-1,L
231127,8,CHL1,2008-03-01,Higgins,Antofagasta,0,0,0,D
231128,8,CHL1,2008-03-01,CD Provincial Osorno,Deportes Melipilla,3,1,2,W
231129,8,CHL1,2008-03-01,Everton CD,Audax Italiano,2,1,1,W
231130,8,CHL1,2008-03-01,Universidad de Concepcion,CD Palestino,2,3,-1,L
231131,8,CHL1,2008-03-01,CSD Rangers,CD Huachipato,0,0,0,D
231132,8,CHL1,2008-03-02,La Serena,Deportes Concepcion,2,4,-2,L
231133,8,CHL1,2008-03-02,CD Cobreloa,Universidad de Chile,3,1,2,W
231134,8,CHL1,2008-03-02,Deportivo Nublense,CD Cobresal,2,1,1,W
231135,8,CHL1,2008-03-02,Colo Colo,Universidad Catolica,0,1,-1,L
231136,8,CHL1,2008-03-05,CD Huachipato,CD Cobresal,2,2,0,D
231137,8,CHL1,2008-03-05,Santiago Morning,Universidad de Concepcion,3,2,1,W
231138,8,CHL1,2008-03-05,CD Palestino,Deportivo Nublense,3,0,3,W
231139,8,CHL1,2008-03-05,Universidad de Chile,La Serena,3,1,2,W
231140,8,CHL1,2008-03-05,Antofagasta,CD Provincial Osorno,1,1,0,D
231141,8,CHL1,2008-03-05,Deportes Melipilla,Everton CD,0,1,-1,L
231142,8,CHL1,2008-03-05,Universidad Catolica,Higgins,2,0,2,W
231143,8,CHL1,2008-03-06,CSD Rangers,CD Cobreloa,2,2,0,D
231144,8,CHL1,2008-03-06,Deportes Concepcion,Union Espanola,1,1,0,D
231145,8,CHL1,2008-03-08,CD Huachipato,Universidad Catolica,3,1,2,W
231146,8,CHL1,2008-03-08,Higgins,Deportes Melipilla,1,1,0,D
231147,8,CHL1,2008-03-08,Everton CD,CSD Rangers,3,1,2,W
231148,8,CHL1,2008-03-08,Universidad de Chile,CD Palestino,1,0,1,W
231149,8,CHL1,2008-03-09,Union Espanola,Colo Colo,1,5,-4,L
231150,8,CHL1,2008-03-09,CD Cobresal,CD Provincial Osorno,2,0,2,W
231151,8,CHL1,2008-03-09,Deportes Concepcion,CD Cobreloa,2,0,2,W
231152,8,CHL1,2008-03-09,Antofagasta,La Serena,1,0,1,W
231153,8,CHL1,2008-03-09,Deportivo Nublense,Santiago Morning,3,1,2,W
231154,8,CHL1,2008-03-09,Audax Italiano,Universidad de Concepcion,3,1,2,W
231155,8,CHL1,2008-03-11,CSD Rangers,Santiago Morning,1,4,-3,L
231156,8,CHL1,2008-03-12,CD Cobreloa,Deportivo Nublense,1,0,1,W
231157,8,CHL1,2008-03-12,CD Palestino,CD Huachipato,1,2,-1,L
231158,8,CHL1,2008-03-12,Universidad de Concepcion,Universidad de Chile,1,1,0,D
231159,8,CHL1,2008-03-12,Union Espanola,Everton CD,2,3,-1,L
231160,8,CHL1,2008-03-12,CD Provincial Osorno,Audax Italiano,1,3,-2,L
231161,8,CHL1,2008-03-12,Deportes Melipilla,Deportes Concepcion,3,4,-1,L
231162,8,CHL1,2008-03-12,Colo Colo,Higgins,1,1,0,D
231163,8,CHL1,2008-03-13,La Serena,CD Cobresal,1,1,0,D
231164,8,CHL1,2008-03-15,Santiago Morning,Colo Colo,1,3,-2,L
231165,8,CHL1,2008-03-15,Everton CD,CD Huachipato,0,0,0,D
231166,8,CHL1,2008-03-15,Audax Italiano,Universidad Catolica,3,1,2,W
231167,8,CHL1,2008-03-16,La Serena,Union Espanola,2,3,-1,L
231168,8,CHL1,2008-03-16,CD Cobresal,Deportes Melipilla,4,2,2,W
231169,8,CHL1,2008-03-16,CD Cobreloa,CD Palestino,3,2,1,W
231170,8,CHL1,2008-03-16,Deportes Concepcion,Universidad de Concepcion,2,0,2,W
231171,8,CHL1,2008-03-16,Universidad de Chile,CD Provincial Osorno,4,1,3,W
231172,8,CHL1,2008-03-16,Higgins,CSD Rangers,2,1,1,W
231173,8,CHL1,2008-03-19,Universidad Catolica,Antofagasta,4,0,4,W
231174,8,CHL1,2008-03-22,Deportivo Nublense,Higgins,2,1,1,W
231175,8,CHL1,2008-03-22,Universidad Catolica,CD Cobresal,2,1,1,W
231176,8,CHL1,2008-03-22,Universidad de Concepcion,La Serena,2,1,1,W
231177,8,CHL1,2008-03-22,CSD Rangers,Audax Italiano,2,0,2,W
231178,8,CHL1,2008-03-23,CD Huachipato,Universidad de Chile,3,2,1,W
231179,8,CHL1,2008-03-23,Deportes Melipilla,CD Cobreloa,1,2,-1,L
231180,8,CHL1,2008-03-23,CD Provincial Osorno,Deportes Concepcion,1,3,-2,L
231181,8,CHL1,2008-03-23,Santiago Morning,Everton CD,1,4,-3,L
231182,8,CHL1,2008-03-23,CD Palestino,Union Espanola,2,3,-1,L
231183,8,CHL1,2008-03-23,Colo Colo,Antofagasta,2,1,1,W
231184,8,CHL1,2008-03-29,Universidad Catolica,Deportes Melipilla,2,0,2,W
231185,8,CHL1,2008-03-29,Higgins,CD Provincial Osorno,4,1,3,W
231186,8,CHL1,2008-03-30,La Serena,CD Huachipato,2,1,1,W
231187,8,CHL1,2008-03-30,CD Cobresal,CSD Rangers,2,0,2,W
231188,8,CHL1,2008-03-30,CD Cobreloa,Universidad de Concepcion,1,3,-2,L
231189,8,CHL1,2008-03-30,Audax Italiano,CD Palestino,2,1,1,W
231190,8,CHL1,2008-03-30,Everton CD,Deportivo Nublense,1,1,0,D
231191,8,CHL1,2008-03-30,Deportes Concepcion,Colo Colo,2,2,0,D
231192,8,CHL1,2008-03-31,Union Espanola,Antofagasta,1,0,1,W
231193,8,CHL1,2008-04-01,Universidad de Chile,Santiago Morning,1,2,-1,L
231194,8,CHL1,2008-04-05,CD Huachipato,Deportes Concepcion,3,2,1,W
231195,8,CHL1,2008-04-05,Universidad de Concepcion,Union Espanola,1,0,1,W
231196,8,CHL1,2008-04-06,Colo Colo,Everton CD,3,1,2,W
231197,8,CHL1,2008-04-06,Antofagasta,Universidad de Chile,2,1,1,W
231198,8,CHL1,2008-04-06,CD Provincial Osorno,CD Cobreloa,1,2,-1,L
231199,8,CHL1,2008-04-06,Deportivo Nublense,La Serena,1,0,1,W
231200,8,CHL1,2008-04-06,CSD Rangers,Deportes Melipilla,0,1,-1,L
231201,8,CHL1,2008-04-06,Santiago Morning,CD Cobresal,2,2,0,D
231202,8,CHL1,2008-04-06,CD Palestino,Universidad Catolica,1,1,0,D
231203,8,CHL1,2008-04-06,Higgins,Audax Italiano,3,0,3,W
231204,8,CHL1,2008-04-12,CD Cobresal,CD Palestino,2,4,-2,L
231205,8,CHL1,2008-04-12,Universidad de Chile,Colo Colo,1,0,1,W
231206,8,CHL1,2008-04-13,Everton CD,Higgins,1,3,-2,L
231207,8,CHL1,2008-04-13,Universidad Catolica,Universidad de Concepcion,2,0,2,W
231208,8,CHL1,2008-04-13,Union Espanola,Deportivo Nublense,0,0,0,D
231209,8,CHL1,2008-04-13,CD Cobreloa,Santiago Morning,3,4,-1,L
231210,8,CHL1,2008-04-13,Deportes Concepcion,CSD Rangers,2,4,-2,L
231211,8,CHL1,2008-04-13,Deportes Melipilla,CD Huachipato,2,4,-2,L
231212,8,CHL1,2008-04-13,Audax Italiano,Antofagasta,3,0,3,W
231213,8,CHL1,2008-04-13,La Serena,CD Provincial Osorno,2,1,1,W
231214,8,CHL1,2008-04-16,Antofagasta,Deportivo Nublense,0,1,-1,L
231215,8,CHL1,2008-04-17,Audax Italiano,Colo Colo,3,2,1,W
231216,8,CHL1,2008-04-19,CD Palestino,Deportes Melipilla,2,1,1,W
231217,8,CHL1,2008-04-19,Colo Colo,CD Cobreloa,0,0,0,D
231218,8,CHL1,2008-04-19,Higgins,La Serena,4,1,3,W
231219,8,CHL1,2008-04-20,CSD Rangers,Universidad Catolica,2,2,0,D
231220,8,CHL1,2008-04-20,CD Huachipato,Union Espanola,2,1,1,W
231221,8,CHL1,2008-04-20,Santiago Morning,CD Provincial Osorno,2,1,1,W
231222,8,CHL1,2008-04-20,Deportivo Nublense,Universidad de Concepcion,3,1,2,W
231223,8,CHL1,2008-04-20,Deportes Concepcion,Everton CD,3,2,1,W
231224,8,CHL1,2008-04-21,Universidad de Chile,Audax Italiano,2,0,2,W
231225,8,CHL1,2008-04-24,Antofagasta,CD Cobresal,0,1,-1,L
231226,8,CHL1,2008-04-26,CD Provincial Osorno,CD Palestino,1,0,1,W
231227,8,CHL1,2008-04-26,Union Espanola,Higgins,1,1,0,D
231228,8,CHL1,2008-04-26,CD Huachipato,Deportivo Nublense,1,2,-1,L
231229,8,CHL1,2008-04-26,Universidad de Concepcion,CSD Rangers,1,2,-1,L
231230,8,CHL1,2008-04-27,La Serena,Colo Colo,2,2,0,D
231231,8,CHL1,2008-04-27,Deportes Melipilla,Antofagasta,0,1,-1,L
231232,8,CHL1,2008-04-27,Universidad Catolica,Universidad de Chile,2,0,2,W
231233,8,CHL1,2008-04-27,Everton CD,CD Cobreloa,4,2,2,W
231234,8,CHL1,2008-04-27,Audax Italiano,Santiago Morning,2,0,2,W
231235,8,CHL1,2008-04-28,CD Cobresal,Deportes Concepcion,4,1,3,W
231236,8,CHL1,2008-04-30,Colo Colo,CD Huachipato,2,2,0,D
231237,8,CHL1,2008-04-30,Higgins,Universidad de Chile,3,1,2,W
231238,8,CHL1,2008-04-30,CD Palestino,La Serena,0,2,-2,L
231239,8,CHL1,2008-04-30,CD Cobreloa,Universidad Catolica,0,1,-1,L
231240,8,CHL1,2008-04-30,Deportivo Nublense,Audax Italiano,3,2,1,W
231241,8,CHL1,2008-05-01,Santiago Morning,Deportes Melipilla,1,0,1,W
231242,8,CHL1,2008-05-01,Universidad de Concepcion,CD Cobresal,3,1,2,W
231243,8,CHL1,2008-05-01,CD Provincial Osorno,Everton CD,2,1,1,W
231244,8,CHL1,2008-05-01,CSD Rangers,Union Espanola,1,0,1,W
231245,8,CHL1,2008-05-01,Antofagasta,Deportes Concepcion,2,1,1,W
231246,8,CHL1,2008-05-03,CD Cobresal,Colo Colo,3,2,1,W
231247,8,CHL1,2008-05-03,Union Espanola,CD Provincial Osorno,2,0,2,W
231248,8,CHL1,2008-05-04,Everton CD,Antofagasta,3,1,2,W
231249,8,CHL1,2008-05-04,La Serena,Santiago Morning,5,1,4,W
231250,8,CHL1,2008-05-04,CD Huachipato,Higgins,0,1,-1,L
231251,8,CHL1,2008-05-04,Universidad de Chile,CSD Rangers,1,1,0,D
231252,8,CHL1,2008-05-04,Deportes Concepcion,CD Palestino,1,3,-2,L
231253,8,CHL1,2008-05-04,Deportes Melipilla,Universidad de Concepcion,3,1,2,W
231254,8,CHL1,2008-05-04,Audax Italiano,CD Cobreloa,2,1,1,W
231255,8,CHL1,2008-05-04,Universidad Catolica,Deportivo Nublense,1,2,-1,L
231256,8,CHL1,2008-06-21,Union Espanola,Deportes Melipilla,1,0,1,W
231257,8,CHL1,2008-06-21,La Serena,Audax Italiano,1,1,0,D
231258,8,CHL1,2008-06-22,Santiago Morning,Universidad Catolica,1,0,1,W
231259,8,CHL1,2008-06-22,CD Huachipato,CD Cobreloa,1,2,-1,L
231260,8,CHL1,2008-06-22,Deportivo Nublense,CSD Rangers,2,2,0,D
231261,8,CHL1,2008-06-22,Higgins,Universidad de Concepcion,3,3,0,D
231262,8,CHL1,2008-06-22,Antofagasta,CD Palestino,0,3,-3,L
231263,8,CHL1,2008-06-27,Universidad de Concepcion,Antofagasta,3,1,2,W
231264,8,CHL1,2008-06-28,CD Palestino,Higgins,2,3,-1,L
231265,8,CHL1,2008-06-28,Universidad Catolica,Everton CD,0,1,-1,L
231266,8,CHL1,2008-06-29,Audax Italiano,Union Espanola,0,0,0,D
231267,8,CHL1,2008-06-29,CD Provincial Osorno,CD Huachipato,3,1,2,W
231268,8,CHL1,2008-06-29,CSD Rangers,La Serena,2,1,1,W
231269,8,CHL1,2008-06-29,Deportes Melipilla,Colo Colo,0,2,-2,L
231270,8,CHL1,2008-06-29,CD Cobreloa,CD Cobresal,1,1,0,D
231271,8,CHL1,2008-06-29,Universidad de Chile,Deportivo Nublense,2,1,1,W
231272,8,CHL1,2008-07-05,Union Espanola,Universidad Catolica,1,4,-3,L
231273,8,CHL1,2008-07-05,Higgins,CD Cobreloa,1,0,1,W
231274,8,CHL1,2008-07-05,Everton CD,Universidad de Concepcion,2,1,1,W
231275,8,CHL1,2008-07-06,La Serena,Deportes Melipilla,1,0,1,W
231276,8,CHL1,2008-07-06,CD Huachipato,Santiago Morning,1,1,0,D
231277,8,CHL1,2008-07-06,CD Provincial Osorno,Deportivo Nublense,4,1,3,W
231278,8,CHL1,2008-07-06,CD Cobresal,Universidad de Chile,1,2,-1,L
231279,8,CHL1,2008-07-06,Antofagasta,CSD Rangers,2,1,1,W
231280,8,CHL1,2008-07-06,Colo Colo,CD Palestino,0,0,0,D
231281,8,CHL1,2008-07-10,Everton CD,CD Cobresal,2,0,2,W
231282,8,CHL1,2008-07-12,CD Palestino,Santiago Morning,1,1,0,D
231283,8,CHL1,2008-07-12,CD Cobreloa,Union Espanola,1,1,0,D
231284,8,CHL1,2008-07-12,Higgins,CD Cobresal,3,0,3,W
231285,8,CHL1,2008-07-13,Universidad de Chile,Everton CD,1,2,-1,L
231286,8,CHL1,2008-07-13,CSD Rangers,CD Provincial Osorno,1,0,1,W
231287,8,CHL1,2008-07-13,Universidad de Concepcion,Colo Colo,1,2,-1,L
231288,8,CHL1,2008-07-13,Antofagasta,CD Huachipato,0,2,-2,L
231289,8,CHL1,2008-07-13,Audax Italiano,Deportes Melipilla,2,2,0,D
231290,8,CHL1,2008-07-13,Universidad Catolica,La Serena,1,1,0,D
231291,8,CHL1,2008-07-16,Colo Colo,CD Provincial Osorno,4,1,3,W
231292,8,CHL1,2008-07-19,CD Huachipato,Universidad de Concepcion,1,1,0,D
231293,8,CHL1,2008-07-19,Everton CD,CD Palestino,0,1,-1,L
231294,8,CHL1,2008-07-19,Union Espanola,Universidad de Chile,1,4,-3,L
231295,8,CHL1,2008-07-20,La Serena,CD Cobreloa,6,2,4,W
231296,8,CHL1,2008-07-20,Santiago Morning,Antofagasta,2,1,1,W
231297,8,CHL1,2008-07-20,Colo Colo,CSD Rangers,2,3,-1,L
231298,8,CHL1,2008-07-20,Deportes Melipilla,Deportivo Nublense,1,1,0,D
231299,8,CHL1,2008-07-20,CD Cobresal,Audax Italiano,1,2,-1,L
231300,8,CHL1,2008-07-20,CD Provincial Osorno,Universidad Catolica,2,4,-2,L
231301,8,CHL1,2008-07-26,Union Espanola,CD Cobresal,1,1,0,D
231302,8,CHL1,2008-07-26,Everton CD,La Serena,5,5,0,D
231303,8,CHL1,2008-07-26,Universidad de Concepcion,CD Provincial Osorno,4,1,3,W
231304,8,CHL1,2008-07-26,Higgins,Santiago Morning,4,1,3,W
231305,8,CHL1,2008-07-27,Universidad de Chile,Deportes Melipilla,4,1,3,W
231306,8,CHL1,2008-07-27,Deportivo Nublense,Colo Colo,1,2,-1,L
231307,8,CHL1,2008-07-27,CSD Rangers,CD Palestino,1,1,0,D
231308,8,CHL1,2008-07-27,CD Cobreloa,Antofagasta,1,2,-1,L
231309,8,CHL1,2008-07-27,Audax Italiano,CD Huachipato,0,3,-3,L
231310,8,CHL1,2008-08-02,CD Palestino,Universidad de Concepcion,3,1,2,W
231311,8,CHL1,2008-08-02,Audax Italiano,Everton CD,2,1,1,W
231312,8,CHL1,2008-08-03,CD Huachipato,CSD Rangers,1,2,-1,L
231313,8,CHL1,2008-08-03,Universidad de Chile,CD Cobreloa,3,1,2,W
231314,8,CHL1,2008-08-03,Deportes Melipilla,CD Provincial Osorno,3,1,2,W
231315,8,CHL1,2008-08-03,Santiago Morning,Union Espanola,1,2,-1,L
231316,8,CHL1,2008-08-03,Universidad Catolica,Colo Colo,1,0,1,W
231317,8,CHL1,2008-08-03,CD Cobresal,Deportivo Nublense,1,0,1,W
231318,8,CHL1,2008-08-03,Antofagasta,Higgins,2,1,1,W
231319,8,CHL1,2008-08-09,Universidad de Concepcion,Santiago Morning,2,2,0,D
231320,8,CHL1,2008-08-09,Colo Colo,Audax Italiano,1,1,0,D
231321,8,CHL1,2008-08-10,CD Provincial Osorno,Antofagasta,0,1,-1,L
231322,8,CHL1,2008-08-10,La Serena,Universidad de Chile,2,2,0,D
231323,8,CHL1,2008-08-10,Everton CD,Deportes Melipilla,2,1,1,W
231324,8,CHL1,2008-08-10,Deportivo Nublense,CD Palestino,2,1,1,W
231325,8,CHL1,2008-08-10,Higgins,Universidad Catolica,1,1,0,D
231326,8,CHL1,2008-08-10,CD Cobresal,CD Huachipato,2,2,0,D
231327,8,CHL1,2008-08-10,CD Cobreloa,CSD Rangers,3,0,3,W
231328,8,CHL1,2008-08-15,CD Palestino,Universidad de Chile,0,3,-3,L
231329,8,CHL1,2008-08-15,Universidad de Concepcion,Audax Italiano,1,1,0,D
231330,8,CHL1,2008-08-17,CD Provincial Osorno,CD Cobresal,0,3,-3,L
231331,8,CHL1,2008-08-17,CSD Rangers,Everton CD,2,0,2,W
231332,8,CHL1,2008-08-17,Santiago Morning,Deportivo Nublense,2,2,0,D
231333,8,CHL1,2008-08-17,La Serena,Antofagasta,2,0,2,W
231334,8,CHL1,2008-08-17,Universidad Catolica,CD Huachipato,0,4,-4,L
231335,8,CHL1,2008-08-21,Deportes Melipilla,Higgins,2,1,1,W
231336,8,CHL1,2008-08-23,CD Huachipato,CD Palestino,1,2,-1,L
231337,8,CHL1,2008-08-23,Audax Italiano,CD Provincial Osorno,1,2,-1,L
231338,8,CHL1,2008-08-24,Universidad de Chile,Universidad de Concepcion,1,1,0,D
231339,8,CHL1,2008-08-24,Everton CD,Union Espanola,2,0,2,W
231340,8,CHL1,2008-08-24,Higgins,Colo Colo,0,3,-3,L
231341,8,CHL1,2008-08-24,Deportivo Nublense,CD Cobreloa,1,1,0,D
231342,8,CHL1,2008-08-24,Santiago Morning,CSD Rangers,1,1,0,D
231343,8,CHL1,2008-08-24,CD Cobresal,La Serena,1,1,0,D
231344,8,CHL1,2008-08-24,Antofagasta,Universidad Catolica,2,3,-1,L
231345,8,CHL1,2008-08-28,Colo Colo,Union Espanola,2,1,1,W
231346,8,CHL1,2008-08-30,CD Palestino,CD Cobreloa,3,4,-1,L
231347,8,CHL1,2008-08-30,Colo Colo,Santiago Morning,2,1,1,W
231348,8,CHL1,2008-08-31,Union Espanola,La Serena,2,3,-1,L
231349,8,CHL1,2008-08-31,CD Provincial Osorno,Universidad de Chile,1,2,-1,L
231350,8,CHL1,2008-08-31,Deportivo Nublense,Antofagasta,2,0,2,W
231351,8,CHL1,2008-08-31,CD Huachipato,Everton CD,2,1,1,W
231352,8,CHL1,2008-08-31,CSD Rangers,Higgins,3,1,2,W
231353,8,CHL1,2008-08-31,Deportes Melipilla,CD Cobresal,1,2,-1,L
231354,8,CHL1,2008-08-31,Universidad Catolica,Audax Italiano,2,4,-2,L
231355,8,CHL1,2008-09-13,CD Cobresal,Universidad Catolica,3,1,2,W
231356,8,CHL1,2008-09-13,Audax Italiano,CSD Rangers,3,0,3,W
231357,8,CHL1,2008-09-13,Higgins,Deportivo Nublense,2,2,0,D
231358,8,CHL1,2008-09-14,La Serena,Universidad de Concepcion,2,1,1,W
231359,8,CHL1,2008-09-14,Everton CD,Santiago Morning,0,1,-1,L
231360,8,CHL1,2008-09-14,Union Espanola,CD Palestino,1,3,-2,L
231361,8,CHL1,2008-09-14,CD Cobreloa,Deportes Melipilla,2,0,2,W
231362,8,CHL1,2008-09-14,Antofagasta,Colo Colo,1,0,1,W
231363,8,CHL1,2008-09-14,Universidad de Chile,CD Huachipato,1,3,-2,L
231364,8,CHL1,2008-09-20,Universidad de Concepcion,CD Cobreloa,2,0,2,W
231365,8,CHL1,2008-09-20,CD Palestino,Audax Italiano,1,0,1,W
231366,8,CHL1,2008-09-20,CSD Rangers,CD Cobresal,2,1,1,W
231367,8,CHL1,2008-09-20,Antofagasta,Union Espanola,1,1,0,D
231368,8,CHL1,2008-09-20,CD Provincial Osorno,Higgins,1,1,0,D
231369,8,CHL1,2008-09-20,Santiago Morning,Universidad de Chile,0,3,-3,L
231370,8,CHL1,2008-09-21,Deportes Melipilla,Universidad Catolica,3,5,-2,L
231371,8,CHL1,2008-09-21,Deportivo Nublense,Everton CD,1,0,1,W
231372,8,CHL1,2008-09-21,CD Huachipato,La Serena,4,1,3,W
231373,8,CHL1,2008-09-27,Audax Italiano,Higgins,1,0,1,W
231374,8,CHL1,2008-09-27,Union Espanola,Universidad de Concepcion,3,1,2,W
231375,8,CHL1,2008-09-28,Deportes Melipilla,CSD Rangers,0,1,-1,L
231376,8,CHL1,2008-09-28,La Serena,Deportivo Nublense,3,3,0,D
231377,8,CHL1,2008-09-28,Universidad Catolica,CD Palestino,1,2,-1,L
231378,8,CHL1,2008-09-28,Everton CD,Colo Colo,3,1,2,W
231379,8,CHL1,2008-09-28,CD Cobresal,Santiago Morning,4,1,3,W
231380,8,CHL1,2008-09-28,CD Cobreloa,CD Provincial Osorno,4,0,4,W
231381,8,CHL1,2008-09-28,Universidad de Chile,Antofagasta,3,0,3,W
231382,8,CHL1,2008-10-04,CD Palestino,CD Cobresal,3,1,2,W
231383,8,CHL1,2008-10-04,CD Huachipato,Deportes Melipilla,2,1,1,W
231384,8,CHL1,2008-10-04,Higgins,Everton CD,4,3,1,W
231385,8,CHL1,2008-10-05,Santiago Morning,CD Cobreloa,3,1,2,W
231386,8,CHL1,2008-10-05,Deportivo Nublense,Union Espanola,0,3,-3,L
231387,8,CHL1,2008-10-05,Antofagasta,Audax Italiano,3,0,3,W
231388,8,CHL1,2008-10-05,Colo Colo,Universidad de Chile,2,0,2,W
231389,8,CHL1,2008-10-05,CD Provincial Osorno,La Serena,1,2,-1,L
231390,8,CHL1,2008-10-05,Universidad de Concepcion,Universidad Catolica,3,5,-2,L
231391,8,CHL1,2008-10-18,Universidad Catolica,CSD Rangers,2,0,2,W
231392,8,CHL1,2008-10-18,Universidad de Concepcion,Deportivo Nublense,1,1,0,D
231393,8,CHL1,2008-10-19,La Serena,Higgins,1,3,-2,L
231394,8,CHL1,2008-10-19,Deportes Melipilla,CD Palestino,0,2,-2,L
231395,8,CHL1,2008-10-19,CD Cobreloa,Colo Colo,4,3,1,W
231396,8,CHL1,2008-10-19,CD Cobresal,Antofagasta,0,0,0,D
231397,8,CHL1,2008-10-19,CD Provincial Osorno,Santiago Morning,0,1,-1,L
231398,8,CHL1,2008-10-19,Union Espanola,CD Huachipato,3,2,1,W
231399,8,CHL1,2008-10-19,Audax Italiano,Universidad de Chile,0,1,-1,L
231400,8,CHL1,2008-10-24,Higgins,Union Espanola,5,3,2,W
231401,8,CHL1,2008-10-25,Colo Colo,La Serena,3,0,3,W
231402,8,CHL1,2008-10-25,CD Cobreloa,Everton CD,2,0,2,W
231403,8,CHL1,2008-10-25,Santiago Morning,Audax Italiano,3,5,-2,L
231404,8,CHL1,2008-10-25,Antofagasta,Deportes Melipilla,4,2,2,W
231405,8,CHL1,2008-10-25,CSD Rangers,Universidad de Concepcion,2,3,-1,L
231406,8,CHL1,2008-10-25,CD Palestino,CD Provincial Osorno,1,0,1,W
231407,8,CHL1,2008-10-25,Deportivo Nublense,CD Huachipato,0,1,-1,L
231408,8,CHL1,2008-10-28,Universidad de Chile,Universidad Catolica,2,1,1,W
231409,8,CHL1,2008-10-31,Deportes Melipilla,Santiago Morning,1,5,-4,L
231410,8,CHL1,2008-11-01,Audax Italiano,Deportivo Nublense,1,1,0,D
231411,8,CHL1,2008-11-01,Universidad Catolica,CD Cobreloa,4,3,1,W
231412,8,CHL1,2008-11-01,Everton CD,CD Provincial Osorno,3,1,2,W
231413,8,CHL1,2008-11-01,La Serena,CD Palestino,3,0,3,W
231414,8,CHL1,2008-11-02,CD Cobresal,Universidad de Concepcion,1,3,-2,L
231415,8,CHL1,2008-11-02,Universidad de Chile,Higgins,5,3,2,W
231416,8,CHL1,2008-11-02,Union Espanola,CSD Rangers,2,1,1,W
231417,8,CHL1,2008-11-02,CD Huachipato,Colo Colo,0,2,-2,L
231418,8,CHL1,2008-11-08,Universidad de Concepcion,Deportes Melipilla,0,1,-1,L
231419,8,CHL1,2008-11-08,Colo Colo,CD Cobresal,1,1,0,D
231420,8,CHL1,2008-11-09,CD Provincial Osorno,Union Espanola,1,2,-1,L
231421,8,CHL1,2008-11-09,Deportivo Nublense,Universidad Catolica,0,2,-2,L
231422,8,CHL1,2008-11-09,CD Cobreloa,Audax Italiano,2,1,1,W
231423,8,CHL1,2008-11-09,Santiago Morning,La Serena,3,2,1,W
231424,8,CHL1,2008-11-09,Antofagasta,Everton CD,0,1,-1,L
231425,8,CHL1,2008-11-09,CSD Rangers,Universidad de Chile,1,0,1,W
231426,8,CHL1,2008-11-09,Higgins,CD Huachipato,3,2,1,W
231427,9,CHL1,2009-01-31,Curico Unido,Colo Colo,2,2,0,D
231428,9,CHL1,2009-01-31,CD Huachipato,Universidad de Concepcion,0,1,-1,L
231429,9,CHL1,2009-01-31,Deportivo Nublense,Audax Italiano,2,1,1,W
231430,9,CHL1,2009-01-31,Everton CD,Union Espanola,0,1,-1,L
231431,9,CHL1,2009-02-01,Municipal Iquique,Universidad Catolica,0,4,-4,L
231432,9,CHL1,2009-02-01,CD Cobresal,Higgins,1,1,0,D
231433,9,CHL1,2009-02-01,Santiago Morning,CD Cobreloa,2,0,2,W
231434,9,CHL1,2009-02-01,CSD Rangers,La Serena,1,1,0,D
231435,9,CHL1,2009-02-07,La Serena,Colo Colo,0,3,-3,L
231436,9,CHL1,2009-02-07,CD Palestino,Higgins,1,2,-1,L
231437,9,CHL1,2009-02-07,Universidad Catolica,CD Cobresal,1,1,0,D
231438,9,CHL1,2009-02-07,Universidad de Concepcion,Everton CD,0,0,0,D
231439,9,CHL1,2009-02-07,Audax Italiano,Santiago Morning,1,1,0,D
231440,9,CHL1,2009-02-08,Municipal Iquique,Curico Unido,1,0,1,W
231441,9,CHL1,2009-02-08,CD Cobreloa,Deportivo Nublense,3,0,3,W
231442,9,CHL1,2009-02-08,Union Espanola,CD Huachipato,4,0,4,W
231443,9,CHL1,2009-02-13,Everton CD,Municipal Iquique,1,0,1,W
231444,9,CHL1,2009-02-14,CD Palestino,Audax Italiano,0,2,-2,L
231445,9,CHL1,2009-02-14,Colo Colo,Universidad de Concepcion,2,0,2,W
231446,9,CHL1,2009-02-14,Deportivo Nublense,Santiago Morning,2,1,1,W
231447,9,CHL1,2009-02-15,La Serena,Universidad Catolica,1,2,-1,L
231448,9,CHL1,2009-02-15,CD Cobresal,Union Espanola,1,3,-2,L
231449,9,CHL1,2009-02-15,CD Huachipato,Curico Unido,0,0,0,D
231450,9,CHL1,2009-02-15,Higgins,CSD Rangers,1,0,1,W
231451,9,CHL1,2009-02-15,Universidad de Chile,CD Cobreloa,4,1,3,W
231452,9,CHL1,2009-02-18,CSD Rangers,Universidad de Chile,0,4,-4,L
231453,9,CHL1,2009-02-21,Santiago Morning,CD Huachipato,5,0,5,W
231454,9,CHL1,2009-02-21,Union Espanola,Universidad de Chile,0,1,-1,L
231455,9,CHL1,2009-02-21,Universidad de Concepcion,Higgins,2,0,2,W
231456,9,CHL1,2009-02-21,Everton CD,CSD Rangers,3,2,1,W
231457,9,CHL1,2009-02-22,CD Cobresal,CD Cobreloa,1,4,-3,L
231458,9,CHL1,2009-02-22,Municipal Iquique,CD Palestino,3,0,3,W
231459,9,CHL1,2009-02-22,Curico Unido,La Serena,1,1,0,D
231460,9,CHL1,2009-02-22,Universidad Catolica,Deportivo Nublense,1,0,1,W
231461,9,CHL1,2009-02-22,Audax Italiano,Colo Colo,2,1,1,W
231462,9,CHL1,2009-02-25,CD Cobreloa,CD Palestino,4,0,4,W
231463,9,CHL1,2009-02-25,Higgins,Universidad Catolica,3,1,2,W
231464,9,CHL1,2009-02-25,Union Espanola,Municipal Iquique,2,0,2,W
231465,9,CHL1,2009-02-26,CSD Rangers,CD Cobresal,1,2,-1,L
231466,9,CHL1,2009-02-26,Colo Colo,Santiago Morning,4,2,2,W
231467,9,CHL1,2009-02-26,La Serena,CD Huachipato,3,1,2,W
231468,9,CHL1,2009-02-26,Universidad de Concepcion,Audax Italiano,3,1,2,W
231469,9,CHL1,2009-02-28,CSD Rangers,Colo Colo,2,1,1,W
231470,9,CHL1,2009-02-28,Deportivo Nublense,CD Cobresal,1,1,0,D
231471,9,CHL1,2009-02-28,Universidad de Chile,Municipal Iquique,0,0,0,D
231472,9,CHL1,2009-03-01,CD Huachipato,Universidad Catolica,2,0,2,W
231473,9,CHL1,2009-03-01,CD Cobreloa,La Serena,1,1,0,D
231474,9,CHL1,2009-03-01,Santiago Morning,Universidad de Concepcion,5,4,1,W
231475,9,CHL1,2009-03-01,Higgins,Everton CD,0,1,-1,L
231476,9,CHL1,2009-03-01,CD Palestino,Curico Unido,0,4,-4,L
231477,9,CHL1,2009-03-01,Audax Italiano,Union Espanola,2,2,0,D
231478,9,CHL1,2009-03-07,Everton CD,Universidad de Chile,1,1,0,D
231479,9,CHL1,2009-03-07,Universidad de Concepcion,CSD Rangers,2,2,0,D
231480,9,CHL1,2009-03-07,Union Espanola,CD Palestino,2,1,1,W
231481,9,CHL1,2009-03-08,CD Cobresal,CD Huachipato,0,0,0,D
231482,9,CHL1,2009-03-08,Municipal Iquique,Santiago Morning,2,2,0,D
231483,9,CHL1,2009-03-08,Curico Unido,Audax Italiano,1,4,-3,L
231484,9,CHL1,2009-03-08,La Serena,Deportivo Nublense,3,0,3,W
231485,9,CHL1,2009-03-08,Universidad Catolica,CD Cobreloa,4,0,4,W
231486,9,CHL1,2009-03-13,CD Huachipato,Higgins,3,0,3,W
231487,9,CHL1,2009-03-14,CD Palestino,Universidad de Concepcion,4,2,2,W
231488,9,CHL1,2009-03-14,Audax Italiano,Universidad de Chile,1,2,-1,L
231489,9,CHL1,2009-03-14,Deportivo Nublense,Municipal Iquique,2,1,1,W
231490,9,CHL1,2009-03-15,Curico Unido,CSD Rangers,2,1,1,W
231491,9,CHL1,2009-03-15,CD Cobreloa,Union Espanola,2,1,1,W
231492,9,CHL1,2009-03-15,Santiago Morning,CD Cobresal,3,3,0,D
231493,9,CHL1,2009-03-15,Colo Colo,Universidad Catolica,0,1,-1,L
231494,9,CHL1,2009-03-19,Colo Colo,Higgins,1,1,0,D
231495,9,CHL1,2009-03-21,Union Espanola,Colo Colo,5,2,3,W
231496,9,CHL1,2009-03-21,Universidad de Concepcion,La Serena,0,0,0,D
231497,9,CHL1,2009-03-22,Universidad Catolica,Everton CD,1,1,0,D
231498,9,CHL1,2009-03-22,Municipal Iquique,Audax Italiano,3,3,0,D
231499,9,CHL1,2009-03-22,CSD Rangers,CD Huachipato,1,1,0,D
231500,9,CHL1,2009-03-22,Santiago Morning,CD Palestino,5,1,4,W
231501,9,CHL1,2009-03-22,CD Cobresal,Curico Unido,1,0,1,W
231502,9,CHL1,2009-03-22,Higgins,CD Cobreloa,1,1,0,D
231503,9,CHL1,2009-03-22,Universidad de Chile,Deportivo Nublense,3,0,3,W
231504,9,CHL1,2009-03-28,CD Huachipato,CD Cobreloa,3,2,1,W
231505,9,CHL1,2009-03-28,Santiago Morning,Curico Unido,0,1,-1,L
231506,9,CHL1,2009-03-28,CSD Rangers,Union Espanola,1,3,-2,L
231507,9,CHL1,2009-03-29,Deportivo Nublense,Everton CD,1,1,0,D
231508,9,CHL1,2009-03-29,La Serena,CD Palestino,0,3,-3,L
231509,9,CHL1,2009-03-29,Municipal Iquique,Universidad de Concepcion,1,1,0,D
231510,9,CHL1,2009-04-03,Universidad de Chile,CD Palestino,3,0,3,W
231511,9,CHL1,2009-04-04,Colo Colo,Municipal Iquique,1,2,-1,L
231512,9,CHL1,2009-04-05,Everton CD,Santiago Morning,1,3,-2,L
231513,9,CHL1,2009-04-05,La Serena,Union Espanola,0,3,-3,L
231514,9,CHL1,2009-04-05,Audax Italiano,CD Huachipato,2,0,2,W
231515,9,CHL1,2009-04-05,Deportivo Nublense,CSD Rangers,1,1,0,D
231516,9,CHL1,2009-04-05,Curico Unido,Universidad Catolica,3,2,1,W
231517,9,CHL1,2009-04-05,CD Palestino,CD Cobresal,2,0,2,W
231518,9,CHL1,2009-04-05,CD Cobreloa,Universidad de Concepcion,2,0,2,W
231519,9,CHL1,2009-04-05,Universidad de Chile,Higgins,2,2,0,D
231520,9,CHL1,2009-04-09,Higgins,Deportivo Nublense,1,0,1,W
231521,9,CHL1,2009-04-10,Universidad Catolica,Audax Italiano,0,2,-2,L
231522,9,CHL1,2009-04-10,Everton CD,CD Huachipato,5,1,4,W
231523,9,CHL1,2009-04-11,Union Espanola,Higgins,2,1,1,W
231524,9,CHL1,2009-04-11,Universidad de Concepcion,CD Cobresal,3,1,2,W
231525,9,CHL1,2009-04-11,Universidad de Chile,Santiago Morning,1,3,-2,L
231526,9,CHL1,2009-04-12,Deportivo Nublense,Colo Colo,2,0,2,W
231527,9,CHL1,2009-04-12,Curico Unido,CD Cobreloa,2,0,2,W
231528,9,CHL1,2009-04-12,Municipal Iquique,CSD Rangers,1,1,0,D
231529,9,CHL1,2009-04-12,Audax Italiano,La Serena,1,2,-1,L
231530,9,CHL1,2009-04-12,Universidad Catolica,CD Palestino,4,1,3,W
231531,9,CHL1,2009-04-18,CD Huachipato,Municipal Iquique,3,1,2,W
231532,9,CHL1,2009-04-18,CSD Rangers,Universidad Catolica,2,1,1,W
231533,9,CHL1,2009-04-19,Higgins,Audax Italiano,1,2,-1,L
231534,9,CHL1,2009-04-19,Santiago Morning,Union Espanola,1,3,-2,L
231535,9,CHL1,2009-04-19,Curico Unido,Universidad de Concepcion,0,1,-1,L
231536,9,CHL1,2009-04-19,CD Palestino,Deportivo Nublense,1,1,0,D
231537,9,CHL1,2009-04-19,Universidad de Chile,Colo Colo,1,3,-2,L
231538,9,CHL1,2009-04-19,CD Cobresal,La Serena,2,2,0,D
231539,9,CHL1,2009-04-19,CD Cobreloa,Everton CD,1,0,1,W
231540,9,CHL1,2009-04-22,Curico Unido,Universidad de Chile,1,3,-2,L
231541,9,CHL1,2009-04-23,La Serena,Everton CD,1,3,-2,L
231542,9,CHL1,2009-04-25,Universidad de Concepcion,Universidad de Chile,1,1,0,D
231543,9,CHL1,2009-04-26,Colo Colo,CD Huachipato,2,2,0,D
231544,9,CHL1,2009-04-26,Municipal Iquique,Higgins,3,1,2,W
231545,9,CHL1,2009-04-26,La Serena,Santiago Morning,1,4,-3,L
231546,9,CHL1,2009-04-26,Audax Italiano,CD Cobreloa,0,0,0,D
231547,9,CHL1,2009-04-26,CD Palestino,CSD Rangers,1,0,1,W
231548,9,CHL1,2009-04-26,Deportivo Nublense,Curico Unido,1,1,0,D
231549,9,CHL1,2009-04-26,Universidad Catolica,Union Espanola,1,1,0,D
231550,9,CHL1,2009-05-02,CD Cobreloa,Colo Colo,2,0,2,W
231551,9,CHL1,2009-05-02,CD Cobresal,Municipal Iquique,2,5,-3,L
231552,9,CHL1,2009-05-02,Universidad de Chile,La Serena,3,2,1,W
231553,9,CHL1,2009-05-02,CD Huachipato,Deportivo Nublense,3,1,2,W
231554,9,CHL1,2009-05-03,Everton CD,CD Palestino,1,1,0,D
231555,9,CHL1,2009-05-03,CSD Rangers,Audax Italiano,0,1,-1,L
231556,9,CHL1,2009-05-03,Santiago Morning,Universidad Catolica,0,1,-1,L
231557,9,CHL1,2009-05-03,Higgins,Curico Unido,5,3,2,W
231558,9,CHL1,2009-05-03,Union Espanola,Universidad de Concepcion,2,1,1,W
231559,9,CHL1,2009-05-07,Everton CD,CD Cobresal,1,1,0,D
231560,9,CHL1,2009-05-09,Santiago Morning,CSD Rangers,2,1,1,W
231561,9,CHL1,2009-05-09,Colo Colo,CD Cobresal,5,2,3,W
231562,9,CHL1,2009-05-09,CD Huachipato,CD Palestino,4,1,3,W
231563,9,CHL1,2009-05-10,La Serena,Higgins,1,2,-1,L
231564,9,CHL1,2009-05-10,Audax Italiano,Everton CD,0,1,-1,L
231565,9,CHL1,2009-05-10,Curico Unido,Union Espanola,1,3,-2,L
231566,9,CHL1,2009-05-10,Universidad Catolica,Universidad de Chile,0,1,-1,L
231567,9,CHL1,2009-05-10,CD Cobreloa,Municipal Iquique,0,2,-2,L
231568,9,CHL1,2009-05-10,Deportivo Nublense,Universidad de Concepcion,2,3,-1,L
231569,9,CHL1,2009-05-14,Colo Colo,Everton CD,1,1,0,D
231570,9,CHL1,2009-05-16,Universidad de Concepcion,Universidad Catolica,0,2,-2,L
231571,9,CHL1,2009-05-16,CD Palestino,Colo Colo,1,0,1,W
231572,9,CHL1,2009-05-16,CD Cobresal,Audax Italiano,1,0,1,W
231573,9,CHL1,2009-05-16,Higgins,Santiago Morning,3,2,1,W
231574,9,CHL1,2009-05-16,Union Espanola,Deportivo Nublense,1,2,-1,L
231575,9,CHL1,2009-05-17,Municipal Iquique,La Serena,2,0,2,W
231576,9,CHL1,2009-05-17,Universidad de Chile,CD Huachipato,1,3,-2,L
231577,9,CHL1,2009-05-17,CSD Rangers,CD Cobreloa,4,1,3,W
231578,9,CHL1,2009-05-17,Everton CD,Curico Unido,3,2,1,W
231579,9,CHL1,2009-05-21,CD Cobresal,Universidad de Chile,3,2,1,W
231580,9,CHL1,2009-07-11,Audax Italiano,Deportivo Nublense,2,1,1,W
231581,9,CHL1,2009-07-11,Universidad de Concepcion,CD Huachipato,2,4,-2,L
231582,9,CHL1,2009-07-11,Higgins,CD Cobresal,2,0,2,W
231583,9,CHL1,2009-07-12,La Serena,CSD Rangers,2,0,2,W
231584,9,CHL1,2009-07-12,Colo Colo,Curico Unido,1,1,0,D
231585,9,CHL1,2009-07-12,CD Cobreloa,Santiago Morning,3,0,3,W
231586,9,CHL1,2009-07-12,Universidad Catolica,Municipal Iquique,2,0,2,W
231587,9,CHL1,2009-07-18,Higgins,CD Palestino,0,1,-1,L
231588,9,CHL1,2009-07-18,Santiago Morning,Audax Italiano,0,1,-1,L
231589,9,CHL1,2009-07-18,Colo Colo,La Serena,2,1,1,W
231590,9,CHL1,2009-07-18,CD Huachipato,Union Espanola,1,2,-1,L
231591,9,CHL1,2009-07-19,Curico Unido,Municipal Iquique,1,1,0,D
231592,9,CHL1,2009-07-19,Deportivo Nublense,CD Cobreloa,1,2,-1,L
231593,9,CHL1,2009-07-19,CD Cobresal,Universidad Catolica,1,1,0,D
231594,9,CHL1,2009-07-19,Everton CD,Universidad de Concepcion,0,1,-1,L
231595,9,CHL1,2009-07-19,Universidad de Chile,CSD Rangers,3,5,-2,L
231596,9,CHL1,2009-07-23,CD Palestino,Universidad de Chile,0,0,0,D
231597,9,CHL1,2009-07-24,Union Espanola,Everton CD,0,1,-1,L
231598,9,CHL1,2009-07-25,Universidad de Concepcion,Colo Colo,1,3,-2,L
231599,9,CHL1,2009-07-26,Audax Italiano,CD Palestino,2,2,0,D
231600,9,CHL1,2009-07-26,Santiago Morning,Deportivo Nublense,3,1,2,W
231601,9,CHL1,2009-07-26,Curico Unido,CD Huachipato,1,0,1,W
231602,9,CHL1,2009-07-26,CSD Rangers,Higgins,2,0,2,W
231603,9,CHL1,2009-07-26,Municipal Iquique,Everton CD,1,2,-1,L
231604,9,CHL1,2009-07-26,CD Cobreloa,Universidad de Chile,0,3,-3,L
231605,9,CHL1,2009-07-26,Union Espanola,CD Cobresal,1,0,1,W
231606,9,CHL1,2009-07-28,Universidad Catolica,La Serena,2,0,2,W
231607,9,CHL1,2009-08-01,Higgins,Universidad de Concepcion,0,2,-2,L
231608,9,CHL1,2009-08-01,CD Palestino,Municipal Iquique,1,1,0,D
231609,9,CHL1,2009-08-01,Universidad de Chile,Union Espanola,2,1,1,W
231610,9,CHL1,2009-08-01,CD Huachipato,Santiago Morning,0,1,-1,L
231611,9,CHL1,2009-08-02,Colo Colo,Audax Italiano,0,1,-1,L
231612,9,CHL1,2009-08-02,CSD Rangers,Everton CD,0,2,-2,L
231613,9,CHL1,2009-08-02,CD Cobreloa,CD Cobresal,0,1,-1,L
231614,9,CHL1,2009-08-02,La Serena,Curico Unido,2,0,2,W
231615,9,CHL1,2009-08-02,Deportivo Nublense,Universidad Catolica,0,0,0,D
231616,9,CHL1,2009-08-08,Universidad de Chile,Curico Unido,1,1,0,D
231617,9,CHL1,2009-08-08,Santiago Morning,Colo Colo,2,1,1,W
231618,9,CHL1,2009-08-08,CD Palestino,CD Cobreloa,2,1,1,W
231619,9,CHL1,2009-08-08,Universidad Catolica,Higgins,0,0,0,D
231620,9,CHL1,2009-08-08,CD Huachipato,La Serena,2,0,2,W
231621,9,CHL1,2009-08-09,Municipal Iquique,Union Espanola,3,4,-1,L
231622,9,CHL1,2009-08-09,CD Cobresal,CSD Rangers,2,0,2,W
231623,9,CHL1,2009-08-09,Everton CD,Deportivo Nublense,1,0,1,W
231624,9,CHL1,2009-08-09,Audax Italiano,Universidad de Concepcion,2,1,1,W
231625,9,CHL1,2009-08-15,Universidad de Concepcion,Santiago Morning,2,1,1,W
231626,9,CHL1,2009-08-16,Municipal Iquique,Universidad de Chile,0,2,-2,L
231627,9,CHL1,2009-08-16,Colo Colo,CSD Rangers,3,0,3,W
231628,9,CHL1,2009-08-16,Curico Unido,CD Palestino,2,1,1,W
231629,9,CHL1,2009-08-16,CD Cobresal,Deportivo Nublense,0,0,0,D
231630,9,CHL1,2009-08-16,La Serena,CD Cobreloa,4,2,2,W
231631,9,CHL1,2009-08-16,Universidad Catolica,CD Huachipato,3,1,2,W
231632,9,CHL1,2009-08-22,Audax Italiano,Curico Unido,1,1,0,D
231633,9,CHL1,2009-08-22,Higgins,Colo Colo,2,2,0,D
231634,9,CHL1,2009-08-22,CD Palestino,Union Espanola,3,3,0,D
231635,9,CHL1,2009-08-22,CD Huachipato,CD Cobresal,2,1,1,W
231636,9,CHL1,2009-08-23,Deportivo Nublense,La Serena,1,0,1,W
231637,9,CHL1,2009-08-23,CD Cobreloa,Universidad Catolica,0,2,-2,L
231638,9,CHL1,2009-08-23,Santiago Morning,Municipal Iquique,3,2,1,W
231639,9,CHL1,2009-08-23,Universidad de Chile,Everton CD,1,1,0,D
231640,9,CHL1,2009-08-29,Everton CD,La Serena,0,1,-1,L
231641,9,CHL1,2009-08-29,Universidad Catolica,Colo Colo,2,1,1,W
231642,9,CHL1,2009-08-29,Universidad de Concepcion,CD Palestino,2,0,2,W
231643,9,CHL1,2009-08-29,Union Espanola,CD Cobreloa,2,0,2,W
231644,9,CHL1,2009-08-30,CSD Rangers,Curico Unido,0,0,0,D
231645,9,CHL1,2009-08-30,Universidad de Chile,Audax Italiano,3,2,1,W
231646,9,CHL1,2009-08-30,Higgins,CD Huachipato,2,1,1,W
231647,9,CHL1,2009-08-30,CD Cobresal,Santiago Morning,3,1,2,W
231648,9,CHL1,2009-08-30,Municipal Iquique,Deportivo Nublense,1,3,-2,L
231649,9,CHL1,2009-09-06,Everton CD,Higgins,1,1,0,D
231650,9,CHL1,2009-09-06,Union Espanola,Audax Italiano,2,4,-2,L
231651,9,CHL1,2009-09-06,CSD Rangers,Universidad de Concepcion,1,1,0,D
231652,9,CHL1,2009-09-12,CD Palestino,Santiago Morning,0,1,-1,L
231653,9,CHL1,2009-09-12,Deportivo Nublense,Universidad de Chile,0,2,-2,L
231654,9,CHL1,2009-09-12,CD Huachipato,CSD Rangers,0,3,-3,L
231655,9,CHL1,2009-09-13,La Serena,Universidad de Concepcion,0,1,-1,L
231656,9,CHL1,2009-09-13,Everton CD,Universidad Catolica,1,1,0,D
231657,9,CHL1,2009-09-13,Audax Italiano,Municipal Iquique,2,0,2,W
231658,9,CHL1,2009-09-13,Curico Unido,CD Cobresal,2,1,1,W
231659,9,CHL1,2009-09-13,CD Cobreloa,Higgins,5,1,4,W
231660,9,CHL1,2009-09-13,Colo Colo,Union Espanola,1,1,0,D
231661,9,CHL1,2009-09-17,Higgins,Universidad de Chile,1,1,0,D
231662,9,CHL1,2009-09-17,Union Espanola,La Serena,1,4,-3,L
231663,9,CHL1,2009-09-18,Universidad Catolica,Curico Unido,7,0,7,W
231664,9,CHL1,2009-09-19,CD Huachipato,Audax Italiano,2,2,0,D
231665,9,CHL1,2009-09-19,CSD Rangers,Deportivo Nublense,2,0,2,W
231666,9,CHL1,2009-09-19,Universidad de Concepcion,CD Cobreloa,1,0,1,W
231667,9,CHL1,2009-09-20,Municipal Iquique,Colo Colo,1,1,0,D
231668,9,CHL1,2009-09-20,Santiago Morning,Everton CD,2,1,1,W
231669,9,CHL1,2009-09-20,CD Cobresal,CD Palestino,0,1,-1,L
231670,9,CHL1,2009-09-23,Deportivo Nublense,Higgins,1,0,1,W
231671,9,CHL1,2009-09-23,CD Palestino,La Serena,1,0,1,W
231672,9,CHL1,2009-09-23,Universidad de Concepcion,Municipal Iquique,2,0,2,W
231673,9,CHL1,2009-09-23,CD Cobreloa,CD Huachipato,2,0,2,W
231674,9,CHL1,2009-09-24,Audax Italiano,Universidad Catolica,0,4,-4,L
231675,9,CHL1,2009-09-25,Everton CD,Colo Colo,3,2,1,W
231676,9,CHL1,2009-09-26,CD Palestino,Universidad Catolica,1,1,0,D
231677,9,CHL1,2009-09-26,Santiago Morning,Universidad de Chile,3,1,2,W
231678,9,CHL1,2009-09-27,Higgins,Union Espanola,2,0,2,W
231679,9,CHL1,2009-09-27,CD Cobreloa,Curico Unido,0,0,0,D
231680,9,CHL1,2009-09-27,CD Cobresal,Universidad de Concepcion,3,0,3,W
231681,9,CHL1,2009-09-27,CSD Rangers,Municipal Iquique,5,3,2,W
231682,9,CHL1,2009-09-27,CD Huachipato,Everton CD,1,2,-1,L
231683,9,CHL1,2009-09-27,Colo Colo,Deportivo Nublense,3,1,2,W
231684,9,CHL1,2009-09-27,La Serena,Audax Italiano,4,2,2,W
231685,9,CHL1,2009-10-03,Universidad Catolica,CSD Rangers,5,1,4,W
231686,9,CHL1,2009-10-03,Municipal Iquique,CD Huachipato,2,2,0,D
231687,9,CHL1,2009-10-03,Colo Colo,Universidad de Chile,1,0,1,W
231688,9,CHL1,2009-10-04,La Serena,CD Cobresal,3,2,1,W
231689,9,CHL1,2009-10-04,Audax Italiano,Higgins,1,1,0,D
231690,9,CHL1,2009-10-04,Universidad de Concepcion,Curico Unido,3,1,2,W
231691,9,CHL1,2009-10-04,Everton CD,CD Cobreloa,0,3,-3,L
231692,9,CHL1,2009-10-04,Deportivo Nublense,CD Palestino,1,0,1,W
231693,9,CHL1,2009-10-04,Union Espanola,Santiago Morning,0,1,-1,L
231694,9,CHL1,2009-10-10,Union Espanola,CSD Rangers,3,3,0,D
231695,9,CHL1,2009-10-11,Universidad de Chile,CD Cobresal,1,1,0,D
231696,9,CHL1,2009-10-12,Curico Unido,Santiago Morning,1,1,0,D
231697,9,CHL1,2009-10-17,Santiago Morning,La Serena,1,2,-1,L
231698,9,CHL1,2009-10-17,Union Espanola,Universidad Catolica,4,3,1,W
231699,9,CHL1,2009-10-18,Higgins,Municipal Iquique,2,2,0,D
231700,9,CHL1,2009-10-18,CD Cobreloa,Audax Italiano,0,1,-1,L
231701,9,CHL1,2009-10-18,CSD Rangers,CD Palestino,1,0,1,W
231702,9,CHL1,2009-10-18,CD Cobresal,Everton CD,2,0,2,W
231703,9,CHL1,2009-10-18,Curico Unido,Deportivo Nublense,3,0,3,W
231704,9,CHL1,2009-10-18,CD Huachipato,Colo Colo,0,2,-2,L
231705,9,CHL1,2009-10-18,Universidad de Chile,Universidad de Concepcion,1,1,0,D
231706,9,CHL1,2009-10-24,Audax Italiano,CSD Rangers,1,0,1,W
231707,9,CHL1,2009-10-24,CD Palestino,Everton CD,0,1,-1,L
231708,9,CHL1,2009-10-24,Universidad de Concepcion,Union Espanola,1,2,-1,L
231709,9,CHL1,2009-10-24,Colo Colo,CD Cobreloa,2,1,1,W
231710,9,CHL1,2009-10-25,Municipal Iquique,CD Cobresal,1,1,0,D
231711,9,CHL1,2009-10-25,La Serena,Universidad de Chile,3,0,3,W
231712,9,CHL1,2009-10-25,Curico Unido,Higgins,0,1,-1,L
231713,9,CHL1,2009-10-25,Deportivo Nublense,CD Huachipato,3,0,3,W
231714,9,CHL1,2009-10-25,Universidad Catolica,Santiago Morning,3,0,3,W
231715,9,CHL1,2009-10-30,Higgins,La Serena,1,3,-2,L
231716,9,CHL1,2009-10-31,CD Cobresal,Colo Colo,0,2,-2,L
231717,9,CHL1,2009-10-31,CD Palestino,CD Huachipato,1,3,-2,L
231718,9,CHL1,2009-10-31,Universidad de Chile,Universidad Catolica,2,3,-1,L
231719,9,CHL1,2009-11-01,Municipal Iquique,CD Cobreloa,2,1,1,W
231720,9,CHL1,2009-11-01,Universidad de Concepcion,Deportivo Nublense,1,1,0,D
231721,9,CHL1,2009-11-01,CSD Rangers,Santiago Morning,3,1,2,W
231722,9,CHL1,2009-11-01,Everton CD,Audax Italiano,1,2,-1,L
231723,9,CHL1,2009-11-01,Union Espanola,Curico Unido,3,0,3,W
231724,9,CHL1,2009-11-06,Santiago Morning,Higgins,1,1,0,D
231725,9,CHL1,2009-11-07,Colo Colo,CD Palestino,1,2,-1,L
231726,9,CHL1,2009-11-07,Universidad Catolica,Universidad de Concepcion,4,1,3,W
231727,9,CHL1,2009-11-08,CD Cobreloa,CSD Rangers,1,0,1,W
231728,9,CHL1,2009-11-08,Curico Unido,Everton CD,2,2,0,D
231729,9,CHL1,2009-11-08,Audax Italiano,CD Cobresal,0,0,0,D
231730,9,CHL1,2009-11-08,Deportivo Nublense,Union Espanola,1,1,0,D
231731,9,CHL1,2009-11-08,La Serena,Municipal Iquique,2,1,1,W
231732,9,CHL1,2009-11-08,CD Huachipato,Universidad de Chile,1,0,1,W
231733,10,CHL1,2010-01-23,Union San Felipe,Colo Colo,3,2,1,W
231734,10,CHL1,2010-01-24,Everton CD,Union Espanola,0,1,-1,L
231735,10,CHL1,2010-01-24,CD Cobreloa,Santiago Wanderers,2,1,1,W
231736,10,CHL1,2010-01-24,Santiago Morning,La Serena,2,3,-1,L
231737,10,CHL1,2010-01-24,CD Huachipato,San Luis,2,1,1,W
231738,10,CHL1,2010-01-24,CD Palestino,Universidad de Concepcion,1,1,0,D
231739,10,CHL1,2010-01-24,Universidad de Chile,CD Cobresal,5,1,4,W
231740,10,CHL1,2010-01-25,Audax Italiano,Deportivo Nublense,5,6,-1,L
231741,10,CHL1,2010-01-29,Universidad de Concepcion,Union San Felipe,0,1,-1,L
231742,10,CHL1,2010-01-29,Santiago Wanderers,CD Huachipato,0,0,0,D
231743,10,CHL1,2010-01-30,CD Cobresal,Santiago Morning,3,0,3,W
231744,10,CHL1,2010-01-30,Universidad Catolica,CD Palestino,2,1,1,W
231745,10,CHL1,2010-01-30,Deportivo Nublense,Everton CD,0,2,-2,L
231746,10,CHL1,2010-01-30,San Luis,Higgins,1,2,-1,L
231747,10,CHL1,2010-01-31,La Serena,Universidad de Chile,2,4,-2,L
231748,10,CHL1,2010-01-31,Union Espanola,Audax Italiano,2,2,0,D
231749,10,CHL1,2010-01-31,Colo Colo,CD Cobreloa,3,1,2,W
231750,10,CHL1,2010-02-02,Universidad Catolica,Santiago Morning,4,0,4,W
231751,10,CHL1,2010-02-03,La Serena,San Luis,1,3,-2,L
231752,10,CHL1,2010-02-03,Higgins,Universidad de Concepcion,1,2,-1,L
231753,10,CHL1,2010-02-03,CD Cobreloa,CD Cobresal,2,1,1,W
231754,10,CHL1,2010-02-03,CD Palestino,Union Espanola,0,0,0,D
231755,10,CHL1,2010-02-03,Union San Felipe,Audax Italiano,1,2,-1,L
231756,10,CHL1,2010-02-03,CD Huachipato,Deportivo Nublense,1,1,0,D
231757,10,CHL1,2010-02-04,Everton CD,Universidad de Chile,2,1,1,W
231758,10,CHL1,2010-02-04,Colo Colo,Santiago Wanderers,3,0,3,W
231759,10,CHL1,2010-02-05,San Luis,Universidad Catolica,1,1,0,D
231760,10,CHL1,2010-02-06,Universidad de Concepcion,Everton CD,2,1,1,W
231761,10,CHL1,2010-02-07,Universidad de Chile,CD Huachipato,3,0,3,W
231762,10,CHL1,2010-02-07,CD Cobresal,Higgins,1,2,-1,L
231763,10,CHL1,2010-02-07,Santiago Morning,Union San Felipe,1,0,1,W
231764,10,CHL1,2010-02-07,Union Espanola,Colo Colo,1,0,1,W
231765,10,CHL1,2010-02-07,Santiago Wanderers,La Serena,5,0,5,W
231766,10,CHL1,2010-02-07,Audax Italiano,CD Cobreloa,3,1,2,W
231767,10,CHL1,2010-02-07,Deportivo Nublense,CD Palestino,1,0,1,W
231768,10,CHL1,2010-02-12,Colo Colo,Deportivo Nublense,2,2,0,D
231769,10,CHL1,2010-02-13,Santiago Wanderers,Universidad de Chile,3,3,0,D
231770,10,CHL1,2010-02-13,Santiago Morning,CD Palestino,2,1,1,W
231771,10,CHL1,2010-02-14,La Serena,Union San Felipe,3,1,2,W
231772,10,CHL1,2010-02-14,CD Cobreloa,Universidad de Concepcion,1,1,0,D
231773,10,CHL1,2010-02-14,Higgins,Audax Italiano,5,1,4,W
231774,10,CHL1,2010-02-14,San Luis,Everton CD,0,2,-2,L
231775,10,CHL1,2010-02-14,CD Huachipato,Union Espanola,1,2,-1,L
231776,10,CHL1,2010-02-14,Universidad Catolica,CD Cobresal,0,2,-2,L
231777,10,CHL1,2010-02-17,Higgins,Universidad Catolica,1,0,1,W
231778,10,CHL1,2010-02-19,Everton CD,CD Huachipato,0,1,-1,L
231779,10,CHL1,2010-02-20,Union Espanola,Universidad Catolica,2,1,1,W
231780,10,CHL1,2010-02-20,Universidad de Concepcion,San Luis,1,1,0,D
231781,10,CHL1,2010-02-20,Audax Italiano,Colo Colo,2,3,-1,L
231782,10,CHL1,2010-02-21,CD Cobresal,Santiago Wanderers,1,0,1,W
231783,10,CHL1,2010-02-21,CD Palestino,CD Cobreloa,1,0,1,W
231784,10,CHL1,2010-02-21,Union San Felipe,Higgins,2,0,2,W
231785,10,CHL1,2010-02-21,Deportivo Nublense,La Serena,3,1,2,W
231786,10,CHL1,2010-02-21,Universidad de Chile,Santiago Morning,2,1,1,W
231787,10,CHL1,2010-03-13,San Luis,Deportivo Nublense,3,3,0,D
231788,10,CHL1,2010-03-14,CD Cobreloa,Union San Felipe,0,0,0,D
231789,10,CHL1,2010-03-14,Santiago Morning,Union Espanola,1,1,0,D
231790,10,CHL1,2010-03-14,Santiago Wanderers,CD Palestino,2,0,2,W
231791,10,CHL1,2010-03-15,La Serena,Audax Italiano,1,3,-2,L
231792,10,CHL1,2010-03-19,Colo Colo,La Serena,6,1,5,W
231793,10,CHL1,2010-03-20,Higgins,Santiago Wanderers,2,2,0,D
231794,10,CHL1,2010-03-20,CD Palestino,Universidad de Chile,0,1,-1,L
231795,10,CHL1,2010-03-20,Everton CD,Santiago Morning,1,1,0,D
231796,10,CHL1,2010-03-21,CD Cobresal,San Luis,4,2,2,W
231797,10,CHL1,2010-03-21,Audax Italiano,Universidad Catolica,1,3,-2,L
231798,10,CHL1,2010-03-26,Universidad de Chile,Union San Felipe,4,2,2,W
231799,10,CHL1,2010-03-27,CD Cobreloa,Higgins,1,1,0,D
231800,10,CHL1,2010-03-27,Santiago Wanderers,Universidad Catolica,2,4,-2,L
231801,10,CHL1,2010-03-27,Union Espanola,Deportivo Nublense,1,3,-2,L
231802,10,CHL1,2010-03-28,San Luis,Colo Colo,0,2,-2,L
231803,10,CHL1,2010-03-28,CD Cobresal,CD Palestino,2,1,1,W
231804,10,CHL1,2010-03-28,La Serena,Everton CD,2,1,1,W
231805,10,CHL1,2010-03-28,Santiago Morning,Universidad de Concepcion,2,0,2,W
231806,10,CHL1,2010-04-02,La Serena,CD Huachipato,0,3,-3,L
231807,10,CHL1,2010-04-03,Universidad Catolica,Colo Colo,0,0,0,D
231808,10,CHL1,2010-04-03,Universidad de Concepcion,CD Cobresal,1,1,0,D
231809,10,CHL1,2010-04-03,Audax Italiano,San Luis,2,2,0,D
231810,10,CHL1,2010-04-03,Universidad de Chile,Union Espanola,4,3,1,W
231811,10,CHL1,2010-04-04,Union San Felipe,Santiago Wanderers,1,1,0,D
231812,10,CHL1,2010-04-04,CD Palestino,Higgins,1,0,1,W
231813,10,CHL1,2010-04-04,Deportivo Nublense,Santiago Morning,1,1,0,D
231814,10,CHL1,2010-04-04,Everton CD,CD Cobreloa,2,1,1,W
231815,10,CHL1,2010-04-06,CD Huachipato,CD Cobresal,4,3,1,W
231816,10,CHL1,2010-04-10,Universidad Catolica,Deportivo Nublense,4,2,2,W
231817,10,CHL1,2010-04-10,Higgins,Santiago Morning,1,0,1,W
231818,10,CHL1,2010-04-10,Union Espanola,La Serena,1,1,0,D
231819,10,CHL1,2010-04-11,San Luis,Union San Felipe,0,1,-1,L
231820,10,CHL1,2010-04-11,Santiago Wanderers,Everton CD,2,0,2,W
231821,10,CHL1,2010-04-11,CD Cobresal,Audax Italiano,3,1,2,W
231822,10,CHL1,2010-04-11,Universidad de Concepcion,CD Huachipato,0,2,-2,L
231823,10,CHL1,2010-04-11,Colo Colo,CD Palestino,3,0,3,W
231824,10,CHL1,2010-04-14,Universidad de Concepcion,Union Espanola,3,3,0,D
231825,10,CHL1,2010-04-17,Santiago Morning,CD Cobreloa,0,0,0,D
231826,10,CHL1,2010-04-17,Audax Italiano,Santiago Wanderers,0,4,-4,L
231827,10,CHL1,2010-04-17,La Serena,Universidad Catolica,1,1,0,D
231828,10,CHL1,2010-04-18,Universidad de Chile,Universidad de Concepcion,4,2,2,W
231829,10,CHL1,2010-04-18,CD Huachipato,Colo Colo,1,2,-1,L
231830,10,CHL1,2010-04-18,Union San Felipe,CD Palestino,1,1,0,D
231831,10,CHL1,2010-04-18,Deportivo Nublense,Higgins,0,3,-3,L
231832,10,CHL1,2010-04-18,Everton CD,CD Cobresal,2,2,0,D
231833,10,CHL1,2010-04-18,Union Espanola,San Luis,2,1,1,W
231834,10,CHL1,2010-04-24,Universidad de Concepcion,Audax Italiano,1,3,-2,L
231835,10,CHL1,2010-04-24,San Luis,Santiago Morning,2,2,0,D
231836,10,CHL1,2010-04-24,Higgins,CD Huachipato,0,0,0,D
231837,10,CHL1,2010-04-25,Colo Colo,Universidad de Chile,1,0,1,W
231838,10,CHL1,2010-04-25,CD Palestino,Everton CD,2,2,0,D
231839,10,CHL1,2010-04-25,CD Cobreloa,La Serena,4,0,4,W
231840,10,CHL1,2010-04-25,Santiago Wanderers,Union Espanola,1,1,0,D
231841,10,CHL1,2010-04-25,CD Cobresal,Deportivo Nublense,0,0,0,D
231842,10,CHL1,2010-04-25,Universidad Catolica,Union San Felipe,2,1,1,W
231843,10,CHL1,2010-04-30,Union San Felipe,CD Cobresal,1,0,1,W
231844,10,CHL1,2010-04-30,CD Huachipato,Universidad Catolica,1,3,-2,L
231845,10,CHL1,2010-05-01,Santiago Morning,Colo Colo,0,2,-2,L
231846,10,CHL1,2010-05-02,Union Espanola,CD Cobreloa,3,1,2,W
231847,10,CHL1,2010-05-02,Deportivo Nublense,Santiago Wanderers,2,2,0,D
231848,10,CHL1,2010-05-02,Audax Italiano,CD Palestino,1,3,-2,L
231849,10,CHL1,2010-05-02,Everton CD,Higgins,1,0,1,W
231850,10,CHL1,2010-05-02,Universidad de Chile,San Luis,4,0,4,W
231851,10,CHL1,2010-05-02,La Serena,Universidad de Concepcion,0,0,0,D
231852,10,CHL1,2010-05-05,Deportivo Nublense,CD Cobreloa,1,1,0,D
231853,10,CHL1,2010-05-08,Santiago Morning,Audax Italiano,0,1,-1,L
231854,10,CHL1,2010-05-08,CD Cobresal,Colo Colo,2,5,-3,L
231855,10,CHL1,2010-05-08,Higgins,Union Espanola,0,0,0,D
231856,10,CHL1,2010-05-09,CD Palestino,La Serena,3,0,3,W
231857,10,CHL1,2010-05-09,Universidad de Chile,Universidad Catolica,1,2,-1,L
231858,10,CHL1,2010-05-09,Union San Felipe,Everton CD,1,3,-2,L
231859,10,CHL1,2010-05-09,Universidad de Concepcion,Deportivo Nublense,4,1,3,W
231860,10,CHL1,2010-05-09,Santiago Wanderers,San Luis,0,2,-2,L
231861,10,CHL1,2010-05-09,CD Cobreloa,CD Huachipato,1,1,0,D
231862,10,CHL1,2010-05-13,Union San Felipe,CD Huachipato,1,1,0,D
231863,10,CHL1,2010-07-10,CD Huachipato,Audax Italiano,1,2,-1,L
231864,10,CHL1,2010-07-10,CD Cobreloa,Universidad de Chile,0,2,-2,L
231865,10,CHL1,2010-07-14,Higgins,Universidad de Chile,3,3,0,D
231866,10,CHL1,2010-07-15,Colo Colo,Everton CD,2,0,2,W
231867,10,CHL1,2010-07-17,Union Espanola,Union San Felipe,1,2,-1,L
231868,10,CHL1,2010-07-17,Deportivo Nublense,Universidad de Chile,0,2,-2,L
231869,10,CHL1,2010-07-17,Audax Italiano,Everton CD,2,0,2,W
231870,10,CHL1,2010-07-18,La Serena,CD Cobresal,3,0,3,W
231871,10,CHL1,2010-07-18,San Luis,CD Palestino,0,0,0,D
231872,10,CHL1,2010-07-18,Colo Colo,Higgins,2,0,2,W
231873,10,CHL1,2010-07-18,Santiago Wanderers,Universidad de Concepcion,1,0,1,W
231874,10,CHL1,2010-07-18,CD Huachipato,Santiago Morning,1,0,1,W
231875,10,CHL1,2010-07-18,Universidad Catolica,CD Cobreloa,2,1,1,W
231876,10,CHL1,2010-07-22,Universidad Catolica,Universidad de Concepcion,1,0,1,W
231877,10,CHL1,2010-07-22,Universidad de Chile,Audax Italiano,2,2,0,D
231878,10,CHL1,2010-07-24,Everton CD,Universidad Catolica,1,1,0,D
231879,10,CHL1,2010-07-24,Higgins,La Serena,4,0,4,W
231880,10,CHL1,2010-07-25,CD Palestino,CD Huachipato,2,1,1,W
231881,10,CHL1,2010-07-25,Universidad de Concepcion,Colo Colo,2,0,2,W
231882,10,CHL1,2010-07-25,Santiago Morning,Santiago Wanderers,2,1,1,W
231883,10,CHL1,2010-07-25,Union San Felipe,Deportivo Nublense,3,1,2,W
231884,10,CHL1,2010-07-25,CD Cobreloa,San Luis,5,0,5,W
231885,10,CHL1,2010-07-25,CD Cobresal,Union Espanola,1,0,1,W
231886,10,CHL1,2010-07-31,San Luis,CD Huachipato,1,4,-3,L
231887,10,CHL1,2010-07-31,Universidad Catolica,Higgins,4,1,3,W
231888,10,CHL1,2010-07-31,Universidad de Concepcion,CD Palestino,1,0,1,W
231889,10,CHL1,2010-08-01,Deportivo Nublense,Audax Italiano,1,5,-4,L
231890,10,CHL1,2010-08-01,Santiago Wanderers,CD Cobreloa,2,1,1,W
231891,10,CHL1,2010-08-01,La Serena,Santiago Morning,2,0,2,W
231892,10,CHL1,2010-08-01,Colo Colo,Union San Felipe,5,2,3,W
231893,10,CHL1,2010-08-07,Audax Italiano,Union Espanola,5,2,3,W
231894,10,CHL1,2010-08-07,CD Cobreloa,Colo Colo,2,1,1,W
231895,10,CHL1,2010-08-07,Higgins,San Luis,0,0,0,D
231896,10,CHL1,2010-08-07,Universidad de Chile,La Serena,1,2,-1,L
231897,10,CHL1,2010-08-08,Santiago Morning,CD Cobresal,1,1,0,D
231898,10,CHL1,2010-08-08,CD Palestino,Universidad Catolica,0,1,-1,L
231899,10,CHL1,2010-08-08,CD Huachipato,Santiago Wanderers,3,2,1,W
231900,10,CHL1,2010-08-08,Union San Felipe,Universidad de Concepcion,0,0,0,D
231901,10,CHL1,2010-08-14,Audax Italiano,Union San Felipe,1,0,1,W
231902,10,CHL1,2010-08-14,Santiago Wanderers,Colo Colo,0,1,-1,L
231903,10,CHL1,2010-08-14,Universidad de Concepcion,Higgins,2,1,1,W
231904,10,CHL1,2010-08-14,Union Espanola,CD Palestino,3,2,1,W
231905,10,CHL1,2010-08-15,Santiago Morning,Universidad Catolica,0,2,-2,L
231906,10,CHL1,2010-08-15,San Luis,La Serena,0,1,-1,L
231907,10,CHL1,2010-08-15,Deportivo Nublense,CD Huachipato,1,1,0,D
231908,10,CHL1,2010-08-15,CD Cobresal,CD Cobreloa,0,1,-1,L
231909,10,CHL1,2010-08-15,Universidad de Chile,Everton CD,5,1,4,W
231910,10,CHL1,2010-08-21,Higgins,CD Cobresal,0,1,-1,L
231911,10,CHL1,2010-08-21,CD Huachipato,Universidad de Chile,1,2,-1,L
231912,10,CHL1,2010-08-21,Universidad Catolica,San Luis,4,1,3,W
231913,10,CHL1,2010-08-22,Union San Felipe,Santiago Morning,1,0,1,W
231914,10,CHL1,2010-08-22,CD Palestino,Deportivo Nublense,2,0,2,W
231915,10,CHL1,2010-08-22,Everton CD,Universidad de Concepcion,1,1,0,D
231916,10,CHL1,2010-08-22,La Serena,Santiago Wanderers,4,0,4,W
231917,10,CHL1,2010-08-22,CD Cobreloa,Audax Italiano,1,1,0,D
231918,10,CHL1,2010-08-22,Colo Colo,Union Espanola,1,0,1,W
231919,10,CHL1,2010-08-28,Universidad de Chile,Santiago Wanderers,1,0,1,W
231920,10,CHL1,2010-08-28,Union San Felipe,La Serena,1,0,1,W
231921,10,CHL1,2010-08-28,CD Palestino,Santiago Morning,2,1,1,W
231922,10,CHL1,2010-08-28,Everton CD,San Luis,1,1,0,D
231923,10,CHL1,2010-08-28,CD Cobresal,Universidad Catolica,3,1,2,W
231924,10,CHL1,2010-08-28,Universidad de Concepcion,CD Cobreloa,3,0,3,W
231925,10,CHL1,2010-08-28,Union Espanola,CD Huachipato,5,0,5,W
231926,10,CHL1,2010-08-29,Deportivo Nublense,Colo Colo,0,0,0,D
231927,10,CHL1,2010-08-29,Audax Italiano,Higgins,2,1,1,W
231928,10,CHL1,2010-09-05,CD Cobresal,Universidad de Chile,1,2,-1,L
231929,10,CHL1,2010-09-05,Union Espanola,Everton CD,3,2,1,W
231930,10,CHL1,2010-09-09,Everton CD,Deportivo Nublense,2,3,-1,L
231931,10,CHL1,2010-09-11,Universidad Catolica,Union Espanola,2,0,2,W
231932,10,CHL1,2010-09-12,La Serena,Deportivo Nublense,1,0,1,W
231933,10,CHL1,2010-09-12,CD Huachipato,Everton CD,1,1,0,D
231934,10,CHL1,2010-09-12,CD Cobreloa,CD Palestino,0,0,0,D
231935,10,CHL1,2010-09-12,Higgins,Union San Felipe,1,2,-1,L
231936,10,CHL1,2010-09-12,Santiago Wanderers,CD Cobresal,0,4,-4,L
231937,10,CHL1,2010-09-12,Colo Colo,Audax Italiano,1,3,-2,L
231938,10,CHL1,2010-09-14,Santiago Morning,Universidad de Chile,1,2,-1,L
231939,10,CHL1,2010-09-16,San Luis,Universidad de Concepcion,1,0,1,W
231940,10,CHL1,2010-09-17,Union San Felipe,CD Cobreloa,1,0,1,W
231941,10,CHL1,2010-09-17,CD Palestino,Santiago Wanderers,0,1,-1,L
231942,10,CHL1,2010-09-17,CD Cobresal,CD Huachipato,2,1,1,W
231943,10,CHL1,2010-09-17,Union Espanola,Santiago Morning,2,2,0,D
231944,10,CHL1,2010-09-17,Audax Italiano,La Serena,2,1,1,W
231945,10,CHL1,2010-09-19,Deportivo Nublense,San Luis,4,0,4,W
231946,10,CHL1,2010-09-19,Universidad de Concepcion,Universidad Catolica,2,2,0,D
231947,10,CHL1,2010-09-23,Universidad de Chile,Higgins,0,1,-1,L
231948,10,CHL1,2010-09-25,San Luis,CD Cobresal,1,1,0,D
231949,10,CHL1,2010-09-25,Santiago Morning,Everton CD,3,0,3,W
231950,10,CHL1,2010-09-25,Union Espanola,Universidad de Concepcion,3,0,3,W
231951,10,CHL1,2010-09-25,Universidad Catolica,Audax Italiano,2,3,-1,L
231952,10,CHL1,2010-09-26,La Serena,Colo Colo,1,2,-1,L
231953,10,CHL1,2010-09-26,Santiago Wanderers,Higgins,1,1,0,D
231954,10,CHL1,2010-09-26,CD Cobreloa,Deportivo Nublense,3,2,1,W
231955,10,CHL1,2010-09-26,CD Huachipato,Union San Felipe,1,1,0,D
231956,10,CHL1,2010-09-26,Universidad de Chile,CD Palestino,1,2,-1,L
231957,10,CHL1,2010-09-29,Everton CD,Colo Colo,0,2,-2,L
231958,10,CHL1,2010-10-02,Audax Italiano,CD Huachipato,1,1,0,D
231959,10,CHL1,2010-10-02,Union San Felipe,Universidad de Chile,1,2,-1,L
231960,10,CHL1,2010-10-02,Universidad Catolica,Santiago Wanderers,3,1,2,W
231961,10,CHL1,2010-10-03,Universidad de Concepcion,Santiago Morning,0,0,0,D
231962,10,CHL1,2010-10-03,Colo Colo,San Luis,3,1,2,W
231963,10,CHL1,2010-10-03,CD Palestino,CD Cobresal,1,0,1,W
231964,10,CHL1,2010-10-03,Higgins,CD Cobreloa,2,2,0,D
231965,10,CHL1,2010-10-03,Deportivo Nublense,Union Espanola,1,1,0,D
231966,10,CHL1,2010-10-03,Everton CD,La Serena,3,3,0,D
231967,10,CHL1,2010-10-16,CD Huachipato,La Serena,0,0,0,D
231968,10,CHL1,2010-10-16,Santiago Wanderers,Union San Felipe,2,1,1,W
231969,10,CHL1,2010-10-16,Union Espanola,Universidad de Chile,2,1,1,W
231970,10,CHL1,2010-10-16,San Luis,Audax Italiano,1,2,-1,L
231971,10,CHL1,2010-10-17,CD Cobresal,Universidad de Concepcion,3,1,2,W
231972,10,CHL1,2010-10-17,Higgins,CD Palestino,4,1,3,W
231973,10,CHL1,2010-10-17,Santiago Morning,Deportivo Nublense,4,1,3,W
231974,10,CHL1,2010-10-17,CD Cobreloa,Everton CD,4,0,4,W
231975,10,CHL1,2010-10-17,Colo Colo,Universidad Catolica,3,2,1,W
231976,10,CHL1,2010-10-22,Audax Italiano,CD Cobresal,4,2,2,W
231977,10,CHL1,2010-10-22,CD Palestino,Colo Colo,1,2,-1,L
231978,10,CHL1,2010-10-23,Everton CD,Santiago Wanderers,0,2,-2,L
231979,10,CHL1,2010-10-23,CD Huachipato,Universidad de Concepcion,3,0,3,W
231980,10,CHL1,2010-10-24,Deportivo Nublense,Universidad Catolica,1,4,-3,L
231981,10,CHL1,2010-10-24,Santiago Morning,Higgins,2,1,1,W
231982,10,CHL1,2010-10-24,La Serena,Union Espanola,3,1,2,W
231983,10,CHL1,2010-10-24,Union San Felipe,San Luis,3,0,3,W
231984,10,CHL1,2010-10-26,Universidad de Chile,CD Cobreloa,3,1,2,W
231985,10,CHL1,2010-10-30,San Luis,Union Espanola,3,1,2,W
231986,10,CHL1,2010-10-30,Higgins,Deportivo Nublense,2,2,0,D
231987,10,CHL1,2010-10-30,Universidad Catolica,La Serena,2,1,1,W
231988,10,CHL1,2010-10-31,CD Cobreloa,Santiago Morning,2,1,1,W
231989,10,CHL1,2010-10-31,Universidad de Concepcion,Universidad de Chile,2,0,2,W
231990,10,CHL1,2010-10-31,CD Cobresal,Everton CD,1,2,-1,L
231991,10,CHL1,2010-10-31,Santiago Wanderers,Audax Italiano,1,0,1,W
231992,10,CHL1,2010-10-31,CD Palestino,Union San Felipe,1,0,1,W
231993,10,CHL1,2010-10-31,Colo Colo,CD Huachipato,0,0,0,D
231994,10,CHL1,2010-11-05,Audax Italiano,Universidad de Concepcion,4,1,3,W
231995,10,CHL1,2010-11-06,Union San Felipe,Universidad Catolica,1,3,-2,L
231996,10,CHL1,2010-11-06,La Serena,CD Cobreloa,1,0,1,W
231997,10,CHL1,2010-11-06,Everton CD,CD Palestino,1,1,0,D
231998,10,CHL1,2010-11-06,Union Espanola,Santiago Wanderers,3,0,3,W
231999,10,CHL1,2010-11-07,Universidad de Chile,Colo Colo,2,2,0,D
232000,10,CHL1,2010-11-07,Santiago Morning,San Luis,2,0,2,W
232001,10,CHL1,2010-11-07,CD Huachipato,Higgins,2,1,1,W
232002,10,CHL1,2010-11-07,Deportivo Nublense,CD Cobresal,3,1,2,W
232003,10,CHL1,2010-11-12,Universidad Catolica,CD Huachipato,2,0,2,W
232004,10,CHL1,2010-11-13,San Luis,Universidad de Chile,0,3,-3,L
232005,10,CHL1,2010-11-13,Colo Colo,Santiago Morning,0,1,-1,L
232006,10,CHL1,2010-11-13,Universidad de Concepcion,La Serena,1,0,1,W
232007,10,CHL1,2010-11-14,CD Cobresal,Union San Felipe,0,0,0,D
232008,10,CHL1,2010-11-14,CD Cobreloa,Union Espanola,3,1,2,W
232009,10,CHL1,2010-11-14,Santiago Wanderers,Deportivo Nublense,2,2,0,D
232010,10,CHL1,2010-11-14,CD Palestino,Audax Italiano,2,5,-3,L
232011,10,CHL1,2010-11-14,Higgins,Everton CD,0,0,0,D
232012,10,CHL1,2010-11-19,San Luis,Santiago Wanderers,3,4,-1,L
232013,10,CHL1,2010-11-20,Everton CD,Union San Felipe,3,0,3,W
232014,10,CHL1,2010-11-21,Colo Colo,CD Cobresal,1,0,1,W
232015,10,CHL1,2010-11-21,Universidad Catolica,Universidad de Chile,4,2,2,W
232016,10,CHL1,2010-11-21,La Serena,CD Palestino,0,0,0,D
232017,10,CHL1,2010-11-21,Deportivo Nublense,Universidad de Concepcion,2,2,0,D
232018,10,CHL1,2010-11-21,Audax Italiano,Santiago Morning,1,0,1,W
232019,10,CHL1,2010-11-21,Union Espanola,Higgins,1,1,0,D
232020,10,CHL1,2010-11-21,CD Huachipato,CD Cobreloa,2,0,2,W
232021,10,CHL1,2010-11-26,Union San Felipe,Union Espanola,2,4,-2,L
232022,10,CHL1,2010-11-27,CD Cobreloa,Universidad Catolica,2,3,-1,L
232023,10,CHL1,2010-11-27,Everton CD,Audax Italiano,1,2,-1,L
232024,10,CHL1,2010-11-27,Universidad de Concepcion,Santiago Wanderers,1,2,-1,L
232025,10,CHL1,2010-11-28,CD Cobresal,La Serena,0,2,-2,L
232026,10,CHL1,2010-11-28,CD Palestino,San Luis,3,2,1,W
232027,10,CHL1,2010-11-28,Higgins,Colo Colo,2,1,1,W
232028,10,CHL1,2010-11-28,Santiago Morning,CD Huachipato,0,3,-3,L
232029,10,CHL1,2010-11-28,Universidad de Chile,Deportivo Nublense,1,2,-1,L
232030,10,CHL1,2010-12-03,Audax Italiano,Universidad de Chile,1,2,-1,L
232031,10,CHL1,2010-12-04,La Serena,Higgins,4,2,2,W
232032,10,CHL1,2010-12-04,Union Espanola,CD Cobresal,2,0,2,W
232033,10,CHL1,2010-12-05,Universidad Catolica,Everton CD,5,0,5,W
232034,10,CHL1,2010-12-05,CD Huachipato,CD Palestino,0,0,0,D
232035,10,CHL1,2010-12-05,Colo Colo,Universidad de Concepcion,4,2,2,W
232036,10,CHL1,2010-12-05,Santiago Wanderers,Santiago Morning,1,1,0,D
232037,10,CHL1,2010-12-05,Deportivo Nublense,Union San Felipe,2,0,2,W
232038,10,CHL1,2010-12-05,San Luis,CD Cobreloa,2,1,1,W
232039,11,CHL1,2011-01-29,Municipal Iquique,Universidad Catolica,0,2,-2,L
232040,11,CHL1,2011-01-29,Audax Italiano,CD Palestino,1,3,-2,L
232041,11,CHL1,2011-01-29,La Serena,Universidad de Chile,1,1,0,D
232042,11,CHL1,2011-01-29,Deportivo Nublense,Santiago Wanderers,2,0,2,W
232043,11,CHL1,2011-01-29,CD Huachipato,Universidad de Concepcion,1,0,1,W
232044,11,CHL1,2011-01-30,Colo Colo,CD Cobresal,2,2,0,D
232045,11,CHL1,2011-01-30,Santiago Morning,Union La Calera,1,1,0,D
232046,11,CHL1,2011-01-30,Union San Felipe,Higgins,3,1,2,W
232047,11,CHL1,2011-01-30,Union Espanola,CD Cobreloa,0,2,-2,L
232048,11,CHL1,2011-02-04,Universidad Catolica,Audax Italiano,3,1,2,W
232049,11,CHL1,2011-02-05,CD Cobresal,CD Huachipato,3,2,1,W
232050,11,CHL1,2011-02-05,Santiago Wanderers,Colo Colo,2,1,1,W
232051,11,CHL1,2011-02-05,Universidad de Concepcion,La Serena,0,0,0,D
232052,11,CHL1,2011-02-05,Universidad de Chile,Deportivo Nublense,3,1,2,W
232053,11,CHL1,2011-02-06,CD Cobreloa,Municipal Iquique,0,0,0,D
232054,11,CHL1,2011-02-06,CD Palestino,Union Espanola,1,2,-1,L
232055,11,CHL1,2011-02-06,Santiago Morning,Higgins,2,4,-2,L
232056,11,CHL1,2011-02-06,Union La Calera,Union San Felipe,1,0,1,W
232057,11,CHL1,2011-02-11,Union Espanola,Santiago Wanderers,2,1,1,W
232058,11,CHL1,2011-02-12,Union La Calera,Universidad Catolica,2,1,1,W
232059,11,CHL1,2011-02-12,La Serena,Santiago Morning,0,0,0,D
232060,11,CHL1,2011-02-12,CD Huachipato,Deportivo Nublense,3,1,2,W
232061,11,CHL1,2011-02-13,Colo Colo,Universidad de Concepcion,1,5,-4,L
232062,11,CHL1,2011-02-13,Municipal Iquique,Union San Felipe,1,1,0,D
232063,11,CHL1,2011-02-13,CD Cobreloa,Universidad de Chile,1,4,-3,L
232064,11,CHL1,2011-02-13,Audax Italiano,CD Cobresal,3,2,1,W
232065,11,CHL1,2011-02-18,La Serena,Audax Italiano,2,3,-1,L
232066,11,CHL1,2011-02-18,Santiago Wanderers,CD Palestino,1,1,0,D
232067,11,CHL1,2011-02-18,Deportivo Nublense,Higgins,2,3,-1,L
232068,11,CHL1,2011-02-19,CD Cobresal,Union La Calera,3,1,2,W
232069,11,CHL1,2011-02-19,Santiago Morning,Municipal Iquique,3,1,2,W
232070,11,CHL1,2011-02-19,Universidad de Concepcion,CD Cobreloa,0,1,-1,L
232071,11,CHL1,2011-02-19,Universidad Catolica,CD Huachipato,2,1,1,W
232072,11,CHL1,2011-02-20,Union San Felipe,Colo Colo,2,0,2,W
232073,11,CHL1,2011-02-20,Universidad de Chile,Union Espanola,2,1,1,W
232074,11,CHL1,2011-02-22,Higgins,Universidad Catolica,2,3,-1,L
232075,11,CHL1,2011-02-22,Deportivo Nublense,CD Cobreloa,2,1,1,W
232076,11,CHL1,2011-02-22,Union La Calera,La Serena,2,0,2,W
232077,11,CHL1,2011-02-23,CD Palestino,Colo Colo,0,3,-3,L
232078,11,CHL1,2011-02-23,Audax Italiano,Union San Felipe,2,1,1,W
232079,11,CHL1,2011-02-23,CD Huachipato,Santiago Wanderers,3,1,2,W
232080,11,CHL1,2011-02-24,Municipal Iquique,Universidad de Concepcion,1,3,-2,L
232081,11,CHL1,2011-02-24,Union Espanola,CD Cobresal,3,0,3,W
232082,11,CHL1,2011-02-25,Universidad de Chile,Santiago Morning,1,2,-1,L
232083,11,CHL1,2011-02-25,La Serena,Higgins,1,2,-1,L
232084,11,CHL1,2011-02-26,Universidad Catolica,Santiago Wanderers,1,1,0,D
232085,11,CHL1,2011-02-27,CD Cobreloa,Union La Calera,0,1,-1,L
232086,11,CHL1,2011-02-27,CD Cobresal,CD Palestino,2,1,1,W
232087,11,CHL1,2011-02-27,Universidad de Concepcion,Universidad de Chile,1,5,-4,L
232088,11,CHL1,2011-02-27,Municipal Iquique,Deportivo Nublense,2,1,1,W
232089,11,CHL1,2011-02-27,Santiago Morning,Audax Italiano,2,2,0,D
232090,11,CHL1,2011-02-27,Union San Felipe,Union Espanola,1,1,0,D
232091,11,CHL1,2011-03-04,Audax Italiano,CD Cobreloa,1,0,1,W
232092,11,CHL1,2011-03-05,Higgins,CD Cobresal,3,0,3,W
232093,11,CHL1,2011-03-05,CD Huachipato,Municipal Iquique,3,1,2,W
232094,11,CHL1,2011-03-05,Deportivo Nublense,La Serena,2,3,-1,L
232095,11,CHL1,2011-03-05,Universidad de Chile,Union San Felipe,0,2,-2,L
232096,11,CHL1,2011-03-06,Santiago Wanderers,Santiago Morning,4,1,3,W
232097,11,CHL1,2011-03-06,Union La Calera,Universidad de Concepcion,2,0,2,W
232098,11,CHL1,2011-03-06,Union Espanola,Colo Colo,1,2,-1,L
232099,11,CHL1,2011-03-06,CD Palestino,Universidad Catolica,1,2,-1,L
232100,11,CHL1,2011-03-11,Colo Colo,Union La Calera,2,0,2,W
232101,11,CHL1,2011-03-12,Universidad de Concepcion,Audax Italiano,1,0,1,W
232102,11,CHL1,2011-03-12,Union San Felipe,CD Huachipato,2,1,1,W
232103,11,CHL1,2011-03-13,La Serena,CD Palestino,2,3,-1,L
232104,11,CHL1,2011-03-13,CD Cobreloa,Higgins,2,3,-1,L
232105,11,CHL1,2011-03-13,Municipal Iquique,Santiago Wanderers,4,1,3,W
232106,11,CHL1,2011-03-13,Santiago Morning,Union Espanola,1,1,0,D
232107,11,CHL1,2011-03-13,Universidad Catolica,Deportivo Nublense,2,0,2,W
232108,11,CHL1,2011-03-18,Universidad Catolica,Santiago Morning,2,1,1,W
232109,11,CHL1,2011-03-19,Higgins,Universidad de Chile,1,1,0,D
232110,11,CHL1,2011-03-19,Union Espanola,Municipal Iquique,3,0,3,W
232111,11,CHL1,2011-03-19,Deportivo Nublense,Union San Felipe,1,0,1,W
232112,11,CHL1,2011-03-19,CD Huachipato,La Serena,0,4,-4,L
232113,11,CHL1,2011-03-20,Colo Colo,CD Cobreloa,1,1,0,D
232114,11,CHL1,2011-03-20,Santiago Wanderers,CD Cobresal,3,0,3,W
232115,11,CHL1,2011-03-20,CD Palestino,Universidad de Concepcion,3,2,1,W
232116,11,CHL1,2011-03-20,Union La Calera,Audax Italiano,3,1,2,W
232117,11,CHL1,2011-03-24,CD Cobresal,Universidad de Chile,2,5,-3,L
232118,11,CHL1,2011-03-27,Higgins,CD Palestino,1,2,-1,L
232119,11,CHL1,2011-03-27,Colo Colo,CD Huachipato,1,2,-1,L
232120,11,CHL1,2011-04-01,Union Espanola,Union La Calera,3,1,2,W
232121,11,CHL1,2011-04-02,Union San Felipe,Universidad Catolica,1,2,-1,L
232122,11,CHL1,2011-04-02,La Serena,Municipal Iquique,0,0,0,D
232123,11,CHL1,2011-04-02,Universidad de Concepcion,Higgins,0,1,-1,L
232124,11,CHL1,2011-04-03,Audax Italiano,Colo Colo,2,1,1,W
232125,11,CHL1,2011-04-03,CD Cobreloa,CD Palestino,1,0,1,W
232126,11,CHL1,2011-04-03,CD Cobresal,Deportivo Nublense,1,2,-1,L
232127,11,CHL1,2011-04-03,Santiago Morning,CD Huachipato,1,1,0,D
232128,11,CHL1,2011-04-03,Universidad de Chile,Santiago Wanderers,4,1,3,W
232129,11,CHL1,2011-04-09,Santiago Wanderers,Union San Felipe,1,2,-1,L
232130,11,CHL1,2011-04-09,CD Palestino,Union La Calera,1,1,0,D
232131,11,CHL1,2011-04-09,CD Huachipato,Audax Italiano,1,1,0,D
232132,11,CHL1,2011-04-09,Colo Colo,La Serena,4,1,3,W
232133,11,CHL1,2011-04-10,Municipal Iquique,Universidad de Chile,2,2,0,D
232134,11,CHL1,2011-04-10,Deportivo Nublense,Santiago Morning,1,1,0,D
232135,11,CHL1,2011-04-10,Higgins,Union Espanola,0,0,0,D
232136,11,CHL1,2011-04-10,CD Cobresal,Universidad de Concepcion,4,3,1,W
232137,11,CHL1,2011-04-10,Universidad Catolica,CD Cobreloa,2,0,2,W
232138,11,CHL1,2011-04-16,Union San Felipe,Santiago Morning,3,1,2,W
232139,11,CHL1,2011-04-16,Union La Calera,Universidad de Chile,0,2,-2,L
232140,11,CHL1,2011-04-16,CD Palestino,Municipal Iquique,1,0,1,W
232141,11,CHL1,2011-04-16,Universidad de Concepcion,Deportivo Nublense,1,0,1,W
232142,11,CHL1,2011-04-17,Audax Italiano,Higgins,1,3,-2,L
232143,11,CHL1,2011-04-17,Colo Colo,Universidad Catolica,1,1,0,D
232144,11,CHL1,2011-04-17,CD Cobreloa,CD Cobresal,1,0,1,W
232145,11,CHL1,2011-04-17,La Serena,Santiago Wanderers,3,1,2,W
232146,11,CHL1,2011-04-17,Union Espanola,CD Huachipato,4,2,2,W
232147,11,CHL1,2011-04-22,Deportivo Nublense,Union Espanola,0,5,-5,L
232148,11,CHL1,2011-04-23,Higgins,Union La Calera,2,0,2,W
232149,11,CHL1,2011-04-23,Santiago Wanderers,Universidad de Concepcion,2,1,1,W
232150,11,CHL1,2011-04-23,CD Huachipato,CD Cobreloa,1,1,0,D
232151,11,CHL1,2011-04-23,Universidad de Chile,CD Palestino,0,0,0,D
232152,11,CHL1,2011-04-24,Universidad Catolica,CD Cobresal,5,2,3,W
232153,11,CHL1,2011-04-24,Municipal Iquique,Audax Italiano,2,0,2,W
232154,11,CHL1,2011-04-24,Union San Felipe,La Serena,0,1,-1,L
232155,11,CHL1,2011-04-24,Santiago Morning,Colo Colo,0,1,-1,L
232156,11,CHL1,2011-04-29,Audax Italiano,Santiago Wanderers,4,0,4,W
232157,11,CHL1,2011-04-29,Higgins,Municipal Iquique,0,1,-1,L
232158,11,CHL1,2011-04-30,Union Espanola,La Serena,4,3,1,W
232159,11,CHL1,2011-04-30,CD Palestino,Deportivo Nublense,1,0,1,W
232160,11,CHL1,2011-04-30,Universidad de Chile,Colo Colo,2,1,1,W
232161,11,CHL1,2011-04-30,CD Cobreloa,Union San Felipe,1,1,0,D
232162,11,CHL1,2011-04-30,CD Cobresal,Santiago Morning,1,4,-3,L
232163,11,CHL1,2011-04-30,Universidad de Concepcion,Universidad Catolica,1,2,-1,L
232164,11,CHL1,2011-05-01,Union La Calera,CD Huachipato,0,0,0,D
232165,11,CHL1,2011-05-07,La Serena,CD Cobresal,2,1,1,W
232166,11,CHL1,2011-05-07,CD Huachipato,Universidad de Chile,1,3,-2,L
232167,11,CHL1,2011-05-07,Santiago Wanderers,CD Cobreloa,2,0,2,W
232168,11,CHL1,2011-05-08,Universidad Catolica,Union Espanola,0,0,0,D
232169,11,CHL1,2011-05-08,Municipal Iquique,Union La Calera,1,0,1,W
232170,11,CHL1,2011-05-08,Santiago Morning,CD Palestino,0,4,-4,L
232171,11,CHL1,2011-05-08,Deportivo Nublense,Audax Italiano,0,0,0,D
232172,11,CHL1,2011-05-08,Union San Felipe,Universidad de Concepcion,1,3,-2,L
232173,11,CHL1,2011-05-08,Colo Colo,Higgins,5,1,4,W
232174,11,CHL1,2011-05-14,Universidad de Concepcion,Santiago Morning,2,1,1,W
232175,11,CHL1,2011-05-14,CD Palestino,CD Huachipato,1,0,1,W
232176,11,CHL1,2011-05-14,Higgins,Santiago Wanderers,1,1,0,D
232177,11,CHL1,2011-05-15,Colo Colo,Municipal Iquique,1,1,0,D
232178,11,CHL1,2011-05-15,Universidad Catolica,Universidad de Chile,2,2,0,D
232179,11,CHL1,2011-05-15,Union La Calera,Deportivo Nublense,2,0,2,W
232180,11,CHL1,2011-05-15,CD Cobreloa,La Serena,3,3,0,D
232181,11,CHL1,2011-05-15,CD Cobresal,Union San Felipe,1,2,-1,L
232182,11,CHL1,2011-05-15,Audax Italiano,Union Espanola,1,2,-1,L
232183,11,CHL1,2011-05-21,Union Espanola,Universidad de Concepcion,1,1,0,D
232184,11,CHL1,2011-05-21,Universidad de Chile,Audax Italiano,2,1,1,W
232185,11,CHL1,2011-05-21,Union San Felipe,CD Palestino,2,3,-1,L
232186,11,CHL1,2011-05-21,CD Huachipato,Higgins,2,1,1,W
232187,11,CHL1,2011-05-22,Municipal Iquique,CD Cobresal,1,1,0,D
232188,11,CHL1,2011-05-22,Deportivo Nublense,Colo Colo,2,3,-1,L
232189,11,CHL1,2011-05-22,Santiago Morning,CD Cobreloa,1,1,0,D
232190,11,CHL1,2011-05-22,Santiago Wanderers,Union La Calera,1,1,0,D
232191,11,CHL1,2011-05-22,La Serena,Universidad Catolica,2,2,0,D
232192,11,CHL1,2011-07-30,Higgins,Union San Felipe,3,0,3,W
232193,11,CHL1,2011-07-30,CD Palestino,Audax Italiano,0,0,0,D
232194,11,CHL1,2011-07-30,Universidad Catolica,Municipal Iquique,4,1,3,W
232195,11,CHL1,2011-07-31,Universidad de Chile,La Serena,3,0,3,W
232196,11,CHL1,2011-07-31,CD Cobreloa,Union Espanola,0,0,0,D
232197,11,CHL1,2011-07-31,Santiago Wanderers,Deportivo Nublense,0,1,-1,L
232198,11,CHL1,2011-07-31,Union La Calera,Santiago Morning,2,0,2,W
232199,11,CHL1,2011-07-31,Universidad de Concepcion,CD Huachipato,1,1,0,D
232200,11,CHL1,2011-08-06,Union Espanola,CD Palestino,0,0,0,D
232201,11,CHL1,2011-08-06,Audax Italiano,Universidad Catolica,0,0,0,D
232202,11,CHL1,2011-08-06,CD Huachipato,CD Cobresal,1,0,1,W
232203,11,CHL1,2011-08-07,Union San Felipe,Union La Calera,1,1,0,D
232204,11,CHL1,2011-08-07,Municipal Iquique,CD Cobreloa,2,4,-2,L
232205,11,CHL1,2011-08-07,La Serena,Universidad de Concepcion,2,0,2,W
232206,11,CHL1,2011-08-07,Higgins,Santiago Morning,2,1,1,W
232207,11,CHL1,2011-08-07,Colo Colo,Santiago Wanderers,3,1,2,W
232208,11,CHL1,2011-08-13,Union San Felipe,Municipal Iquique,2,1,1,W
232209,11,CHL1,2011-08-13,CD Palestino,Higgins,2,2,0,D
232210,11,CHL1,2011-08-13,CD Cobresal,Audax Italiano,3,2,1,W
232211,11,CHL1,2011-08-13,Santiago Wanderers,Union Espanola,1,1,0,D
232212,11,CHL1,2011-08-14,Universidad Catolica,Union La Calera,4,0,4,W
232213,11,CHL1,2011-08-14,Santiago Morning,La Serena,4,1,3,W
232214,11,CHL1,2011-08-14,Deportivo Nublense,CD Huachipato,2,4,-2,L
232215,11,CHL1,2011-08-14,Universidad de Concepcion,Colo Colo,3,0,3,W
232216,11,CHL1,2011-08-14,Universidad de Chile,CD Cobreloa,3,1,2,W
232217,11,CHL1,2011-08-20,Union La Calera,CD Cobresal,0,1,-1,L
232218,11,CHL1,2011-08-20,Audax Italiano,La Serena,2,1,1,W
232219,11,CHL1,2011-08-20,CD Palestino,Santiago Wanderers,1,1,0,D
232220,11,CHL1,2011-08-20,CD Cobreloa,Universidad de Concepcion,1,1,0,D
232221,11,CHL1,2011-08-20,CD Huachipato,Universidad Catolica,1,1,0,D
232222,11,CHL1,2011-08-21,Higgins,Deportivo Nublense,1,1,0,D
232223,11,CHL1,2011-08-21,Municipal Iquique,Santiago Morning,4,2,2,W
232224,11,CHL1,2011-08-21,Union Espanola,Universidad de Chile,0,1,-1,L
232225,11,CHL1,2011-08-21,Colo Colo,Union San Felipe,2,2,0,D
232226,11,CHL1,2011-08-23,La Serena,Union La Calera,0,0,0,D
232227,11,CHL1,2011-08-23,CD Cobreloa,Deportivo Nublense,2,0,2,W
232228,11,CHL1,2011-08-24,Universidad Catolica,Higgins,2,0,2,W
232229,11,CHL1,2011-08-24,Santiago Wanderers,CD Huachipato,2,1,1,W
232230,11,CHL1,2011-08-24,CD Cobresal,Union Espanola,2,2,0,D
232231,11,CHL1,2011-08-24,Universidad de Concepcion,Municipal Iquique,3,1,2,W
232232,11,CHL1,2011-08-25,Colo Colo,CD Palestino,3,1,2,W
232233,11,CHL1,2011-08-25,Union San Felipe,Audax Italiano,2,2,0,D
232234,11,CHL1,2011-08-26,Santiago Morning,Universidad de Chile,0,2,-2,L
232235,11,CHL1,2011-08-27,Higgins,La Serena,1,1,0,D
232236,11,CHL1,2011-08-27,CD Palestino,CD Cobresal,2,1,1,W
232237,11,CHL1,2011-08-27,CD Huachipato,Colo Colo,1,2,-1,L
232238,11,CHL1,2011-08-28,Union Espanola,Union San Felipe,3,0,3,W
232239,11,CHL1,2011-08-28,Santiago Wanderers,Universidad Catolica,2,0,2,W
232240,11,CHL1,2011-08-28,Union La Calera,CD Cobreloa,0,1,-1,L
232241,11,CHL1,2011-08-28,Audax Italiano,Santiago Morning,5,0,5,W
232242,11,CHL1,2011-08-28,Deportivo Nublense,Municipal Iquique,1,2,-1,L
232243,11,CHL1,2011-08-28,Universidad de Chile,Universidad de Concepcion,2,0,2,W
232244,11,CHL1,2011-09-03,CD Cobresal,Colo Colo,0,2,-2,L
232245,11,CHL1,2011-09-03,Deportivo Nublense,Universidad de Chile,1,4,-3,L
232246,11,CHL1,2011-09-10,La Serena,Deportivo Nublense,3,1,2,W
232247,11,CHL1,2011-09-10,Santiago Morning,Santiago Wanderers,3,0,3,W
232248,11,CHL1,2011-09-10,Universidad de Concepcion,Union La Calera,0,0,0,D
232249,11,CHL1,2011-09-10,Union San Felipe,Universidad de Chile,0,3,-3,L
232250,11,CHL1,2011-09-11,Colo Colo,Union Espanola,3,2,1,W
232251,11,CHL1,2011-09-11,Municipal Iquique,CD Huachipato,3,2,1,W
232252,11,CHL1,2011-09-11,CD Cobreloa,Audax Italiano,3,4,-1,L
232253,11,CHL1,2011-09-11,CD Cobresal,Higgins,1,0,1,W
232254,11,CHL1,2011-09-11,Universidad Catolica,CD Palestino,2,1,1,W
232255,11,CHL1,2011-09-16,Audax Italiano,Universidad de Concepcion,2,1,1,W
232256,11,CHL1,2011-09-16,CD Huachipato,Union San Felipe,2,2,0,D
232257,11,CHL1,2011-09-17,Union Espanola,Santiago Morning,1,0,1,W
232258,11,CHL1,2011-09-17,Universidad de Chile,CD Cobresal,3,1,2,W
232259,11,CHL1,2011-09-17,Union La Calera,Colo Colo,3,0,3,W
232260,11,CHL1,2011-09-17,Santiago Wanderers,Municipal Iquique,2,2,0,D
232261,11,CHL1,2011-09-17,CD Palestino,La Serena,1,1,0,D
232262,11,CHL1,2011-09-17,Higgins,CD Cobreloa,2,2,0,D
232263,11,CHL1,2011-09-17,Deportivo Nublense,Universidad Catolica,2,0,2,W
232264,11,CHL1,2011-09-23,Audax Italiano,Union La Calera,2,1,1,W
232265,11,CHL1,2011-09-24,La Serena,CD Huachipato,1,0,1,W
232266,11,CHL1,2011-09-24,Municipal Iquique,Union Espanola,1,5,-4,L
232267,11,CHL1,2011-09-24,CD Cobresal,Santiago Wanderers,3,2,1,W
232268,11,CHL1,2011-09-24,Union San Felipe,Deportivo Nublense,1,2,-1,L
232269,11,CHL1,2011-09-24,Santiago Morning,Universidad Catolica,3,2,1,W
232270,11,CHL1,2011-09-24,Universidad de Concepcion,CD Palestino,0,0,0,D
232271,11,CHL1,2011-09-25,CD Cobreloa,Colo Colo,0,1,-1,L
232272,11,CHL1,2011-09-25,Universidad de Chile,Higgins,3,0,3,W
232273,11,CHL1,2011-09-27,Union La Calera,Union Espanola,2,0,2,W
232274,11,CHL1,2011-09-28,Universidad Catolica,Union San Felipe,0,1,-1,L
232275,11,CHL1,2011-09-28,CD Palestino,CD Cobreloa,0,2,-2,L
232276,11,CHL1,2011-09-28,Santiago Wanderers,Universidad de Chile,1,1,0,D
232277,11,CHL1,2011-09-28,Higgins,Universidad de Concepcion,3,0,3,W
232278,11,CHL1,2011-09-29,Deportivo Nublense,CD Cobresal,0,2,-2,L
232279,11,CHL1,2011-09-29,Municipal Iquique,La Serena,1,1,0,D
232280,11,CHL1,2011-09-29,CD Huachipato,Santiago Morning,1,3,-2,L
232281,11,CHL1,2011-09-30,Colo Colo,Audax Italiano,3,0,3,W
232282,11,CHL1,2011-10-01,CD Cobreloa,Universidad Catolica,2,0,2,W
232283,11,CHL1,2011-10-01,Universidad de Concepcion,CD Cobresal,0,0,0,D
232284,11,CHL1,2011-10-02,Universidad de Chile,Municipal Iquique,2,2,0,D
232285,11,CHL1,2011-10-02,La Serena,Colo Colo,4,0,4,W
232286,11,CHL1,2011-10-02,Union San Felipe,Santiago Wanderers,0,2,-2,L
232287,11,CHL1,2011-10-02,Union La Calera,CD Palestino,3,2,1,W
232288,11,CHL1,2011-10-02,Santiago Morning,Deportivo Nublense,1,3,-2,L
232289,11,CHL1,2011-10-02,Union Espanola,Higgins,3,1,2,W
232290,11,CHL1,2011-10-04,Audax Italiano,CD Huachipato,1,1,0,D
232291,11,CHL1,2011-10-13,Universidad de Chile,Union La Calera,3,2,1,W
232292,11,CHL1,2011-10-15,CD Huachipato,Union Espanola,2,1,1,W
232293,11,CHL1,2011-10-15,Santiago Morning,Union San Felipe,1,1,0,D
232294,11,CHL1,2011-10-15,Santiago Wanderers,La Serena,0,2,-2,L
232295,11,CHL1,2011-10-16,Deportivo Nublense,Universidad de Concepcion,2,1,1,W
232296,11,CHL1,2011-10-16,Municipal Iquique,CD Palestino,1,3,-2,L
232297,11,CHL1,2011-10-16,Universidad Catolica,Colo Colo,4,0,4,W
232298,11,CHL1,2011-10-16,CD Cobresal,CD Cobreloa,0,3,-3,L
232299,11,CHL1,2011-10-16,Higgins,Audax Italiano,0,1,-1,L
232300,11,CHL1,2011-10-22,Audax Italiano,Municipal Iquique,3,0,3,W
232301,11,CHL1,2011-10-22,Union La Calera,Higgins,1,0,1,W
232302,11,CHL1,2011-10-22,La Serena,Union San Felipe,2,1,1,W
232303,11,CHL1,2011-10-22,Universidad de Concepcion,Santiago Wanderers,2,2,0,D
232304,11,CHL1,2011-10-22,CD Palestino,Universidad de Chile,1,1,0,D
232305,11,CHL1,2011-10-23,Union Espanola,Deportivo Nublense,3,1,2,W
232306,11,CHL1,2011-10-23,CD Cobreloa,CD Huachipato,1,0,1,W
232307,11,CHL1,2011-10-23,CD Cobresal,Universidad Catolica,2,2,0,D
232308,11,CHL1,2011-10-23,Colo Colo,Santiago Morning,3,1,2,W
232309,11,CHL1,2011-10-29,Union San Felipe,CD Cobreloa,1,1,0,D
232310,11,CHL1,2011-10-29,Municipal Iquique,Higgins,3,2,1,W
232311,11,CHL1,2011-10-29,Santiago Wanderers,Audax Italiano,2,0,2,W
232312,11,CHL1,2011-10-29,Santiago Morning,CD Cobresal,5,0,5,W
232313,11,CHL1,2011-10-29,CD Huachipato,Union La Calera,1,0,1,W
232314,11,CHL1,2011-10-30,La Serena,Union Espanola,3,2,1,W
232315,11,CHL1,2011-10-30,Deportivo Nublense,CD Palestino,3,1,2,W
232316,11,CHL1,2011-10-30,Colo Colo,Universidad de Chile,2,2,0,D
232317,11,CHL1,2011-10-30,Universidad Catolica,Universidad de Concepcion,2,1,1,W
232318,11,CHL1,2011-11-04,Audax Italiano,Deportivo Nublense,2,0,2,W
232319,11,CHL1,2011-11-05,CD Palestino,Santiago Morning,2,4,-2,L
232320,11,CHL1,2011-11-05,Universidad de Concepcion,Union San Felipe,2,1,1,W
232321,11,CHL1,2011-11-05,Union Espanola,Universidad Catolica,1,2,-1,L
232322,11,CHL1,2011-11-05,Union La Calera,Municipal Iquique,1,2,-1,L
232323,11,CHL1,2011-11-06,CD Cobreloa,Santiago Wanderers,1,0,1,W
232324,11,CHL1,2011-11-06,CD Cobresal,La Serena,2,1,1,W
232325,11,CHL1,2011-11-06,Higgins,Colo Colo,2,0,2,W
232326,11,CHL1,2011-11-06,Universidad de Chile,CD Huachipato,5,3,2,W
232327,11,CHL1,2011-11-18,CD Huachipato,CD Palestino,0,1,-1,L
232328,11,CHL1,2011-11-19,Municipal Iquique,Colo Colo,1,1,0,D
232329,11,CHL1,2011-11-19,Santiago Morning,Universidad de Concepcion,0,3,-3,L
232330,11,CHL1,2011-11-19,Santiago Wanderers,Higgins,1,0,1,W
232331,11,CHL1,2011-11-19,La Serena,CD Cobreloa,2,1,1,W
232332,11,CHL1,2011-11-19,Union San Felipe,CD Cobresal,1,1,0,D
232333,11,CHL1,2011-11-19,Union Espanola,Audax Italiano,5,2,3,W
232334,11,CHL1,2011-11-20,Universidad de Chile,Universidad Catolica,0,0,0,D
232335,11,CHL1,2011-11-20,Deportivo Nublense,Union La Calera,1,3,-2,L
232336,11,CHL1,2011-11-26,Universidad Catolica,La Serena,4,1,3,W
232337,11,CHL1,2011-11-26,Colo Colo,Deportivo Nublense,2,1,1,W
232338,11,CHL1,2011-11-27,CD Cobreloa,Santiago Morning,2,1,1,W
232339,11,CHL1,2011-11-27,CD Cobresal,Municipal Iquique,3,3,0,D
232340,11,CHL1,2011-11-27,Union La Calera,Santiago Wanderers,1,0,1,W
232341,11,CHL1,2011-11-27,CD Palestino,Union San Felipe,1,0,1,W
232342,11,CHL1,2011-11-27,Higgins,CD Huachipato,4,4,0,D
232343,11,CHL1,2011-11-27,Universidad de Concepcion,Union Espanola,2,2,0,D
232344,11,CHL1,2011-11-27,Audax Italiano,Universidad de Chile,1,1,0,D
232345,12,CHL1,2012-01-27,Higgins,Antofagasta,1,0,1,W
232346,12,CHL1,2012-01-28,CSD Rangers,La Serena,2,0,2,W
232347,12,CHL1,2012-01-28,CD Palestino,Universidad Catolica,1,2,-1,L
232348,12,CHL1,2012-01-28,CD Huachipato,Santiago Wanderers,2,1,1,W
232349,12,CHL1,2012-01-29,Colo Colo,Municipal Iquique,0,0,0,D
232350,12,CHL1,2012-01-29,CD Cobresal,Union San Felipe,1,1,0,D
232351,12,CHL1,2012-01-29,Union La Calera,Universidad de Concepcion,1,1,0,D
232352,12,CHL1,2012-01-29,Audax Italiano,Union Espanola,0,2,-2,L
232353,12,CHL1,2012-02-03,Universidad de Concepcion,Audax Italiano,1,1,0,D
232354,12,CHL1,2012-02-04,CD Palestino,CD Huachipato,2,2,0,D
232355,12,CHL1,2012-02-04,Santiago Wanderers,Universidad Catolica,2,1,1,W
232356,12,CHL1,2012-02-04,La Serena,Universidad de Chile,1,3,-2,L
232357,12,CHL1,2012-02-04,Colo Colo,Higgins,1,0,1,W
232358,12,CHL1,2012-02-05,Antofagasta,Municipal Iquique,1,1,0,D
232359,12,CHL1,2012-02-05,Union Espanola,CD Cobresal,6,1,5,W
232360,12,CHL1,2012-02-05,CD Cobreloa,Union La Calera,1,0,1,W
232361,12,CHL1,2012-02-05,Union San Felipe,CSD Rangers,0,0,0,D
232362,12,CHL1,2012-02-10,Universidad de Chile,Municipal Iquique,1,1,0,D
232363,12,CHL1,2012-02-11,Union La Calera,CD Palestino,1,1,0,D
232364,12,CHL1,2012-02-11,CD Cobresal,Colo Colo,2,2,0,D
232365,12,CHL1,2012-02-11,CD Huachipato,La Serena,1,1,0,D
232366,12,CHL1,2012-02-11,Audax Italiano,CD Cobreloa,1,1,0,D
232367,12,CHL1,2012-02-12,CSD Rangers,Santiago Wanderers,2,3,-1,L
232368,12,CHL1,2012-02-12,Antofagasta,Universidad de Concepcion,2,1,1,W
232369,12,CHL1,2012-02-12,Union Espanola,Higgins,0,2,-2,L
232370,12,CHL1,2012-02-12,Universidad Catolica,Union San Felipe,1,1,0,D
232371,12,CHL1,2012-02-17,Union San Felipe,Union Espanola,3,1,2,W
232372,12,CHL1,2012-02-18,Universidad de Concepcion,CD Cobresal,1,1,0,D
232373,12,CHL1,2012-02-18,Santiago Wanderers,Audax Italiano,4,2,2,W
232374,12,CHL1,2012-02-18,Municipal Iquique,CSD Rangers,2,0,2,W
232375,12,CHL1,2012-02-18,CD Palestino,Universidad de Chile,1,3,-2,L
232376,12,CHL1,2012-02-18,La Serena,Higgins,2,2,0,D
232377,12,CHL1,2012-02-19,Universidad Catolica,Antofagasta,1,0,1,W
232378,12,CHL1,2012-02-19,CD Cobreloa,CD Huachipato,4,2,2,W
232379,12,CHL1,2012-02-19,Colo Colo,Union La Calera,3,1,2,W
232380,12,CHL1,2012-02-24,Audax Italiano,CD Palestino,1,2,-1,L
232381,12,CHL1,2012-02-25,CSD Rangers,CD Cobreloa,0,3,-3,L
232382,12,CHL1,2012-02-25,Higgins,Universidad de Chile,3,0,3,W
232383,12,CHL1,2012-02-25,Municipal Iquique,CD Huachipato,1,0,1,W
232384,12,CHL1,2012-02-25,Colo Colo,Universidad de Concepcion,1,2,-1,L
232385,12,CHL1,2012-02-25,La Serena,Santiago Wanderers,3,1,2,W
232386,12,CHL1,2012-02-26,Antofagasta,Union San Felipe,0,0,0,D
232387,12,CHL1,2012-02-26,CD Cobresal,Union La Calera,1,4,-3,L
232388,12,CHL1,2012-02-26,Union Espanola,Universidad Catolica,2,2,0,D
232389,12,CHL1,2012-02-28,Universidad de Chile,CD Cobreloa,4,1,3,W
232390,12,CHL1,2012-03-02,Universidad Catolica,CSD Rangers,2,0,2,W
232391,12,CHL1,2012-03-03,CD Palestino,Union Espanola,1,3,-2,L
232392,12,CHL1,2012-03-03,Municipal Iquique,Audax Italiano,1,2,-1,L
232393,12,CHL1,2012-03-03,Universidad de Concepcion,Higgins,1,3,-2,L
232394,12,CHL1,2012-03-03,Universidad de Chile,CD Cobresal,3,1,2,W
232395,12,CHL1,2012-03-03,Union San Felipe,CD Huachipato,1,2,-1,L
232396,12,CHL1,2012-03-04,Santiago Wanderers,Colo Colo,0,0,0,D
232397,12,CHL1,2012-03-04,CD Cobreloa,La Serena,2,2,0,D
232398,12,CHL1,2012-03-04,Union La Calera,Antofagasta,0,0,0,D
232399,12,CHL1,2012-03-09,CSD Rangers,CD Palestino,2,0,2,W
232400,12,CHL1,2012-03-10,Union Espanola,CD Huachipato,1,3,-2,L
232401,12,CHL1,2012-03-10,Universidad de Concepcion,CD Cobreloa,3,1,2,W
232402,12,CHL1,2012-03-10,Audax Italiano,Universidad de Chile,0,6,-6,L
232403,12,CHL1,2012-03-10,Union San Felipe,Union La Calera,0,0,0,D
232404,12,CHL1,2012-03-11,Antofagasta,Santiago Wanderers,1,0,1,W
232405,12,CHL1,2012-03-11,Higgins,Universidad Catolica,1,2,-1,L
232406,12,CHL1,2012-03-11,CD Cobresal,Municipal Iquique,0,4,-4,L
232407,12,CHL1,2012-03-11,Colo Colo,La Serena,0,2,-2,L
232408,12,CHL1,2012-03-16,Santiago Wanderers,Union San Felipe,1,0,1,W
232409,12,CHL1,2012-03-17,La Serena,Universidad de Concepcion,1,0,1,W
232410,12,CHL1,2012-03-17,CD Cobreloa,Colo Colo,0,2,-2,L
232411,12,CHL1,2012-03-17,CD Palestino,CD Cobresal,2,1,1,W
232412,12,CHL1,2012-03-17,Municipal Iquique,Higgins,1,2,-1,L
232413,12,CHL1,2012-03-17,Universidad de Chile,Union Espanola,3,2,1,W
232414,12,CHL1,2012-03-17,CD Huachipato,Antofagasta,2,0,2,W
232415,12,CHL1,2012-03-18,Union La Calera,Universidad Catolica,1,0,1,W
232416,12,CHL1,2012-03-18,Audax Italiano,CSD Rangers,3,0,3,W
232417,12,CHL1,2012-03-23,Union San Felipe,Universidad de Chile,0,1,-1,L
232418,12,CHL1,2012-03-23,Universidad de Concepcion,Santiago Wanderers,2,5,-3,L
232419,12,CHL1,2012-03-24,Union Espanola,La Serena,5,2,3,W
232420,12,CHL1,2012-03-24,Higgins,Union La Calera,2,1,1,W
232421,12,CHL1,2012-03-24,Universidad Catolica,Municipal Iquique,1,1,0,D
232422,12,CHL1,2012-03-24,CSD Rangers,CD Huachipato,2,1,1,W
232423,12,CHL1,2012-03-25,Antofagasta,CD Cobreloa,1,0,1,W
232424,12,CHL1,2012-03-25,CD Cobresal,Audax Italiano,3,1,2,W
232425,12,CHL1,2012-03-25,Colo Colo,CD Palestino,0,1,-1,L
232426,12,CHL1,2012-03-31,La Serena,Union San Felipe,2,1,1,W
232427,12,CHL1,2012-03-31,Santiago Wanderers,CD Cobresal,5,2,3,W
232428,12,CHL1,2012-03-31,CD Palestino,Antofagasta,0,0,0,D
232429,12,CHL1,2012-03-31,Municipal Iquique,Universidad de Concepcion,2,0,2,W
232430,12,CHL1,2012-03-31,Audax Italiano,Universidad Catolica,2,0,2,W
232431,12,CHL1,2012-04-01,Union La Calera,Union Espanola,1,0,1,W
232432,12,CHL1,2012-04-01,CD Huachipato,Colo Colo,0,3,-3,L
232433,12,CHL1,2012-04-01,CD Cobreloa,Higgins,0,1,-1,L
232434,12,CHL1,2012-04-01,Universidad de Chile,CSD Rangers,2,0,2,W
232435,12,CHL1,2012-04-07,Union Espanola,Colo Colo,4,2,2,W
232436,12,CHL1,2012-04-07,Municipal Iquique,La Serena,3,1,2,W
232437,12,CHL1,2012-04-07,CSD Rangers,Union La Calera,2,0,2,W
232438,12,CHL1,2012-04-07,Higgins,Union San Felipe,2,1,1,W
232439,12,CHL1,2012-04-08,Universidad de Concepcion,CD Palestino,2,0,2,W
232440,12,CHL1,2012-04-08,Antofagasta,Audax Italiano,1,2,-1,L
232441,12,CHL1,2012-04-08,Universidad de Chile,Santiago Wanderers,3,0,3,W
232442,12,CHL1,2012-04-08,CD Cobresal,CD Huachipato,0,2,-2,L
232443,12,CHL1,2012-04-08,Universidad Catolica,CD Cobreloa,5,1,4,W
232444,12,CHL1,2012-04-14,Union Espanola,CSD Rangers,2,1,1,W
232445,12,CHL1,2012-04-14,CD Palestino,Santiago Wanderers,2,1,1,W
232446,12,CHL1,2012-04-14,Colo Colo,Universidad Catolica,1,1,0,D
232447,12,CHL1,2012-04-14,Union San Felipe,Universidad de Concepcion,2,2,0,D
232448,12,CHL1,2012-04-15,La Serena,Audax Italiano,2,4,-2,L
232449,12,CHL1,2012-04-15,Antofagasta,CD Cobresal,2,1,1,W
232450,12,CHL1,2012-04-15,Union La Calera,Universidad de Chile,0,1,-1,L
232451,12,CHL1,2012-04-15,CD Cobreloa,Municipal Iquique,0,1,-1,L
232452,12,CHL1,2012-04-15,CD Huachipato,Higgins,2,1,1,W
232453,12,CHL1,2012-04-21,Audax Italiano,Union San Felipe,0,0,0,D
232454,12,CHL1,2012-04-21,Higgins,CD Palestino,5,0,5,W
232455,12,CHL1,2012-04-21,Municipal Iquique,Union La Calera,3,3,0,D
232456,12,CHL1,2012-04-21,Santiago Wanderers,Union Espanola,2,2,0,D
232457,12,CHL1,2012-04-21,Universidad de Concepcion,CD Huachipato,1,1,0,D
232458,12,CHL1,2012-04-22,Universidad Catolica,La Serena,3,0,3,W
232459,12,CHL1,2012-04-22,CSD Rangers,Colo Colo,2,2,0,D
232460,12,CHL1,2012-04-22,CD Cobresal,CD Cobreloa,0,1,-1,L
232461,12,CHL1,2012-04-22,Universidad de Chile,Antofagasta,4,0,4,W
232462,12,CHL1,2012-04-28,Union San Felipe,CD Cobreloa,0,3,-3,L
232463,12,CHL1,2012-04-28,Union Espanola,Universidad de Concepcion,4,1,3,W
232464,12,CHL1,2012-04-28,CD Palestino,Municipal Iquique,0,1,-1,L
232465,12,CHL1,2012-04-28,CD Cobresal,CSD Rangers,1,0,1,W
232466,12,CHL1,2012-04-28,CD Huachipato,Universidad Catolica,2,2,0,D
232467,12,CHL1,2012-04-28,La Serena,Antofagasta,4,1,3,W
232468,12,CHL1,2012-04-29,Santiago Wanderers,Higgins,0,1,-1,L
232469,12,CHL1,2012-04-29,Universidad de Chile,Colo Colo,5,0,5,W
232470,12,CHL1,2012-04-29,Union La Calera,Audax Italiano,1,1,0,D
232471,12,CHL1,2012-05-05,Audax Italiano,CD Huachipato,2,2,0,D
232472,12,CHL1,2012-05-05,Union La Calera,La Serena,3,0,3,W
232473,12,CHL1,2012-05-05,Municipal Iquique,Santiago Wanderers,2,1,1,W
232474,12,CHL1,2012-05-05,CD Cobreloa,CD Palestino,1,0,1,W
232475,12,CHL1,2012-05-05,Colo Colo,Union San Felipe,1,0,1,W
232476,12,CHL1,2012-05-05,Higgins,CSD Rangers,2,2,0,D
232477,12,CHL1,2012-05-06,Antofagasta,Union Espanola,1,1,0,D
232478,12,CHL1,2012-05-06,Universidad de Concepcion,Universidad de Chile,2,0,2,W
232479,12,CHL1,2012-05-06,Universidad Catolica,CD Cobresal,5,0,5,W
232480,12,CHL1,2012-05-12,CD Huachipato,Union La Calera,1,2,-1,L
232481,12,CHL1,2012-05-12,Union Espanola,Municipal Iquique,1,2,-1,L
232482,12,CHL1,2012-05-12,Santiago Wanderers,CD Cobreloa,1,3,-2,L
232483,12,CHL1,2012-05-12,CSD Rangers,Universidad de Concepcion,1,2,-1,L
232484,12,CHL1,2012-05-12,Colo Colo,Antofagasta,1,0,1,W
232485,12,CHL1,2012-05-12,La Serena,CD Cobresal,1,1,0,D
232486,12,CHL1,2012-05-13,Union San Felipe,CD Palestino,1,0,1,W
232487,12,CHL1,2012-05-13,Universidad Catolica,Universidad de Chile,2,1,1,W
232488,12,CHL1,2012-05-13,Higgins,Audax Italiano,3,1,2,W
232489,12,CHL1,2012-05-19,Union La Calera,Santiago Wanderers,2,1,1,W
232490,12,CHL1,2012-05-19,CD Cobreloa,Union Espanola,1,2,-1,L
232491,12,CHL1,2012-05-19,CD Palestino,La Serena,1,0,1,W
232492,12,CHL1,2012-05-19,Municipal Iquique,Union San Felipe,4,1,3,W
232493,12,CHL1,2012-05-19,Audax Italiano,Colo Colo,1,3,-2,L
232494,12,CHL1,2012-05-20,Antofagasta,CSD Rangers,0,1,-1,L
232495,12,CHL1,2012-05-20,Universidad de Concepcion,Universidad Catolica,1,1,0,D
232496,12,CHL1,2012-05-20,CD Cobresal,Higgins,1,0,1,W
232497,12,CHL1,2012-05-20,Universidad de Chile,CD Huachipato,4,0,4,W
232498,12,CHL1,2012-07-07,La Serena,CSD Rangers,1,1,0,D
232499,12,CHL1,2012-07-07,Union Espanola,Audax Italiano,3,3,0,D
232500,12,CHL1,2012-07-07,Universidad de Concepcion,Union La Calera,0,0,0,D
232501,12,CHL1,2012-07-07,Santiago Wanderers,CD Huachipato,1,1,0,D
232502,12,CHL1,2012-07-08,Union San Felipe,CD Cobresal,0,0,0,D
232503,12,CHL1,2012-07-08,Municipal Iquique,Colo Colo,0,1,-1,L
232504,12,CHL1,2012-07-08,Universidad Catolica,CD Palestino,0,1,-1,L
232505,12,CHL1,2012-07-14,Audax Italiano,Universidad de Concepcion,2,2,0,D
232506,12,CHL1,2012-07-14,Municipal Iquique,Antofagasta,2,1,1,W
232507,12,CHL1,2012-07-14,CD Cobresal,Union Espanola,2,1,1,W
232508,12,CHL1,2012-07-14,Union La Calera,CD Cobreloa,1,0,1,W
232509,12,CHL1,2012-07-14,Universidad Catolica,Santiago Wanderers,3,2,1,W
232510,12,CHL1,2012-07-15,CD Huachipato,CD Palestino,1,1,0,D
232511,12,CHL1,2012-07-15,Higgins,Colo Colo,1,1,0,D
232512,12,CHL1,2012-07-15,CSD Rangers,Union San Felipe,1,0,1,W
232513,12,CHL1,2012-07-16,Universidad de Chile,La Serena,5,2,3,W
232514,12,CHL1,2012-07-21,Universidad de Concepcion,Antofagasta,0,2,-2,L
232515,12,CHL1,2012-07-21,Higgins,Union Espanola,1,3,-2,L
232516,12,CHL1,2012-07-21,CD Palestino,Union La Calera,1,0,1,W
232517,12,CHL1,2012-07-21,Municipal Iquique,Universidad de Chile,0,0,0,D
232518,12,CHL1,2012-07-21,CD Cobreloa,Audax Italiano,1,2,-1,L
232519,12,CHL1,2012-07-21,Santiago Wanderers,CSD Rangers,2,2,0,D
232520,12,CHL1,2012-07-22,La Serena,CD Huachipato,2,1,1,W
232521,12,CHL1,2012-07-22,Colo Colo,CD Cobresal,1,2,-1,L
232522,12,CHL1,2012-07-22,Union San Felipe,Universidad Catolica,0,1,-1,L
232523,12,CHL1,2012-07-28,CSD Rangers,Municipal Iquique,5,0,5,W
232524,12,CHL1,2012-07-28,Antofagasta,Universidad Catolica,2,2,0,D
232525,12,CHL1,2012-07-28,CD Cobresal,Universidad de Concepcion,1,1,0,D
232526,12,CHL1,2012-07-28,Union Espanola,Union San Felipe,3,1,2,W
232527,12,CHL1,2012-07-28,Audax Italiano,Santiago Wanderers,4,1,3,W
232528,12,CHL1,2012-07-28,CD Huachipato,CD Cobreloa,0,1,-1,L
232529,12,CHL1,2012-07-29,Union La Calera,Colo Colo,1,1,0,D
232530,12,CHL1,2012-07-29,Higgins,La Serena,2,1,1,W
232531,12,CHL1,2012-08-04,Union San Felipe,Antofagasta,2,1,1,W
232532,12,CHL1,2012-08-04,CD Palestino,Audax Italiano,0,0,0,D
232533,12,CHL1,2012-08-04,CD Cobreloa,CSD Rangers,0,1,-1,L
232534,12,CHL1,2012-08-04,Santiago Wanderers,La Serena,1,1,0,D
232535,12,CHL1,2012-08-05,CD Huachipato,Municipal Iquique,4,1,3,W
232536,12,CHL1,2012-08-05,Union La Calera,CD Cobresal,1,1,0,D
232537,12,CHL1,2012-08-05,Universidad de Concepcion,Colo Colo,1,1,0,D
232538,12,CHL1,2012-08-05,Universidad Catolica,Union Espanola,3,0,3,W
232539,12,CHL1,2012-08-09,Universidad de Chile,CD Palestino,3,2,1,W
232540,12,CHL1,2012-08-11,Audax Italiano,Municipal Iquique,0,1,-1,L
232541,12,CHL1,2012-08-11,Union Espanola,CD Palestino,1,0,1,W
232542,12,CHL1,2012-08-11,CD Cobresal,Universidad de Chile,1,2,-1,L
232543,12,CHL1,2012-08-11,CD Huachipato,Union San Felipe,1,0,1,W
232544,12,CHL1,2012-08-12,La Serena,CD Cobreloa,0,0,0,D
232545,12,CHL1,2012-08-12,Antofagasta,Union La Calera,2,1,1,W
232546,12,CHL1,2012-08-12,CSD Rangers,Universidad Catolica,1,0,1,W
232547,12,CHL1,2012-08-12,Higgins,Universidad de Concepcion,4,1,3,W
232548,12,CHL1,2012-08-12,Colo Colo,Santiago Wanderers,1,1,0,D
232549,12,CHL1,2012-08-15,Antofagasta,Higgins,2,3,-1,L
232550,12,CHL1,2012-08-18,CD Huachipato,Union Espanola,2,0,2,W
232551,12,CHL1,2012-08-18,CD Palestino,CSD Rangers,4,1,3,W
232552,12,CHL1,2012-08-18,Universidad de Chile,Audax Italiano,2,1,1,W
232553,12,CHL1,2012-08-18,Union La Calera,Union San Felipe,1,3,-2,L
232554,12,CHL1,2012-08-19,Santiago Wanderers,Antofagasta,0,1,-1,L
232555,12,CHL1,2012-08-19,Municipal Iquique,CD Cobresal,3,2,1,W
232556,12,CHL1,2012-08-19,CD Cobreloa,Universidad de Concepcion,3,1,2,W
232557,12,CHL1,2012-08-19,La Serena,Colo Colo,1,1,0,D
232558,12,CHL1,2012-08-19,Universidad Catolica,Higgins,1,0,1,W
232559,12,CHL1,2012-08-25,Universidad de Concepcion,La Serena,3,1,2,W
232560,12,CHL1,2012-08-25,Union Espanola,Universidad de Chile,5,2,3,W
232561,12,CHL1,2012-08-25,Colo Colo,CD Cobreloa,3,1,2,W
232562,12,CHL1,2012-08-25,CD Cobresal,CD Palestino,0,1,-1,L
232563,12,CHL1,2012-08-25,Higgins,Municipal Iquique,0,1,-1,L
232564,12,CHL1,2012-08-26,Union San Felipe,Santiago Wanderers,1,0,1,W
232565,12,CHL1,2012-08-26,Antofagasta,CD Huachipato,3,0,3,W
232566,12,CHL1,2012-08-26,CSD Rangers,Audax Italiano,1,0,1,W
232567,12,CHL1,2012-08-26,Universidad Catolica,Union La Calera,1,1,0,D
232568,12,CHL1,2012-08-30,Universidad de Chile,Higgins,1,1,0,D
232569,12,CHL1,2012-09-01,Audax Italiano,CD Cobresal,1,1,0,D
232570,12,CHL1,2012-09-01,Santiago Wanderers,Universidad de Concepcion,3,1,2,W
232571,12,CHL1,2012-09-01,Municipal Iquique,Universidad Catolica,3,2,1,W
232572,12,CHL1,2012-09-01,CD Cobreloa,Antofagasta,3,1,2,W
232573,12,CHL1,2012-09-01,Universidad de Chile,Union San Felipe,2,0,2,W
232574,12,CHL1,2012-09-01,CD Huachipato,CSD Rangers,1,2,-1,L
232575,12,CHL1,2012-09-02,La Serena,Union Espanola,2,1,1,W
232576,12,CHL1,2012-09-02,Union La Calera,Higgins,0,0,0,D
232577,12,CHL1,2012-09-02,CD Palestino,Colo Colo,0,3,-3,L
232578,12,CHL1,2012-09-04,CD Cobreloa,Universidad de Chile,0,1,-1,L
232579,12,CHL1,2012-09-15,Universidad Catolica,Audax Italiano,1,0,1,W
232580,12,CHL1,2012-09-15,CSD Rangers,Universidad de Chile,2,2,0,D
232581,12,CHL1,2012-09-15,CD Cobresal,Santiago Wanderers,2,1,1,W
232582,12,CHL1,2012-09-15,Universidad de Concepcion,Municipal Iquique,0,1,-1,L
232583,12,CHL1,2012-09-15,Higgins,CD Cobreloa,1,0,1,W
232584,12,CHL1,2012-09-16,Union San Felipe,La Serena,3,0,3,W
232585,12,CHL1,2012-09-16,Antofagasta,CD Palestino,0,1,-1,L
232586,12,CHL1,2012-09-16,Colo Colo,CD Huachipato,3,0,3,W
232587,12,CHL1,2012-09-16,Union Espanola,Union La Calera,0,0,0,D
232588,12,CHL1,2012-09-22,La Serena,Municipal Iquique,2,3,-1,L
232589,12,CHL1,2012-09-22,CD Palestino,Universidad de Concepcion,1,0,1,W
232590,12,CHL1,2012-09-22,Santiago Wanderers,Universidad de Chile,2,2,0,D
232591,12,CHL1,2012-09-22,Audax Italiano,Antofagasta,1,2,-1,L
232592,12,CHL1,2012-09-22,CD Huachipato,CD Cobresal,1,1,0,D
232593,12,CHL1,2012-09-23,Union San Felipe,Higgins,1,1,0,D
232594,12,CHL1,2012-09-23,CD Cobreloa,Universidad Catolica,4,3,1,W
232595,12,CHL1,2012-09-23,Union La Calera,CSD Rangers,2,2,0,D
232596,12,CHL1,2012-09-23,Colo Colo,Union Espanola,3,0,3,W
232597,12,CHL1,2012-09-29,Higgins,CD Huachipato,2,4,-2,L
232598,12,CHL1,2012-09-29,Universidad de Chile,Union La Calera,0,0,0,D
232599,12,CHL1,2012-09-29,CD Cobresal,Antofagasta,3,1,2,W
232600,12,CHL1,2012-09-29,Universidad de Concepcion,Union San Felipe,1,1,0,D
232601,12,CHL1,2012-09-29,CSD Rangers,Union Espanola,1,0,1,W
232602,12,CHL1,2012-09-30,Audax Italiano,La Serena,3,2,1,W
232603,12,CHL1,2012-09-30,Universidad Catolica,Colo Colo,0,2,-2,L
232604,12,CHL1,2012-09-30,Municipal Iquique,CD Cobreloa,1,1,0,D
232605,12,CHL1,2012-09-30,Santiago Wanderers,CD Palestino,2,3,-1,L
232606,12,CHL1,2012-10-06,Union Espanola,Santiago Wanderers,2,2,0,D
232607,12,CHL1,2012-10-06,CD Palestino,Higgins,2,1,1,W
232608,12,CHL1,2012-10-06,CD Huachipato,Universidad de Concepcion,2,0,2,W
232609,12,CHL1,2012-10-06,La Serena,Universidad Catolica,1,3,-2,L
232610,12,CHL1,2012-10-07,Antofagasta,Universidad de Chile,2,4,-2,L
232611,12,CHL1,2012-10-07,CD Cobreloa,CD Cobresal,3,0,3,W
232612,12,CHL1,2012-10-07,Union La Calera,Municipal Iquique,1,1,0,D
232613,12,CHL1,2012-10-07,Colo Colo,CSD Rangers,2,2,0,D
232614,12,CHL1,2012-10-09,Union San Felipe,Audax Italiano,1,3,-2,L
232615,12,CHL1,2012-10-20,Universidad de Concepcion,Union Espanola,2,1,1,W
232616,12,CHL1,2012-10-20,Municipal Iquique,CD Palestino,2,1,1,W
232617,12,CHL1,2012-10-20,Universidad Catolica,CD Huachipato,0,2,-2,L
232618,12,CHL1,2012-10-21,Higgins,Santiago Wanderers,1,1,0,D
232619,12,CHL1,2012-10-21,Antofagasta,La Serena,2,1,1,W
232620,12,CHL1,2012-10-21,CSD Rangers,CD Cobresal,2,0,2,W
232621,12,CHL1,2012-10-21,Colo Colo,Universidad de Chile,1,0,1,W
232622,12,CHL1,2012-10-21,CD Cobreloa,Union San Felipe,2,1,1,W
232623,12,CHL1,2012-10-21,Audax Italiano,Union La Calera,2,1,1,W
232624,12,CHL1,2012-10-25,Santiago Wanderers,Municipal Iquique,2,1,1,W
232625,12,CHL1,2012-10-26,Union San Felipe,Colo Colo,2,1,1,W
232626,12,CHL1,2012-10-27,CD Huachipato,Audax Italiano,1,1,0,D
232627,12,CHL1,2012-10-27,CSD Rangers,Higgins,1,2,-1,L
232628,12,CHL1,2012-10-27,CD Palestino,CD Cobreloa,2,1,1,W
232629,12,CHL1,2012-10-27,CD Cobresal,Universidad Catolica,2,2,0,D
232630,12,CHL1,2012-10-27,La Serena,Union La Calera,0,1,-1,L
232631,12,CHL1,2012-10-27,Union Espanola,Antofagasta,2,1,1,W
232632,12,CHL1,2012-11-02,Universidad de Concepcion,CSD Rangers,1,0,1,W
232633,12,CHL1,2012-11-03,Antofagasta,Colo Colo,1,2,-1,L
232634,12,CHL1,2012-11-03,CD Cobresal,La Serena,2,2,0,D
232635,12,CHL1,2012-11-03,CD Palestino,Union San Felipe,1,2,-1,L
232636,12,CHL1,2012-11-03,Municipal Iquique,Union Espanola,2,4,-2,L
232637,12,CHL1,2012-11-03,Audax Italiano,Higgins,5,1,4,W
232638,12,CHL1,2012-11-04,Universidad de Chile,Universidad Catolica,0,0,0,D
232639,12,CHL1,2012-11-04,CD Cobreloa,Santiago Wanderers,2,4,-2,L
232640,12,CHL1,2012-11-04,Union La Calera,CD Huachipato,0,2,-2,L
232641,12,CHL1,2012-11-10,CD Huachipato,Universidad de Chile,0,3,-3,L
232642,12,CHL1,2012-11-10,Colo Colo,Audax Italiano,5,1,4,W
232643,12,CHL1,2012-11-10,La Serena,CD Palestino,1,1,0,D
232644,12,CHL1,2012-11-11,Universidad Catolica,Universidad de Concepcion,2,2,0,D
232645,12,CHL1,2012-11-11,Union Espanola,CD Cobreloa,2,1,1,W
232646,12,CHL1,2012-11-14,Universidad de Chile,Universidad de Concepcion,3,1,2,W
232647,12,CHL1,2012-11-14,Union San Felipe,Municipal Iquique,1,2,-1,L
232648,12,CHL1,2012-11-14,Santiago Wanderers,Union La Calera,2,0,2,W
232649,12,CHL1,2012-11-14,Higgins,CD Cobresal,1,2,-1,L
232650,12,CHL1,2012-11-14,CSD Rangers,Antofagasta,2,2,0,D
232651,13,CHL1,2013-07-27,Everton CD,CD Palestino,0,2,-2,L
232652,13,CHL1,2013-07-27,CD Huachipato,Santiago Wanderers,0,1,-1,L
232653,13,CHL1,2013-07-27,Union La Calera,CD Cobresal,1,1,0,D
232654,13,CHL1,2013-07-27,Universidad de Chile,CSD Rangers,0,1,-1,L
232655,13,CHL1,2013-07-28,Antofagasta,Union Espanola,1,0,1,W
232656,13,CHL1,2013-07-28,Audax Italiano,Colo Colo,4,0,4,W
232657,13,CHL1,2013-07-28,Municipal Iquique,Higgins,0,1,-1,L
232658,13,CHL1,2013-07-28,CD Cobreloa,Universidad de Concepcion,2,0,2,W
232659,13,CHL1,2013-07-28,Universidad Catolica,Deportivo Nublense,3,0,3,W
232660,13,CHL1,2013-08-03,Higgins,Antofagasta,2,1,1,W
232661,13,CHL1,2013-08-03,Union Espanola,Universidad Catolica,0,1,-1,L
232662,13,CHL1,2013-08-03,Santiago Wanderers,Audax Italiano,0,0,0,D
232663,13,CHL1,2013-08-03,CD Palestino,Universidad de Chile,1,1,0,D
232664,13,CHL1,2013-08-04,CSD Rangers,CD Huachipato,1,0,1,W
232665,13,CHL1,2013-08-04,CD Cobresal,Municipal Iquique,0,0,0,D
232666,13,CHL1,2013-08-04,Deportivo Nublense,CD Cobreloa,1,1,0,D
232667,13,CHL1,2013-08-04,Colo Colo,Everton CD,0,1,-1,L
232668,13,CHL1,2013-08-10,Universidad de Chile,CD Cobresal,3,0,3,W
232669,13,CHL1,2013-08-10,Universidad Catolica,Universidad de Concepcion,1,1,0,D
232670,13,CHL1,2013-08-10,CD Palestino,Santiago Wanderers,2,2,0,D
232671,13,CHL1,2013-08-10,Everton CD,CSD Rangers,3,1,2,W
232672,13,CHL1,2013-08-11,Audax Italiano,Higgins,1,1,0,D
232673,13,CHL1,2013-08-11,Antofagasta,Colo Colo,1,1,0,D
232674,13,CHL1,2013-08-11,Municipal Iquique,Union Espanola,2,1,1,W
232675,13,CHL1,2013-08-11,Union La Calera,Deportivo Nublense,2,1,1,W
232676,13,CHL1,2013-08-11,CD Huachipato,CD Cobreloa,0,0,0,D
232677,13,CHL1,2013-08-17,Higgins,Everton CD,1,1,0,D
232678,13,CHL1,2013-08-17,Union Espanola,CD Huachipato,0,2,-2,L
232679,13,CHL1,2013-08-17,Universidad de Concepcion,CD Palestino,2,0,2,W
232680,13,CHL1,2013-08-17,Universidad Catolica,Audax Italiano,1,1,0,D
232681,13,CHL1,2013-08-18,CD Cobreloa,Santiago Wanderers,2,1,1,W
232682,13,CHL1,2013-08-18,CSD Rangers,Union La Calera,2,2,0,D
232683,13,CHL1,2013-08-18,Deportivo Nublense,Universidad de Chile,2,2,0,D
232684,13,CHL1,2013-08-18,CD Cobresal,Antofagasta,2,0,2,W
232685,13,CHL1,2013-08-18,Colo Colo,Municipal Iquique,4,1,3,W
232686,13,CHL1,2013-08-24,Deportivo Nublense,Union Espanola,0,2,-2,L
232687,13,CHL1,2013-08-24,Santiago Wanderers,Higgins,0,3,-3,L
232688,13,CHL1,2013-08-24,CD Palestino,Universidad Catolica,3,6,-3,L
232689,13,CHL1,2013-08-25,Audax Italiano,CD Cobreloa,1,1,0,D
232690,13,CHL1,2013-08-25,Everton CD,Universidad de Concepcion,2,3,-1,L
232691,13,CHL1,2013-08-25,CD Huachipato,Colo Colo,0,0,0,D
232692,13,CHL1,2013-08-25,CSD Rangers,CD Cobresal,1,2,-1,L
232693,13,CHL1,2013-08-25,Municipal Iquique,Union La Calera,2,1,1,W
232694,13,CHL1,2013-08-25,Universidad de Chile,Antofagasta,5,0,5,W
232695,13,CHL1,2013-08-31,Antofagasta,Everton CD,2,0,2,W
232696,13,CHL1,2013-08-31,Universidad de Concepcion,Deportivo Nublense,2,2,0,D
232697,13,CHL1,2013-08-31,Union La Calera,Audax Italiano,1,1,0,D
232698,13,CHL1,2013-08-31,Universidad Catolica,CD Cobresal,3,0,3,W
232699,13,CHL1,2013-09-01,Higgins,CD Palestino,0,1,-1,L
232700,13,CHL1,2013-09-01,Colo Colo,Union Espanola,0,2,-2,L
232701,13,CHL1,2013-09-01,CD Cobreloa,CSD Rangers,2,1,1,W
232702,13,CHL1,2013-09-01,Municipal Iquique,CD Huachipato,1,1,0,D
232703,13,CHL1,2013-09-01,Universidad de Chile,Santiago Wanderers,2,2,0,D
232704,13,CHL1,2013-09-04,Universidad de Concepcion,Union La Calera,1,1,0,D
232705,13,CHL1,2013-09-14,Audax Italiano,Antofagasta,3,4,-1,L
232706,13,CHL1,2013-09-14,CD Palestino,Union La Calera,1,1,0,D
232707,13,CHL1,2013-09-14,CSD Rangers,Colo Colo,0,3,-3,L
232708,13,CHL1,2013-09-14,Santiago Wanderers,Municipal Iquique,0,2,-2,L
232709,13,CHL1,2013-09-14,Union Espanola,CD Cobreloa,0,1,-1,L
232710,13,CHL1,2013-09-15,Higgins,Deportivo Nublense,1,0,1,W
232711,13,CHL1,2013-09-15,Everton CD,Universidad de Chile,2,1,1,W
232712,13,CHL1,2013-09-15,CD Cobresal,Universidad de Concepcion,1,0,1,W
232713,13,CHL1,2013-09-15,CD Huachipato,Universidad Catolica,0,4,-4,L
232714,13,CHL1,2013-09-20,Everton CD,Union Espanola,1,2,-1,L
232715,13,CHL1,2013-09-21,Universidad de Concepcion,CSD Rangers,2,1,1,W
232716,13,CHL1,2013-09-21,Union La Calera,Santiago Wanderers,1,3,-2,L
232717,13,CHL1,2013-09-21,CD Cobreloa,CD Cobresal,2,0,2,W
232718,13,CHL1,2013-09-21,Colo Colo,CD Palestino,0,1,-1,L
232719,13,CHL1,2013-09-22,Universidad Catolica,Higgins,1,2,-1,L
232720,13,CHL1,2013-09-22,Antofagasta,Municipal Iquique,1,2,-1,L
232721,13,CHL1,2013-09-22,Deportivo Nublense,CD Huachipato,3,1,2,W
232722,13,CHL1,2013-09-22,Universidad de Chile,Audax Italiano,2,0,2,W
232723,13,CHL1,2013-09-28,Higgins,CD Huachipato,1,0,1,W
232724,13,CHL1,2013-09-28,CD Palestino,CD Cobreloa,2,0,2,W
232725,13,CHL1,2013-09-28,CD Cobresal,Colo Colo,3,1,2,W
232726,13,CHL1,2013-09-28,Union La Calera,Antofagasta,1,1,0,D
232727,13,CHL1,2013-09-29,Universidad de Concepcion,Audax Italiano,2,1,1,W
232728,13,CHL1,2013-09-29,Santiago Wanderers,Everton CD,3,0,3,W
232729,13,CHL1,2013-09-29,CSD Rangers,Deportivo Nublense,0,3,-3,L
232730,13,CHL1,2013-09-29,Union Espanola,Universidad de Chile,0,2,-2,L
232731,13,CHL1,2013-09-30,Municipal Iquique,Universidad Catolica,2,2,0,D
232732,13,CHL1,2013-10-05,CD Huachipato,CD Palestino,0,2,-2,L
232733,13,CHL1,2013-10-05,Deportivo Nublense,Santiago Wanderers,2,3,-1,L
232734,13,CHL1,2013-10-05,Everton CD,CD Cobresal,0,1,-1,L
232735,13,CHL1,2013-10-05,Universidad de Chile,Higgins,1,1,0,D
232736,13,CHL1,2013-10-06,Audax Italiano,Union Espanola,0,2,-2,L
232737,13,CHL1,2013-10-06,Universidad Catolica,CSD Rangers,5,1,4,W
232738,13,CHL1,2013-10-06,Antofagasta,Universidad de Concepcion,1,1,0,D
232739,13,CHL1,2013-10-06,CD Cobreloa,Municipal Iquique,2,3,-1,L
232740,13,CHL1,2013-10-06,Colo Colo,Union La Calera,2,0,2,W
232741,13,CHL1,2013-10-19,Audax Italiano,Deportivo Nublense,0,2,-2,L
232742,13,CHL1,2013-10-19,Union Espanola,CD Palestino,2,1,1,W
232743,13,CHL1,2013-10-19,Universidad de Concepcion,Higgins,0,1,-1,L
232744,13,CHL1,2013-10-19,Universidad Catolica,Santiago Wanderers,2,0,2,W
232745,13,CHL1,2013-10-20,Municipal Iquique,Universidad de Chile,0,3,-3,L
232746,13,CHL1,2013-10-20,Union La Calera,Everton CD,2,0,2,W
232747,13,CHL1,2013-10-20,Antofagasta,CSD Rangers,0,2,-2,L
232748,13,CHL1,2013-10-20,CD Cobresal,CD Huachipato,1,0,1,W
232749,13,CHL1,2013-10-20,Colo Colo,CD Cobreloa,2,1,1,W
232750,13,CHL1,2013-10-26,CD Huachipato,Audax Italiano,2,1,1,W
232751,13,CHL1,2013-10-26,CD Palestino,Antofagasta,0,1,-1,L
232752,13,CHL1,2013-10-26,Higgins,Colo Colo,2,3,-1,L
232753,13,CHL1,2013-10-26,CSD Rangers,Union Espanola,1,1,0,D
232754,13,CHL1,2013-10-27,Everton CD,Municipal Iquique,1,0,1,W
232755,13,CHL1,2013-10-27,Universidad de Chile,Universidad Catolica,0,1,-1,L
232756,13,CHL1,2013-10-27,CD Cobreloa,Union La Calera,1,0,1,W
232757,13,CHL1,2013-10-27,Santiago Wanderers,Universidad de Concepcion,2,1,1,W
232758,13,CHL1,2013-10-27,Deportivo Nublense,CD Cobresal,2,1,1,W
232759,13,CHL1,2013-11-01,Universidad de Concepcion,Colo Colo,4,1,3,W
232760,13,CHL1,2013-11-01,CSD Rangers,CD Palestino,2,3,-1,L
232761,13,CHL1,2013-11-02,CD Cobresal,Higgins,0,4,-4,L
232762,13,CHL1,2013-11-02,Union La Calera,Universidad de Chile,0,3,-3,L
232763,13,CHL1,2013-11-02,Union Espanola,Santiago Wanderers,3,1,2,W
232764,13,CHL1,2013-11-02,Audax Italiano,Everton CD,4,1,3,W
232765,13,CHL1,2013-11-03,Municipal Iquique,Deportivo Nublense,4,1,3,W
232766,13,CHL1,2013-11-03,Antofagasta,CD Huachipato,1,0,1,W
232767,13,CHL1,2013-11-03,Universidad Catolica,CD Cobreloa,2,1,1,W
232768,13,CHL1,2013-11-08,Higgins,CD Cobreloa,1,0,1,W
232769,13,CHL1,2013-11-09,CD Palestino,CD Cobresal,2,1,1,W
232770,13,CHL1,2013-11-09,Union Espanola,Union La Calera,1,0,1,W
232771,13,CHL1,2013-11-09,Santiago Wanderers,CSD Rangers,0,3,-3,L
232772,13,CHL1,2013-11-09,Everton CD,Universidad Catolica,0,2,-2,L
232773,13,CHL1,2013-11-09,CD Huachipato,Universidad de Concepcion,0,0,0,D
232774,13,CHL1,2013-11-10,Municipal Iquique,Audax Italiano,2,1,1,W
232775,13,CHL1,2013-11-10,Colo Colo,Universidad de Chile,3,2,1,W
232776,13,CHL1,2013-11-10,Deportivo Nublense,Antofagasta,2,1,1,W
232777,13,CHL1,2013-11-22,Universidad de Concepcion,Union Espanola,0,1,-1,L
232778,13,CHL1,2013-11-22,CSD Rangers,Municipal Iquique,0,0,0,D
232779,13,CHL1,2013-11-23,CD Palestino,Deportivo Nublense,3,6,-3,L
232780,13,CHL1,2013-11-23,Antofagasta,Universidad Catolica,2,0,2,W
232781,13,CHL1,2013-11-24,Union La Calera,Higgins,1,2,-1,L
232782,13,CHL1,2013-11-24,Santiago Wanderers,Colo Colo,0,0,0,D
232783,13,CHL1,2013-11-24,CD Cobreloa,Everton CD,1,2,-1,L
232784,13,CHL1,2013-11-24,CD Cobresal,Audax Italiano,3,1,2,W
232785,13,CHL1,2013-11-24,Universidad de Chile,CD Huachipato,1,0,1,W
232786,13,CHL1,2013-11-29,CD Huachipato,Union La Calera,0,1,-1,L
232787,13,CHL1,2013-11-30,Antofagasta,CD Cobreloa,0,0,0,D
232788,13,CHL1,2013-11-30,Audax Italiano,CSD Rangers,2,0,2,W
232789,13,CHL1,2013-11-30,CD Cobresal,Santiago Wanderers,1,1,0,D
232790,13,CHL1,2013-11-30,Higgins,Union Espanola,1,0,1,W
232791,13,CHL1,2013-11-30,Universidad de Chile,Universidad de Concepcion,1,1,0,D
232792,13,CHL1,2013-12-01,Municipal Iquique,CD Palestino,0,1,-1,L
232793,13,CHL1,2013-12-01,Universidad Catolica,Colo Colo,1,0,1,W
232794,13,CHL1,2013-12-01,Deportivo Nublense,Everton CD,1,0,1,W
232795,13,CHL1,2013-12-06,Everton CD,CD Huachipato,2,3,-1,L
232796,13,CHL1,2013-12-07,Union La Calera,Universidad Catolica,0,2,-2,L
232797,13,CHL1,2013-12-07,CSD Rangers,Higgins,3,4,-1,L
232798,13,CHL1,2013-12-08,Santiago Wanderers,Antofagasta,1,1,0,D
232799,13,CHL1,2013-12-08,CD Cobreloa,Universidad de Chile,2,2,0,D
232800,13,CHL1,2013-12-08,Universidad de Concepcion,Municipal Iquique,1,1,0,D
232801,13,CHL1,2013-12-08,Union Espanola,CD Cobresal,4,1,3,W
232802,13,CHL1,2013-12-08,CD Palestino,Audax Italiano,1,2,-1,L
232803,13,CHL1,2013-12-08,Colo Colo,Deportivo Nublense,2,0,2,W
232804,13,CHL1,2014-01-03,Higgins,Municipal Iquique,1,0,1,W
232805,13,CHL1,2014-01-04,Santiago Wanderers,CD Huachipato,4,2,2,W
232806,13,CHL1,2014-01-04,CD Palestino,Everton CD,4,0,4,W
232807,13,CHL1,2014-01-04,Universidad de Concepcion,CD Cobreloa,1,0,1,W
232808,13,CHL1,2014-01-04,CSD Rangers,Universidad de Chile,0,1,-1,L
232809,13,CHL1,2014-01-05,Union Espanola,Antofagasta,1,1,0,D
232810,13,CHL1,2014-01-05,Deportivo Nublense,Universidad Catolica,1,2,-1,L
232811,13,CHL1,2014-01-05,CD Cobresal,Union La Calera,1,5,-4,L
232812,13,CHL1,2014-01-05,Colo Colo,Audax Italiano,2,1,1,W
232813,13,CHL1,2014-01-09,Audax Italiano,Santiago Wanderers,2,0,2,W
232814,13,CHL1,2014-01-10,Universidad de Chile,CD Palestino,0,1,-1,L
232815,13,CHL1,2014-01-10,CD Huachipato,CSD Rangers,3,2,1,W
232816,13,CHL1,2014-01-11,Municipal Iquique,CD Cobresal,2,0,2,W
232817,13,CHL1,2014-01-11,Union La Calera,Universidad de Concepcion,0,2,-2,L
232818,13,CHL1,2014-01-11,Universidad Catolica,Union Espanola,1,0,1,W
232819,13,CHL1,2014-01-12,Antofagasta,Higgins,0,0,0,D
232820,13,CHL1,2014-01-12,CD Cobreloa,Deportivo Nublense,3,1,2,W
232821,13,CHL1,2014-01-12,Everton CD,Colo Colo,0,2,-2,L
232822,13,CHL1,2014-01-13,Santiago Wanderers,CD Palestino,2,2,0,D
232823,13,CHL1,2014-01-14,CD Cobresal,Universidad de Chile,2,1,1,W
232824,13,CHL1,2014-01-14,Universidad de Concepcion,Universidad Catolica,2,1,1,W
232825,13,CHL1,2014-01-14,Higgins,Audax Italiano,1,1,0,D
232826,13,CHL1,2014-01-15,CSD Rangers,Everton CD,3,0,3,W
232827,13,CHL1,2014-01-15,CD Cobreloa,CD Huachipato,1,1,0,D
232828,13,CHL1,2014-01-15,Union Espanola,Municipal Iquique,1,1,0,D
232829,13,CHL1,2014-01-15,Deportivo Nublense,Union La Calera,2,0,2,W
232830,13,CHL1,2014-01-16,Colo Colo,Antofagasta,1,1,0,D
232831,13,CHL1,2014-01-24,CD Palestino,Universidad de Concepcion,1,0,1,W
232832,13,CHL1,2014-01-25,CD Huachipato,Union Espanola,1,2,-1,L
232833,13,CHL1,2014-01-25,Audax Italiano,Universidad Catolica,1,1,0,D
232834,13,CHL1,2014-01-25,Antofagasta,CD Cobresal,1,0,1,W
232835,13,CHL1,2014-01-25,Union La Calera,CSD Rangers,3,1,2,W
232836,13,CHL1,2014-01-26,Municipal Iquique,Colo Colo,2,5,-3,L
232837,13,CHL1,2014-01-26,Everton CD,Higgins,0,2,-2,L
232838,13,CHL1,2014-01-26,Universidad de Chile,Deportivo Nublense,5,0,5,W
232839,13,CHL1,2014-01-27,Santiago Wanderers,CD Cobreloa,2,2,0,D
232840,13,CHL1,2014-01-31,Universidad de Concepcion,Everton CD,2,3,-1,L
232841,13,CHL1,2014-02-01,Universidad Catolica,CD Palestino,5,3,2,W
232842,13,CHL1,2014-02-01,Higgins,Santiago Wanderers,2,0,2,W
232843,13,CHL1,2014-02-01,Union La Calera,Municipal Iquique,0,2,-2,L
232844,13,CHL1,2014-02-02,Union Espanola,Deportivo Nublense,3,2,1,W
232845,13,CHL1,2014-02-02,CD Cobreloa,Audax Italiano,2,0,2,W
232846,13,CHL1,2014-02-02,CD Cobresal,CSD Rangers,2,2,0,D
232847,13,CHL1,2014-02-02,Antofagasta,Universidad de Chile,1,3,-2,L
232848,13,CHL1,2014-02-02,Colo Colo,CD Huachipato,5,3,2,W
232849,13,CHL1,2014-02-07,CSD Rangers,CD Cobreloa,2,1,1,W
232850,13,CHL1,2014-02-08,Audax Italiano,Union La Calera,0,1,-1,L
232851,13,CHL1,2014-02-08,CD Cobresal,Universidad Catolica,0,1,-1,L
232852,13,CHL1,2014-02-08,CD Palestino,Higgins,1,1,0,D
232853,13,CHL1,2014-02-09,Everton CD,Antofagasta,1,1,0,D
232854,13,CHL1,2014-02-09,Santiago Wanderers,Universidad de Chile,2,1,1,W
232855,13,CHL1,2014-02-09,CD Huachipato,Municipal Iquique,0,1,-1,L
232856,13,CHL1,2014-02-09,Deportivo Nublense,Universidad de Concepcion,3,1,2,W
232857,13,CHL1,2014-02-09,Union Espanola,Colo Colo,1,4,-3,L
232858,13,CHL1,2014-02-14,CD Cobreloa,Union Espanola,1,1,0,D
232859,13,CHL1,2014-02-14,Colo Colo,CSD Rangers,3,1,2,W
232860,13,CHL1,2014-02-15,Universidad de Concepcion,CD Cobresal,1,1,0,D
232861,13,CHL1,2014-02-15,Union La Calera,CD Palestino,2,3,-1,L
232862,13,CHL1,2014-02-15,Universidad Catolica,CD Huachipato,7,1,6,W
232863,13,CHL1,2014-02-16,Municipal Iquique,Santiago Wanderers,3,1,2,W
232864,13,CHL1,2014-02-16,Antofagasta,Audax Italiano,0,1,-1,L
232865,13,CHL1,2014-02-16,Deportivo Nublense,Higgins,0,2,-2,L
232866,13,CHL1,2014-02-16,Universidad de Chile,Everton CD,2,1,1,W
232867,13,CHL1,2014-02-21,Audax Italiano,Universidad de Chile,3,3,0,D
232868,13,CHL1,2014-02-22,CD Huachipato,Deportivo Nublense,1,0,1,W
232869,13,CHL1,2014-02-22,CSD Rangers,Universidad de Concepcion,0,0,0,D
232870,13,CHL1,2014-02-22,Higgins,Universidad Catolica,2,0,2,W
232871,13,CHL1,2014-02-23,Union Espanola,Everton CD,1,3,-2,L
232872,13,CHL1,2014-02-23,Municipal Iquique,Antofagasta,3,2,1,W
232873,13,CHL1,2014-02-23,CD Cobresal,CD Cobreloa,3,0,3,W
232874,13,CHL1,2014-02-23,Santiago Wanderers,Union La Calera,1,0,1,W
232875,13,CHL1,2014-02-23,CD Palestino,Colo Colo,1,2,-1,L
232876,13,CHL1,2014-02-27,Universidad Catolica,Municipal Iquique,1,0,1,W
232877,13,CHL1,2014-02-28,Colo Colo,CD Cobresal,3,2,1,W
232878,13,CHL1,2014-03-01,Universidad de Chile,Union Espanola,3,3,0,D
232879,13,CHL1,2014-03-01,Antofagasta,Union La Calera,2,3,-1,L
232880,13,CHL1,2014-03-01,CD Huachipato,Higgins,1,0,1,W
232881,13,CHL1,2014-03-02,Audax Italiano,Universidad de Concepcion,2,2,0,D
232882,13,CHL1,2014-03-02,CD Cobreloa,CD Palestino,0,1,-1,L
232883,13,CHL1,2014-03-02,Everton CD,Santiago Wanderers,2,1,1,W
232884,13,CHL1,2014-03-02,Deportivo Nublense,CSD Rangers,1,0,1,W
232885,13,CHL1,2014-03-06,CD Palestino,CD Huachipato,2,1,1,W
232886,13,CHL1,2014-03-06,Santiago Wanderers,Deportivo Nublense,1,1,0,D
232887,13,CHL1,2014-03-06,Union Espanola,Audax Italiano,3,2,1,W
232888,13,CHL1,2014-03-08,Universidad de Concepcion,Antofagasta,1,1,0,D
232889,13,CHL1,2014-03-08,Higgins,Universidad de Chile,1,0,1,W
232890,13,CHL1,2014-03-09,Municipal Iquique,CD Cobreloa,5,2,3,W
232891,13,CHL1,2014-03-09,Union La Calera,Colo Colo,1,5,-4,L
232892,13,CHL1,2014-03-09,CD Cobresal,Everton CD,2,0,2,W
232893,13,CHL1,2014-03-09,CSD Rangers,Universidad Catolica,0,2,-2,L
232894,13,CHL1,2014-03-14,CD Huachipato,CD Cobresal,1,0,1,W
232895,13,CHL1,2014-03-15,CD Cobreloa,Colo Colo,0,0,0,D
232896,13,CHL1,2014-03-15,Universidad de Chile,Municipal Iquique,3,1,2,W
232897,13,CHL1,2014-03-16,Deportivo Nublense,Audax Italiano,2,1,1,W
232898,13,CHL1,2014-03-16,CSD Rangers,Antofagasta,1,3,-2,L
232899,13,CHL1,2014-03-16,Higgins,Universidad de Concepcion,0,0,0,D
232900,13,CHL1,2014-03-17,Santiago Wanderers,Universidad Catolica,0,2,-2,L
232901,13,CHL1,2014-03-18,Everton CD,Union La Calera,1,0,1,W
232902,13,CHL1,2014-03-21,Audax Italiano,CD Huachipato,0,0,0,D
232903,13,CHL1,2014-03-22,Universidad de Concepcion,Santiago Wanderers,2,1,1,W
232904,13,CHL1,2014-03-22,Antofagasta,CD Palestino,2,1,1,W
232905,13,CHL1,2014-03-23,Universidad Catolica,Universidad de Chile,0,3,-3,L
232906,13,CHL1,2014-03-23,Union Espanola,CSD Rangers,4,0,4,W
232907,13,CHL1,2014-03-23,CD Cobresal,Deportivo Nublense,2,1,1,W
232908,13,CHL1,2014-03-23,Union La Calera,CD Cobreloa,0,1,-1,L
232909,13,CHL1,2014-03-23,Colo Colo,Higgins,3,0,3,W
232910,13,CHL1,2014-03-24,Municipal Iquique,Everton CD,2,0,2,W
232911,13,CHL1,2014-03-26,CD Palestino,Union Espanola,1,2,-1,L
232912,13,CHL1,2014-03-29,Universidad de Chile,Union La Calera,0,1,-1,L
232913,13,CHL1,2014-03-29,CD Palestino,CSD Rangers,0,0,0,D
232914,13,CHL1,2014-03-29,CD Cobreloa,Universidad Catolica,2,1,1,W
232915,13,CHL1,2014-03-29,Santiago Wanderers,Union Espanola,4,0,4,W
232916,13,CHL1,2014-03-30,Deportivo Nublense,Municipal Iquique,3,0,3,W
232917,13,CHL1,2014-03-30,CD Huachipato,Antofagasta,4,1,3,W
232918,13,CHL1,2014-03-30,Higgins,CD Cobresal,3,2,1,W
232919,13,CHL1,2014-03-30,Colo Colo,Universidad de Concepcion,1,2,-1,L
232920,13,CHL1,2014-04-01,Everton CD,Audax Italiano,1,1,0,D
232921,13,CHL1,2014-04-05,Antofagasta,Deportivo Nublense,1,0,1,W
232922,13,CHL1,2014-04-05,CD Cobreloa,Higgins,2,1,1,W
232923,13,CHL1,2014-04-05,CSD Rangers,Santiago Wanderers,1,0,1,W
232924,13,CHL1,2014-04-05,Universidad de Concepcion,CD Huachipato,1,1,0,D
232925,13,CHL1,2014-04-05,Universidad Catolica,Everton CD,3,1,2,W
232926,13,CHL1,2014-04-06,Universidad de Chile,Colo Colo,0,1,-1,L
232927,13,CHL1,2014-04-06,CD Cobresal,CD Palestino,1,1,0,D
232928,13,CHL1,2014-04-06,Union La Calera,Union Espanola,4,0,4,W
232929,13,CHL1,2014-04-07,Audax Italiano,Municipal Iquique,3,0,3,W
232930,13,CHL1,2014-04-11,Municipal Iquique,CSD Rangers,0,1,-1,L
232931,13,CHL1,2014-04-12,Audax Italiano,CD Cobresal,1,3,-2,L
232932,13,CHL1,2014-04-12,Union Espanola,Universidad de Concepcion,2,1,1,W
232933,13,CHL1,2014-04-12,Everton CD,CD Cobreloa,2,0,2,W
232934,13,CHL1,2014-04-12,Universidad Catolica,Antofagasta,2,0,2,W
232935,13,CHL1,2014-04-13,Higgins,Union La Calera,0,0,0,D
232936,13,CHL1,2014-04-13,Colo Colo,Santiago Wanderers,1,0,1,W
232937,13,CHL1,2014-04-13,CD Huachipato,Universidad de Chile,5,2,3,W
232938,13,CHL1,2014-04-13,Deportivo Nublense,CD Palestino,0,2,-2,L
232939,13,CHL1,2014-04-19,CD Palestino,Municipal Iquique,0,1,-1,L
232940,13,CHL1,2014-04-19,CSD Rangers,Audax Italiano,0,2,-2,L
232941,13,CHL1,2014-04-19,Universidad de Concepcion,Universidad de Chile,1,0,1,W
232942,13,CHL1,2014-04-19,Union Espanola,Higgins,1,3,-2,L
232943,13,CHL1,2014-04-20,Union La Calera,CD Huachipato,0,6,-6,L
232944,13,CHL1,2014-04-20,Colo Colo,Universidad Catolica,2,2,0,D
232945,13,CHL1,2014-04-20,CD Cobreloa,Antofagasta,0,1,-1,L
232946,13,CHL1,2014-04-20,Everton CD,Deportivo Nublense,1,1,0,D
232947,13,CHL1,2014-04-22,Santiago Wanderers,CD Cobresal,2,0,2,W
232948,13,CHL1,2014-04-26,Higgins,CSD Rangers,1,1,0,D
232949,13,CHL1,2014-04-26,CD Huachipato,Everton CD,0,0,0,D
232950,13,CHL1,2014-04-26,Universidad Catolica,Union La Calera,1,1,0,D
232951,13,CHL1,2014-04-26,Audax Italiano,CD Palestino,1,1,0,D
232952,13,CHL1,2014-04-26,Municipal Iquique,Universidad de Concepcion,0,1,-1,L
232953,13,CHL1,2014-04-26,Antofagasta,Santiago Wanderers,1,1,0,D
232954,13,CHL1,2014-04-27,CD Cobresal,Union Espanola,2,0,2,W
232955,13,CHL1,2014-04-27,Deportivo Nublense,Colo Colo,3,5,-2,L
232956,13,CHL1,2014-04-27,Universidad de Chile,CD Cobreloa,0,4,-4,L
232957,14,CHL1,2014-07-19,San Marcos de Arica,Colo Colo,1,1,0,D
232958,14,CHL1,2014-07-19,Universidad Catolica,Antofagasta,1,0,1,W
232959,14,CHL1,2014-07-19,Santiago Wanderers,AC Barnechea,3,0,3,W
232960,14,CHL1,2014-07-20,Audax Italiano,Union Espanola,0,1,-1,L
232961,14,CHL1,2014-07-20,CD Palestino,CD Cobreloa,1,2,-1,L
232962,14,CHL1,2014-07-20,Union La Calera,Higgins,1,2,-1,L
232963,14,CHL1,2014-07-20,CD Huachipato,Deportivo Nublense,3,0,3,W
232964,14,CHL1,2014-07-20,Municipal Iquique,Universidad de Concepcion,1,1,0,D
232965,14,CHL1,2014-07-20,Universidad de Chile,CD Cobresal,3,1,2,W
232966,14,CHL1,2014-07-26,Antofagasta,Audax Italiano,0,0,0,D
232967,14,CHL1,2014-07-26,Universidad de Concepcion,CD Huachipato,0,1,-1,L
232968,14,CHL1,2014-07-26,Higgins,Universidad de Chile,1,3,-2,L
232969,14,CHL1,2014-07-26,AC Barnechea,Union La Calera,0,3,-3,L
232970,14,CHL1,2014-07-27,Union Espanola,Universidad Catolica,1,0,1,W
232971,14,CHL1,2014-07-27,Deportivo Nublense,San Marcos de Arica,2,1,1,W
232972,14,CHL1,2014-07-27,CD Cobreloa,Santiago Wanderers,1,2,-1,L
232973,14,CHL1,2014-07-27,CD Cobresal,CD Palestino,0,1,-1,L
232974,14,CHL1,2014-07-27,Colo Colo,Municipal Iquique,2,0,2,W
232975,14,CHL1,2014-08-02,Union La Calera,Antofagasta,3,1,2,W
232976,14,CHL1,2014-08-02,CD Palestino,Deportivo Nublense,2,2,0,D
232977,14,CHL1,2014-08-02,Universidad de Chile,Santiago Wanderers,3,2,1,W
232978,14,CHL1,2014-08-02,Universidad Catolica,CD Cobreloa,5,1,4,W
232979,14,CHL1,2014-08-03,Higgins,Universidad de Concepcion,2,2,0,D
232980,14,CHL1,2014-08-03,San Marcos de Arica,Union Espanola,2,1,1,W
232981,14,CHL1,2014-08-03,CD Huachipato,Colo Colo,1,3,-2,L
232982,14,CHL1,2014-08-03,Municipal Iquique,CD Cobresal,2,2,0,D
232983,14,CHL1,2014-08-03,Audax Italiano,AC Barnechea,3,1,2,W
232984,14,CHL1,2014-08-09,Union Espanola,Union La Calera,2,0,2,W
232985,14,CHL1,2014-08-09,CD Palestino,Audax Italiano,1,0,1,W
232986,14,CHL1,2014-08-09,Deportivo Nublense,Universidad Catolica,2,1,1,W
232987,14,CHL1,2014-08-09,Antofagasta,Universidad de Chile,0,3,-3,L
232988,14,CHL1,2014-08-10,Santiago Wanderers,Municipal Iquique,2,0,2,W
232989,14,CHL1,2014-08-10,Colo Colo,Higgins,2,3,-1,L
232990,14,CHL1,2014-08-10,CD Cobreloa,Universidad de Concepcion,0,2,-2,L
232991,14,CHL1,2014-08-10,CD Cobresal,CD Huachipato,2,2,0,D
232992,14,CHL1,2014-08-10,AC Barnechea,San Marcos de Arica,1,0,1,W
232993,14,CHL1,2014-08-15,Municipal Iquique,Universidad de Chile,2,2,0,D
232994,14,CHL1,2014-08-16,CD Huachipato,CD Palestino,2,0,2,W
232995,14,CHL1,2014-08-16,Audax Italiano,CD Cobresal,2,2,0,D
232996,14,CHL1,2014-08-16,Universidad de Concepcion,AC Barnechea,3,2,1,W
232997,14,CHL1,2014-08-16,Union La Calera,Deportivo Nublense,3,2,1,W
232998,14,CHL1,2014-08-16,Higgins,CD Cobreloa,4,1,3,W
232999,14,CHL1,2014-08-17,San Marcos de Arica,Antofagasta,1,0,1,W
233000,14,CHL1,2014-08-17,Colo Colo,Union Espanola,2,0,2,W
233001,14,CHL1,2014-08-17,Universidad Catolica,Santiago Wanderers,0,1,-1,L
233002,14,CHL1,2014-08-23,Santiago Wanderers,Audax Italiano,2,2,0,D
233003,14,CHL1,2014-08-23,Universidad de Chile,CD Huachipato,2,1,1,W
233004,14,CHL1,2014-08-23,Deportivo Nublense,Higgins,1,1,0,D
233005,14,CHL1,2014-08-23,Union Espanola,Universidad de Concepcion,0,0,0,D
233006,14,CHL1,2014-08-24,Antofagasta,Municipal Iquique,1,0,1,W
233007,14,CHL1,2014-08-24,AC Barnechea,Colo Colo,0,3,-3,L
233008,14,CHL1,2014-08-24,CD Cobresal,San Marcos de Arica,0,0,0,D
233009,14,CHL1,2014-08-24,CD Cobreloa,Union La Calera,1,1,0,D
233010,14,CHL1,2014-08-24,CD Palestino,Universidad Catolica,2,1,1,W
233011,14,CHL1,2014-08-29,Union Espanola,Universidad de Chile,0,1,-1,L
233012,14,CHL1,2014-08-30,San Marcos de Arica,CD Palestino,1,0,1,W
233013,14,CHL1,2014-08-30,Colo Colo,Antofagasta,4,0,4,W
233014,14,CHL1,2014-08-30,CD Huachipato,Santiago Wanderers,4,0,4,W
233015,14,CHL1,2014-08-31,Universidad Catolica,Higgins,2,2,0,D
233016,14,CHL1,2014-08-31,Universidad de Concepcion,Union La Calera,1,1,0,D
233017,14,CHL1,2014-08-31,CD Cobresal,CD Cobreloa,2,1,1,W
233018,14,CHL1,2014-08-31,Municipal Iquique,AC Barnechea,1,0,1,W
233019,14,CHL1,2014-08-31,Audax Italiano,Deportivo Nublense,0,1,-1,L
233020,14,CHL1,2014-09-13,Union La Calera,Municipal Iquique,1,1,0,D
233021,14,CHL1,2014-09-13,Santiago Wanderers,CD Cobresal,4,1,3,W
233022,14,CHL1,2014-09-13,Universidad Catolica,San Marcos de Arica,2,0,2,W
233023,14,CHL1,2014-09-13,Higgins,Union Espanola,1,3,-2,L
233024,14,CHL1,2014-09-14,CD Palestino,Colo Colo,1,3,-2,L
233025,14,CHL1,2014-09-14,CD Cobreloa,Audax Italiano,0,1,-1,L
233026,14,CHL1,2014-09-14,Deportivo Nublense,AC Barnechea,0,1,-1,L
233027,14,CHL1,2014-09-14,Antofagasta,CD Huachipato,2,2,0,D
233028,14,CHL1,2014-09-14,Universidad de Chile,Universidad de Concepcion,1,0,1,W
233029,14,CHL1,2014-09-27,Universidad de Concepcion,Santiago Wanderers,1,3,-2,L
233030,14,CHL1,2014-09-27,Audax Italiano,Universidad de Chile,2,3,-1,L
233031,14,CHL1,2014-09-27,AC Barnechea,Higgins,1,2,-1,L
233032,14,CHL1,2014-09-28,Union Espanola,Antofagasta,1,0,1,W
233033,14,CHL1,2014-09-28,San Marcos de Arica,CD Cobreloa,0,1,-1,L
233034,14,CHL1,2014-09-28,CD Cobresal,Universidad Catolica,0,1,-1,L
233035,14,CHL1,2014-09-28,Municipal Iquique,CD Palestino,2,4,-2,L
233036,14,CHL1,2014-09-28,Colo Colo,Deportivo Nublense,0,0,0,D
233037,14,CHL1,2014-10-04,Audax Italiano,Municipal Iquique,2,1,1,W
233038,14,CHL1,2014-10-04,Union La Calera,CD Cobresal,2,1,1,W
233039,14,CHL1,2014-10-04,Higgins,CD Palestino,0,1,-1,L
233040,14,CHL1,2014-10-04,Universidad Catolica,CD Huachipato,0,3,-3,L
233041,14,CHL1,2014-10-05,Universidad de Concepcion,Colo Colo,0,1,-1,L
233042,14,CHL1,2014-10-05,CD Cobreloa,AC Barnechea,1,2,-1,L
233043,14,CHL1,2014-10-05,Antofagasta,Deportivo Nublense,2,0,2,W
233044,14,CHL1,2014-10-05,Universidad de Chile,San Marcos de Arica,2,0,2,W
233045,14,CHL1,2014-10-11,CD Huachipato,Union La Calera,0,4,-4,L
233046,14,CHL1,2014-10-12,Santiago Wanderers,Union Espanola,1,0,1,W
233047,14,CHL1,2014-10-18,CD Palestino,Santiago Wanderers,0,1,-1,L
233048,14,CHL1,2014-10-18,Deportivo Nublense,Universidad de Concepcion,2,1,1,W
233049,14,CHL1,2014-10-18,AC Barnechea,Universidad Catolica,1,0,1,W
233050,14,CHL1,2014-10-19,Municipal Iquique,Higgins,0,0,0,D
233051,14,CHL1,2014-10-19,San Marcos de Arica,Union La Calera,2,1,1,W
233052,14,CHL1,2014-10-19,Colo Colo,Universidad de Chile,2,0,2,W
233053,14,CHL1,2014-10-19,CD Cobresal,Antofagasta,1,1,0,D
233054,14,CHL1,2014-10-19,Union Espanola,CD Cobreloa,2,1,1,W
233055,14,CHL1,2014-10-21,CD Huachipato,Audax Italiano,1,2,-1,L
233056,14,CHL1,2014-10-25,Deportivo Nublense,Union Espanola,3,1,2,W
233057,14,CHL1,2014-10-25,Universidad de Concepcion,CD Cobresal,3,2,1,W
233058,14,CHL1,2014-10-25,Santiago Wanderers,San Marcos de Arica,2,1,1,W
233059,14,CHL1,2014-10-25,Universidad Catolica,Audax Italiano,2,1,1,W
233060,14,CHL1,2014-10-26,Higgins,CD Huachipato,3,0,3,W
233061,14,CHL1,2014-10-26,Union La Calera,Colo Colo,0,2,-2,L
233062,14,CHL1,2014-10-26,CD Cobreloa,Municipal Iquique,3,3,0,D
233063,14,CHL1,2014-10-26,Antofagasta,AC Barnechea,1,1,0,D
233064,14,CHL1,2014-10-26,Universidad de Chile,CD Palestino,2,1,1,W
233065,14,CHL1,2014-10-31,Santiago Wanderers,Higgins,1,0,1,W
233066,14,CHL1,2014-11-01,Universidad de Chile,Universidad Catolica,3,0,3,W
233067,14,CHL1,2014-11-01,CD Palestino,Antofagasta,3,1,2,W
233068,14,CHL1,2014-11-01,CD Huachipato,CD Cobreloa,2,0,2,W
233069,14,CHL1,2014-11-01,AC Barnechea,Union Espanola,1,0,1,W
233070,14,CHL1,2014-11-02,San Marcos de Arica,Universidad de Concepcion,0,0,0,D
233071,14,CHL1,2014-11-02,CD Cobresal,Colo Colo,0,1,-1,L
233072,14,CHL1,2014-11-02,Municipal Iquique,Deportivo Nublense,1,1,0,D
233073,14,CHL1,2014-11-02,Audax Italiano,Union La Calera,2,2,0,D
233074,14,CHL1,2014-11-07,Higgins,San Marcos de Arica,3,1,2,W
233075,14,CHL1,2014-11-08,Union Espanola,Municipal Iquique,2,5,-3,L
233076,14,CHL1,2014-11-08,CD Cobreloa,Universidad de Chile,0,4,-4,L
233077,14,CHL1,2014-11-08,Union La Calera,Universidad Catolica,1,0,1,W
233078,14,CHL1,2014-11-08,AC Barnechea,CD Huachipato,3,0,3,W
233079,14,CHL1,2014-11-09,Antofagasta,Santiago Wanderers,0,2,-2,L
233080,14,CHL1,2014-11-09,Universidad de Concepcion,CD Palestino,0,1,-1,L
233081,14,CHL1,2014-11-09,Deportivo Nublense,CD Cobresal,2,3,-1,L
233082,14,CHL1,2014-11-09,Colo Colo,Audax Italiano,2,1,1,W
233083,14,CHL1,2014-11-21,Antofagasta,CD Cobreloa,2,1,1,W
233084,14,CHL1,2014-11-22,CD Huachipato,Union Espanola,1,3,-2,L
233085,14,CHL1,2014-11-22,Universidad de Chile,AC Barnechea,1,1,0,D
233086,14,CHL1,2014-11-22,San Marcos de Arica,Municipal Iquique,1,0,1,W
233087,14,CHL1,2014-11-22,Santiago Wanderers,Deportivo Nublense,2,1,1,W
233088,14,CHL1,2014-11-23,Universidad Catolica,Colo Colo,1,2,-1,L
233089,14,CHL1,2014-11-23,CD Palestino,Union La Calera,3,2,1,W
233090,14,CHL1,2014-11-23,CD Cobresal,Higgins,3,1,2,W
233091,14,CHL1,2014-11-23,Audax Italiano,Universidad de Concepcion,4,1,3,W
233092,14,CHL1,2014-11-28,Higgins,Audax Italiano,1,1,0,D
233093,14,CHL1,2014-11-30,Municipal Iquique,Universidad Catolica,3,2,1,W
233094,14,CHL1,2014-11-30,San Marcos de Arica,CD Huachipato,1,2,-1,L
233095,14,CHL1,2014-11-30,Universidad de Concepcion,Antofagasta,1,0,1,W
233096,14,CHL1,2014-11-30,Deportivo Nublense,Universidad de Chile,0,3,-3,L
233097,14,CHL1,2014-11-30,Colo Colo,CD Cobreloa,4,1,3,W
233098,14,CHL1,2014-11-30,Union La Calera,Santiago Wanderers,0,1,-1,L
233099,14,CHL1,2014-12-01,AC Barnechea,CD Cobresal,1,3,-2,L
233100,14,CHL1,2014-12-02,Union Espanola,CD Palestino,2,5,-3,L
233101,14,CHL1,2014-12-05,CD Cobreloa,Deportivo Nublense,4,2,2,W
233102,14,CHL1,2014-12-05,Universidad Catolica,Universidad de Concepcion,2,2,0,D
233103,14,CHL1,2014-12-06,Santiago Wanderers,Colo Colo,2,0,2,W
233104,14,CHL1,2014-12-06,Universidad de Chile,Union La Calera,1,0,1,W
233105,14,CHL1,2014-12-07,CD Huachipato,Municipal Iquique,5,0,5,W
233106,14,CHL1,2014-12-07,CD Cobresal,Union Espanola,1,3,-2,L
233107,14,CHL1,2014-12-07,CD Palestino,AC Barnechea,2,0,2,W
233108,14,CHL1,2014-12-07,Antofagasta,Higgins,2,1,1,W
233109,14,CHL1,2014-12-07,Audax Italiano,San Marcos de Arica,3,0,3,W
233110,14,CHL1,2015-01-02,Higgins,Union La Calera,2,1,1,W
233111,14,CHL1,2015-01-03,CD Cobresal,Universidad de Chile,1,1,0,D
233112,14,CHL1,2015-01-03,Deportivo Nublense,CD Huachipato,3,1,2,W
233113,14,CHL1,2015-01-04,Antofagasta,Universidad Catolica,2,3,-1,L
233114,14,CHL1,2015-01-04,Universidad de Concepcion,Municipal Iquique,3,1,2,W
233115,14,CHL1,2015-01-04,Colo Colo,San Marcos de Arica,0,1,-1,L
233116,14,CHL1,2015-01-05,Union Espanola,Audax Italiano,0,2,-2,L
233117,14,CHL1,2015-01-07,CD Cobreloa,CD Palestino,3,0,3,W
233118,14,CHL1,2015-01-07,AC Barnechea,Santiago Wanderers,0,2,-2,L
233119,14,CHL1,2015-01-09,CD Huachipato,Universidad de Concepcion,1,2,-1,L
233120,14,CHL1,2015-01-10,Audax Italiano,Antofagasta,1,1,0,D
233121,14,CHL1,2015-01-10,Universidad de Chile,Higgins,3,0,3,W
233122,14,CHL1,2015-01-10,Union La Calera,AC Barnechea,3,0,3,W
233123,14,CHL1,2015-01-11,San Marcos de Arica,Deportivo Nublense,0,0,0,D
233124,14,CHL1,2015-01-11,Municipal Iquique,Colo Colo,3,2,1,W
233125,14,CHL1,2015-01-11,CD Palestino,CD Cobresal,0,1,-1,L
233126,14,CHL1,2015-01-11,Universidad Catolica,Union Espanola,0,0,0,D
233127,14,CHL1,2015-01-12,Santiago Wanderers,CD Cobreloa,0,1,-1,L
233128,14,CHL1,2015-01-16,CD Cobreloa,Universidad Catolica,1,3,-2,L
233129,14,CHL1,2015-01-17,Universidad de Concepcion,Higgins,2,1,1,W
233130,14,CHL1,2015-01-17,Santiago Wanderers,Universidad de Chile,3,2,1,W
233131,14,CHL1,2015-01-18,Union Espanola,San Marcos de Arica,1,2,-1,L
233132,14,CHL1,2015-01-18,CD Cobresal,Municipal Iquique,4,2,2,W
233133,14,CHL1,2015-01-18,Deportivo Nublense,CD Palestino,0,3,-3,L
233134,14,CHL1,2015-01-18,Antofagasta,Union La Calera,3,4,-1,L
233135,14,CHL1,2015-01-18,Colo Colo,CD Huachipato,2,2,0,D
233136,14,CHL1,2015-01-20,AC Barnechea,Audax Italiano,0,0,0,D
233137,14,CHL1,2015-01-30,CD Huachipato,CD Cobresal,2,1,1,W
233138,14,CHL1,2015-01-31,Municipal Iquique,Santiago Wanderers,2,1,1,W
233139,14,CHL1,2015-01-31,Union La Calera,Union Espanola,2,0,2,W
233140,14,CHL1,2015-01-31,Universidad de Concepcion,CD Cobreloa,3,2,1,W
233141,14,CHL1,2015-01-31,Universidad de Chile,Antofagasta,1,3,-2,L
233142,14,CHL1,2015-02-01,Audax Italiano,CD Palestino,1,2,-1,L
233143,14,CHL1,2015-02-01,San Marcos de Arica,AC Barnechea,0,0,0,D
233144,14,CHL1,2015-02-01,Higgins,Colo Colo,0,2,-2,L
233145,14,CHL1,2015-02-01,Universidad Catolica,Deportivo Nublense,2,1,1,W
233146,14,CHL1,2015-02-03,Universidad de Chile,Municipal Iquique,2,3,-1,L
233147,14,CHL1,2015-02-04,AC Barnechea,Universidad de Concepcion,1,2,-1,L
233148,14,CHL1,2015-02-04,CD Cobresal,Audax Italiano,3,1,2,W
233149,14,CHL1,2015-02-04,Antofagasta,San Marcos de Arica,0,2,-2,L
233150,14,CHL1,2015-02-04,Union Espanola,Colo Colo,1,3,-2,L
233151,14,CHL1,2015-02-04,Santiago Wanderers,Universidad Catolica,2,0,2,W
233152,14,CHL1,2015-02-05,CD Cobreloa,Higgins,0,0,0,D
233153,14,CHL1,2015-02-05,Deportivo Nublense,Union La Calera,1,2,-1,L
233154,14,CHL1,2015-02-07,CD Huachipato,Universidad de Chile,2,2,0,D
233155,14,CHL1,2015-02-07,Colo Colo,AC Barnechea,4,1,3,W
233156,14,CHL1,2015-02-08,Audax Italiano,Santiago Wanderers,2,1,1,W
233157,14,CHL1,2015-02-08,San Marcos de Arica,CD Cobresal,1,1,0,D
233158,14,CHL1,2015-02-08,Universidad de Concepcion,Union Espanola,1,2,-1,L
233159,14,CHL1,2015-02-08,Municipal Iquique,Antofagasta,1,2,-1,L
233160,14,CHL1,2015-02-08,Union La Calera,CD Cobreloa,0,0,0,D
233161,14,CHL1,2015-02-08,Universidad Catolica,CD Palestino,3,2,1,W
233162,14,CHL1,2015-02-09,Higgins,Deportivo Nublense,1,0,1,W
233163,14,CHL1,2015-02-13,AC Barnechea,Municipal Iquique,1,0,1,W
233164,14,CHL1,2015-02-14,Universidad de Chile,Union Espanola,1,2,-1,L
233165,14,CHL1,2015-02-14,Antofagasta,Colo Colo,1,2,-1,L
233166,14,CHL1,2015-02-14,Union La Calera,Universidad de Concepcion,2,0,2,W
233167,14,CHL1,2015-02-15,CD Cobreloa,CD Cobresal,1,3,-2,L
233168,14,CHL1,2015-02-15,Deportivo Nublense,Audax Italiano,1,0,1,W
233169,14,CHL1,2015-02-15,Higgins,Universidad Catolica,1,1,0,D
233170,14,CHL1,2015-02-15,CD Palestino,San Marcos de Arica,0,4,-4,L
233171,14,CHL1,2015-02-16,Santiago Wanderers,CD Huachipato,0,1,-1,L
233172,14,CHL1,2015-02-21,AC Barnechea,Deportivo Nublense,1,3,-2,L
233173,14,CHL1,2015-02-21,San Marcos de Arica,Universidad Catolica,3,3,0,D
233174,14,CHL1,2015-02-21,CD Huachipato,Antofagasta,2,0,2,W
233175,14,CHL1,2015-02-22,Union Espanola,Higgins,1,2,-1,L
233176,14,CHL1,2015-02-22,Universidad de Concepcion,Universidad de Chile,1,2,-1,L
233177,14,CHL1,2015-02-22,CD Cobresal,Santiago Wanderers,1,0,1,W
233178,14,CHL1,2015-02-22,Colo Colo,CD Palestino,1,1,0,D
233179,14,CHL1,2015-02-23,Audax Italiano,CD Cobreloa,1,0,1,W
233180,14,CHL1,2015-02-23,Municipal Iquique,Union La Calera,2,1,1,W
233181,14,CHL1,2015-02-27,Santiago Wanderers,Universidad de Concepcion,0,0,0,D
233182,14,CHL1,2015-02-28,Higgins,AC Barnechea,3,1,2,W
233183,14,CHL1,2015-02-28,Universidad Catolica,CD Cobresal,2,4,-2,L
233184,14,CHL1,2015-03-01,CD Palestino,Municipal Iquique,2,2,0,D
233185,14,CHL1,2015-03-01,CD Cobreloa,San Marcos de Arica,1,0,1,W
233186,14,CHL1,2015-03-01,Deportivo Nublense,Colo Colo,0,1,-1,L
233187,14,CHL1,2015-03-01,Antofagasta,Union Espanola,1,2,-1,L
233188,14,CHL1,2015-03-01,Union La Calera,CD Huachipato,0,1,-1,L
233189,14,CHL1,2015-03-02,Universidad de Chile,Audax Italiano,2,3,-1,L
233190,14,CHL1,2015-03-06,Union Espanola,Santiago Wanderers,2,2,0,D
233191,14,CHL1,2015-03-07,AC Barnechea,CD Cobreloa,0,1,-1,L
233192,14,CHL1,2015-03-07,CD Palestino,Higgins,3,3,0,D
233193,14,CHL1,2015-03-07,CD Huachipato,Universidad Catolica,3,5,-2,L
233194,14,CHL1,2015-03-08,Municipal Iquique,Audax Italiano,3,2,1,W
233195,14,CHL1,2015-03-08,San Marcos de Arica,Universidad de Chile,0,1,-1,L
233196,14,CHL1,2015-03-08,CD Cobresal,Union La Calera,1,1,0,D
233197,14,CHL1,2015-03-08,Deportivo Nublense,Antofagasta,0,1,-1,L
233198,14,CHL1,2015-03-08,Colo Colo,Universidad de Concepcion,3,0,3,W
233199,14,CHL1,2015-03-13,Universidad de Concepcion,Deportivo Nublense,2,2,0,D
233200,14,CHL1,2015-03-13,Higgins,Municipal Iquique,1,0,1,W
233201,14,CHL1,2015-03-14,Universidad de Chile,Colo Colo,1,2,-1,L
233202,14,CHL1,2015-03-15,CD Cobreloa,Union Espanola,1,1,0,D
233203,14,CHL1,2015-03-15,Antofagasta,CD Cobresal,2,0,2,W
233204,14,CHL1,2015-03-15,Universidad Catolica,AC Barnechea,5,0,5,W
233205,14,CHL1,2015-03-15,Audax Italiano,CD Huachipato,2,2,0,D
233206,14,CHL1,2015-03-20,Audax Italiano,Universidad Catolica,1,1,0,D
233207,14,CHL1,2015-03-21,AC Barnechea,Antofagasta,1,3,-2,L
233208,14,CHL1,2015-03-21,Union Espanola,Deportivo Nublense,1,1,0,D
233209,14,CHL1,2015-03-21,CD Huachipato,Higgins,3,2,1,W
233210,14,CHL1,2015-03-21,Colo Colo,Union La Calera,1,4,-3,L
233211,14,CHL1,2015-03-22,San Marcos de Arica,Santiago Wanderers,3,3,0,D
233212,14,CHL1,2015-03-22,Municipal Iquique,CD Cobreloa,0,0,0,D
233213,14,CHL1,2015-03-22,CD Palestino,Universidad de Chile,1,3,-2,L
233214,14,CHL1,2015-03-22,CD Cobresal,Universidad de Concepcion,2,1,1,W
233215,14,CHL1,2015-03-25,CD Palestino,CD Huachipato,1,1,0,D
233216,14,CHL1,2015-03-28,Union La Calera,San Marcos de Arica,1,4,-3,L
233217,14,CHL1,2015-04-01,Santiago Wanderers,CD Palestino,0,3,-3,L
233218,14,CHL1,2015-04-03,Colo Colo,CD Cobresal,1,2,-1,L
233219,14,CHL1,2015-04-04,Deportivo Nublense,Municipal Iquique,2,0,2,W
233220,14,CHL1,2015-04-04,Higgins,Santiago Wanderers,1,1,0,D
233221,14,CHL1,2015-04-04,Antofagasta,CD Palestino,1,2,-1,L
233222,14,CHL1,2015-04-04,Union La Calera,Audax Italiano,2,2,0,D
233223,14,CHL1,2015-04-05,Union Espanola,AC Barnechea,2,1,1,W
233224,14,CHL1,2015-04-05,Universidad Catolica,Universidad de Chile,2,4,-2,L
233225,14,CHL1,2015-04-05,CD Cobreloa,CD Huachipato,6,0,6,W
233226,14,CHL1,2015-04-05,Universidad de Concepcion,San Marcos de Arica,3,2,1,W
233227,14,CHL1,2015-04-11,Universidad Catolica,Union La Calera,4,2,2,W
233228,14,CHL1,2015-04-11,CD Palestino,Universidad de Concepcion,3,2,1,W
233229,14,CHL1,2015-04-11,Santiago Wanderers,Antofagasta,0,2,-2,L
233230,14,CHL1,2015-04-11,Universidad de Chile,CD Cobreloa,4,0,4,W
233231,14,CHL1,2015-04-12,CD Cobresal,Deportivo Nublense,1,0,1,W
233232,14,CHL1,2015-04-12,San Marcos de Arica,Higgins,0,0,0,D
233233,14,CHL1,2015-04-12,Audax Italiano,Colo Colo,0,1,-1,L
233234,14,CHL1,2015-04-12,Municipal Iquique,Union Espanola,0,1,-1,L
233235,14,CHL1,2015-04-12,CD Huachipato,AC Barnechea,4,1,3,W
233236,14,CHL1,2015-04-18,Higgins,CD Cobresal,2,0,2,W
233237,14,CHL1,2015-04-18,Colo Colo,Universidad Catolica,0,3,-3,L
233238,14,CHL1,2015-04-18,CD Cobreloa,Antofagasta,3,1,2,W
233239,14,CHL1,2015-04-18,Union Espanola,CD Huachipato,0,1,-1,L
233240,14,CHL1,2015-04-19,Deportivo Nublense,Santiago Wanderers,1,1,0,D
233241,14,CHL1,2015-04-19,Universidad de Concepcion,Audax Italiano,2,2,0,D
233242,14,CHL1,2015-04-19,Municipal Iquique,San Marcos de Arica,4,1,3,W
233243,14,CHL1,2015-04-19,AC Barnechea,Universidad de Chile,1,4,-3,L
233244,14,CHL1,2015-04-20,Union La Calera,CD Palestino,4,0,4,W
233245,14,CHL1,2015-04-25,CD Palestino,Union Espanola,2,3,-1,L
233246,14,CHL1,2015-04-25,Santiago Wanderers,Union La Calera,4,2,2,W
233247,14,CHL1,2015-04-25,Antofagasta,Universidad de Concepcion,0,1,-1,L
233248,14,CHL1,2015-04-26,CD Huachipato,San Marcos de Arica,1,0,1,W
233249,14,CHL1,2015-04-26,Audax Italiano,Higgins,3,0,3,W
233250,14,CHL1,2015-04-26,CD Cobreloa,Colo Colo,0,4,-4,L
233251,14,CHL1,2015-04-26,Universidad de Chile,Deportivo Nublense,2,1,1,W
233252,14,CHL1,2015-04-26,Universidad Catolica,Municipal Iquique,3,3,0,D
233253,14,CHL1,2015-04-26,CD Cobresal,AC Barnechea,3,2,1,W
233254,14,CHL1,2015-04-30,AC Barnechea,CD Palestino,2,1,1,W
233255,14,CHL1,2015-05-02,Universidad de Concepcion,Universidad Catolica,2,0,2,W
233256,14,CHL1,2015-05-02,Colo Colo,Santiago Wanderers,3,1,2,W
233257,14,CHL1,2015-05-02,Municipal Iquique,CD Huachipato,1,2,-1,L
233258,14,CHL1,2015-05-03,Union Espanola,CD Cobresal,1,1,0,D
233259,14,CHL1,2015-05-03,Union La Calera,Universidad de Chile,2,1,1,W
233260,14,CHL1,2015-05-03,Higgins,Antofagasta,2,2,0,D
233261,14,CHL1,2015-05-03,San Marcos de Arica,Audax Italiano,3,0,3,W
233262,14,CHL1,2015-05-03,Deportivo Nublense,CD Cobreloa,3,2,1,W
233263,15,CHL1,2015-07-25,Union Espanola,Colo Colo,1,2,-1,L
233264,15,CHL1,2015-07-25,Santiago Wanderers,San Marcos de Arica,1,1,0,D
233265,15,CHL1,2015-07-26,Union La Calera,Higgins,1,0,1,W
233266,15,CHL1,2015-07-26,Universidad de Concepcion,CD Huachipato,2,0,2,W
233267,15,CHL1,2015-07-26,Municipal Iquique,Universidad Catolica,0,2,-2,L
233268,15,CHL1,2015-07-26,Universidad de Chile,Antofagasta,1,1,0,D
233269,15,CHL1,2015-07-28,Audax Italiano,CD Palestino,1,1,0,D
233270,15,CHL1,2015-08-08,CD Huachipato,Municipal Iquique,2,1,1,W
233271,15,CHL1,2015-08-09,San Marcos de Arica,CD Cobresal,1,2,-1,L
233272,15,CHL1,2015-08-09,San Luis,Santiago Wanderers,0,1,-1,L
233273,15,CHL1,2015-08-09,Colo Colo,Audax Italiano,4,1,3,W
233274,15,CHL1,2015-08-10,CD Palestino,Union Espanola,2,1,1,W
233275,15,CHL1,2015-08-15,Municipal Iquique,Higgins,2,5,-3,L
233276,15,CHL1,2015-08-15,Union Espanola,CD Huachipato,2,2,0,D
233277,15,CHL1,2015-08-15,Santiago Wanderers,Universidad Catolica,2,2,0,D
233278,15,CHL1,2015-08-15,Union La Calera,San Marcos de Arica,1,4,-3,L
233279,15,CHL1,2015-08-16,Audax Italiano,Antofagasta,0,0,0,D
233280,15,CHL1,2015-08-16,CD Cobresal,Colo Colo,2,3,-1,L
233281,15,CHL1,2015-08-16,Universidad de Chile,San Luis,4,2,2,W
233282,15,CHL1,2015-08-17,Universidad de Concepcion,CD Palestino,1,0,1,W
233283,15,CHL1,2015-08-19,Higgins,Universidad de Chile,2,2,0,D
233284,15,CHL1,2015-08-22,CD Palestino,CD Cobresal,3,1,2,W
233285,15,CHL1,2015-08-22,CD Huachipato,Union La Calera,1,1,0,D
233286,15,CHL1,2015-08-22,Higgins,Santiago Wanderers,1,0,1,W
233287,15,CHL1,2015-08-23,San Luis,Audax Italiano,0,0,0,D
233288,15,CHL1,2015-08-23,San Marcos de Arica,Universidad de Chile,0,1,-1,L
233289,15,CHL1,2015-08-23,Colo Colo,Municipal Iquique,1,0,1,W
233290,15,CHL1,2015-08-24,Universidad Catolica,Universidad de Concepcion,2,1,1,W
233291,15,CHL1,2015-08-25,Antofagasta,Union Espanola,0,2,-2,L
233292,15,CHL1,2015-08-29,Santiago Wanderers,CD Huachipato,3,1,2,W
233293,15,CHL1,2015-08-29,Universidad de Concepcion,CD Cobresal,3,1,2,W
233294,15,CHL1,2015-08-29,Union La Calera,Audax Italiano,1,2,-1,L
233295,15,CHL1,2015-08-30,Municipal Iquique,San Luis,2,1,1,W
233296,15,CHL1,2015-08-30,Antofagasta,Colo Colo,0,1,-1,L
233297,15,CHL1,2015-08-30,Universidad de Chile,CD Palestino,4,4,0,D
233298,15,CHL1,2015-08-31,Union Espanola,Universidad Catolica,2,0,2,W
233299,15,CHL1,2015-09-01,Higgins,San Marcos de Arica,3,1,2,W
233300,15,CHL1,2015-09-06,CD Cobresal,San Luis,2,1,1,W
233301,15,CHL1,2015-09-06,Antofagasta,Universidad de Concepcion,1,4,-3,L
233302,15,CHL1,2015-09-06,Universidad Catolica,Union La Calera,3,1,2,W
233303,15,CHL1,2015-09-12,CD Cobresal,Municipal Iquique,1,2,-1,L
233304,15,CHL1,2015-09-12,CD Huachipato,Antofagasta,1,0,1,W
233305,15,CHL1,2015-09-13,Universidad Catolica,Higgins,5,0,5,W
233306,15,CHL1,2015-09-13,San Luis,Union Espanola,0,4,-4,L
233307,15,CHL1,2015-09-14,CD Palestino,Santiago Wanderers,2,0,2,W
233308,15,CHL1,2015-09-14,Colo Colo,Union La Calera,3,1,2,W
233309,15,CHL1,2015-09-15,San Marcos de Arica,Universidad de Concepcion,4,1,3,W
233310,15,CHL1,2015-09-16,Audax Italiano,Universidad de Chile,3,1,2,W
233311,15,CHL1,2015-09-24,Universidad de Chile,CD Cobresal,2,1,1,W
233312,15,CHL1,2015-09-26,Municipal Iquique,CD Palestino,0,2,-2,L
233313,15,CHL1,2015-09-26,Union Espanola,Universidad de Concepcion,2,4,-2,L
233314,15,CHL1,2015-09-26,CD Huachipato,Universidad Catolica,0,1,-1,L
233315,15,CHL1,2015-09-26,Santiago Wanderers,Union La Calera,1,0,1,W
233316,15,CHL1,2015-09-27,Antofagasta,San Marcos de Arica,0,1,-1,L
233317,15,CHL1,2015-09-27,San Luis,Colo Colo,0,1,-1,L
233318,15,CHL1,2015-09-29,Higgins,Audax Italiano,3,2,1,W
233319,15,CHL1,2015-10-03,San Marcos de Arica,CD Huachipato,2,0,2,W
233320,15,CHL1,2015-10-03,CD Palestino,Higgins,1,0,1,W
233321,15,CHL1,2015-10-03,Universidad de Concepcion,San Luis,1,0,1,W
233322,15,CHL1,2015-10-03,Universidad de Chile,Union Espanola,1,1,0,D
233323,15,CHL1,2015-10-04,Universidad Catolica,Colo Colo,2,1,1,W
233324,15,CHL1,2015-10-04,CD Cobresal,Santiago Wanderers,2,0,2,W
233325,15,CHL1,2015-10-04,Union La Calera,Antofagasta,2,0,2,W
233326,15,CHL1,2015-10-05,Audax Italiano,Municipal Iquique,2,1,1,W
233327,15,CHL1,2015-10-15,CD Cobresal,Audax Italiano,1,2,-1,L
233328,15,CHL1,2015-10-16,Higgins,CD Huachipato,1,0,1,W
233329,15,CHL1,2015-10-17,San Luis,CD Palestino,6,2,4,W
233330,15,CHL1,2015-10-17,Antofagasta,Universidad Catolica,2,1,1,W
233331,15,CHL1,2015-10-17,Santiago Wanderers,Municipal Iquique,2,2,0,D
233332,15,CHL1,2015-10-18,Universidad de Concepcion,Universidad de Chile,4,1,3,W
233333,15,CHL1,2015-10-18,Colo Colo,San Marcos de Arica,0,1,-1,L
233334,15,CHL1,2015-10-20,Union Espanola,Union La Calera,4,0,4,W
233335,15,CHL1,2015-10-24,Union Espanola,Higgins,1,2,-1,L
233336,15,CHL1,2015-10-24,Municipal Iquique,Antofagasta,1,1,0,D
233337,15,CHL1,2015-10-24,Universidad de Chile,Santiago Wanderers,0,1,-1,L
233338,15,CHL1,2015-10-25,Union La Calera,CD Cobresal,0,2,-2,L
233339,15,CHL1,2015-10-25,San Marcos de Arica,San Luis,0,1,-1,L
233340,15,CHL1,2015-10-25,CD Huachipato,Colo Colo,1,2,-1,L
233341,15,CHL1,2015-10-25,Universidad Catolica,CD Palestino,2,0,2,W
233342,15,CHL1,2015-10-26,Audax Italiano,Universidad de Concepcion,2,1,1,W
233343,15,CHL1,2015-10-31,San Marcos de Arica,Union Espanola,1,1,0,D
233344,15,CHL1,2015-10-31,Colo Colo,Universidad de Chile,2,0,2,W
233345,15,CHL1,2015-10-31,Universidad de Concepcion,Municipal Iquique,1,1,0,D
233346,15,CHL1,2015-10-31,Higgins,Antofagasta,1,1,0,D
233347,15,CHL1,2015-11-01,CD Palestino,Union La Calera,1,1,0,D
233348,15,CHL1,2015-11-01,CD Cobresal,Universidad Catolica,2,5,-3,L
233349,15,CHL1,2015-11-01,Audax Italiano,Santiago Wanderers,1,1,0,D
233350,15,CHL1,2015-11-02,San Luis,CD Huachipato,2,3,-1,L
233351,15,CHL1,2015-11-06,Antofagasta,CD Palestino,0,2,-2,L
233352,15,CHL1,2015-11-06,Universidad Catolica,San Marcos de Arica,5,1,4,W
233353,15,CHL1,2015-11-07,Municipal Iquique,Universidad de Chile,5,3,2,W
233354,15,CHL1,2015-11-07,Union La Calera,San Luis,0,2,-2,L
233355,15,CHL1,2015-11-07,Colo Colo,Higgins,2,1,1,W
233356,15,CHL1,2015-11-07,CD Huachipato,CD Cobresal,2,0,2,W
233357,15,CHL1,2015-11-09,Union Espanola,Audax Italiano,3,2,1,W
233358,15,CHL1,2015-11-10,Santiago Wanderers,Universidad de Concepcion,1,2,-1,L
233359,15,CHL1,2015-11-21,Audax Italiano,CD Huachipato,2,2,0,D
233360,15,CHL1,2015-11-21,CD Cobresal,Antofagasta,3,1,2,W
233361,15,CHL1,2015-11-21,CD Palestino,Colo Colo,2,0,2,W
233362,15,CHL1,2015-11-22,Santiago Wanderers,Union Espanola,1,2,-1,L
233363,15,CHL1,2015-11-22,Universidad de Chile,Universidad Catolica,2,2,0,D
233364,15,CHL1,2015-11-22,Municipal Iquique,San Marcos de Arica,2,1,1,W
233365,15,CHL1,2015-11-23,San Luis,Higgins,2,1,1,W
233366,15,CHL1,2015-11-23,Universidad de Concepcion,Union La Calera,1,2,-1,L
233367,15,CHL1,2015-11-26,Antofagasta,Santiago Wanderers,2,2,0,D
233368,15,CHL1,2015-11-27,San Marcos de Arica,Audax Italiano,0,1,-1,L
233369,15,CHL1,2015-11-29,Colo Colo,Universidad de Concepcion,1,0,1,W
233370,15,CHL1,2015-11-29,Universidad Catolica,San Luis,1,0,1,W
233371,15,CHL1,2015-11-29,Union La Calera,Universidad de Chile,1,0,1,W
233372,15,CHL1,2015-11-30,Union Espanola,Municipal Iquique,3,0,3,W
233373,15,CHL1,2015-11-30,CD Huachipato,CD Palestino,0,0,0,D
233374,15,CHL1,2015-12-01,Higgins,CD Cobresal,2,0,2,W
233375,15,CHL1,2015-12-03,San Luis,Antofagasta,1,2,-1,L
233376,15,CHL1,2015-12-05,CD Cobresal,Union Espanola,3,1,2,W
233377,15,CHL1,2015-12-05,Universidad de Concepcion,Higgins,3,1,2,W
233378,15,CHL1,2015-12-05,CD Palestino,San Marcos de Arica,1,0,1,W
233379,15,CHL1,2015-12-05,Universidad de Chile,CD Huachipato,2,1,1,W
233380,15,CHL1,2015-12-06,Municipal Iquique,Union La Calera,1,1,0,D
233381,15,CHL1,2015-12-06,Audax Italiano,Universidad Catolica,1,0,1,W
233382,15,CHL1,2016-01-11,Santiago Wanderers,Colo Colo,2,1,1,W
233383,15,CHL1,2016-01-15,Higgins,Union La Calera,4,0,4,W
233384,15,CHL1,2016-01-16,San Marcos de Arica,Santiago Wanderers,0,2,-2,L
233385,15,CHL1,2016-01-16,Colo Colo,Union Espanola,1,1,0,D
233386,15,CHL1,2016-01-16,CD Huachipato,Universidad de Concepcion,3,0,3,W
233387,15,CHL1,2016-01-17,San Luis,CD Cobresal,0,0,0,D
233388,15,CHL1,2016-01-17,Antofagasta,Universidad de Chile,1,1,0,D
233389,15,CHL1,2016-01-17,Universidad Catolica,Municipal Iquique,2,2,0,D
233390,15,CHL1,2016-01-18,CD Palestino,Audax Italiano,2,1,1,W
233391,15,CHL1,2016-01-22,Santiago Wanderers,San Luis,3,1,2,W
233392,15,CHL1,2016-01-23,Municipal Iquique,CD Huachipato,1,1,0,D
233393,15,CHL1,2016-01-23,Audax Italiano,Colo Colo,0,3,-3,L
233394,15,CHL1,2016-01-23,Universidad de Concepcion,Antofagasta,2,1,1,W
233395,15,CHL1,2016-01-24,Union La Calera,Universidad Catolica,1,4,-3,L
233396,15,CHL1,2016-01-24,Universidad de Chile,Higgins,8,1,7,W
233397,15,CHL1,2016-01-24,Union Espanola,CD Palestino,1,1,0,D
233398,15,CHL1,2016-01-25,CD Cobresal,San Marcos de Arica,0,0,0,D
233399,15,CHL1,2016-01-27,San Luis,Universidad de Chile,1,1,0,D
233400,15,CHL1,2016-01-29,Antofagasta,Audax Italiano,1,2,-1,L
233401,15,CHL1,2016-01-30,Colo Colo,CD Cobresal,1,0,1,W
233402,15,CHL1,2016-01-30,CD Huachipato,Union Espanola,3,3,0,D
233403,15,CHL1,2016-01-31,San Marcos de Arica,Union La Calera,0,1,-1,L
233404,15,CHL1,2016-01-31,Universidad Catolica,Santiago Wanderers,4,2,2,W
233405,15,CHL1,2016-01-31,Higgins,Municipal Iquique,0,0,0,D
233406,15,CHL1,2016-02-01,CD Palestino,Universidad de Concepcion,3,0,3,W
233407,15,CHL1,2016-02-05,Santiago Wanderers,Higgins,3,1,2,W
233408,15,CHL1,2016-02-06,Audax Italiano,San Luis,1,0,1,W
233409,15,CHL1,2016-02-06,Universidad de Chile,San Marcos de Arica,0,0,0,D
233410,15,CHL1,2016-02-06,Universidad de Concepcion,Universidad Catolica,2,4,-2,L
233411,15,CHL1,2016-02-07,CD Cobresal,CD Palestino,2,3,-1,L
233412,15,CHL1,2016-02-07,Municipal Iquique,Colo Colo,0,0,0,D
233413,15,CHL1,2016-02-07,Union Espanola,Antofagasta,0,2,-2,L
233414,15,CHL1,2016-02-08,Union La Calera,CD Huachipato,1,2,-1,L
233415,15,CHL1,2016-02-12,Universidad Catolica,Union Espanola,4,2,2,W
233416,15,CHL1,2016-02-13,CD Palestino,Universidad de Chile,2,1,1,W
233417,15,CHL1,2016-02-13,CD Cobresal,Universidad de Concepcion,1,0,1,W
233418,15,CHL1,2016-02-14,San Luis,Municipal Iquique,3,1,2,W
233419,15,CHL1,2016-02-14,Colo Colo,Antofagasta,2,1,1,W
233420,15,CHL1,2016-02-14,CD Huachipato,Santiago Wanderers,3,2,1,W
233421,15,CHL1,2016-02-15,San Marcos de Arica,Higgins,0,1,-1,L
233422,15,CHL1,2016-02-15,Audax Italiano,Union La Calera,0,0,0,D
233423,15,CHL1,2016-02-19,Santiago Wanderers,CD Palestino,0,0,0,D
233424,15,CHL1,2016-02-20,Higgins,Universidad Catolica,4,3,1,W
233425,15,CHL1,2016-02-20,Universidad de Chile,Audax Italiano,2,2,0,D
233426,15,CHL1,2016-02-21,Union Espanola,San Luis,3,1,2,W
233427,15,CHL1,2016-02-21,Union La Calera,Colo Colo,0,1,-1,L
233428,15,CHL1,2016-02-21,Antofagasta,CD Huachipato,3,0,3,W
233429,15,CHL1,2016-02-22,Municipal Iquique,CD Cobresal,1,1,0,D
233430,15,CHL1,2016-02-22,Universidad de Concepcion,San Marcos de Arica,2,1,1,W
233431,15,CHL1,2016-02-26,CD Palestino,Municipal Iquique,2,2,0,D
233432,15,CHL1,2016-02-26,Universidad de Concepcion,Union Espanola,3,1,2,W
233433,15,CHL1,2016-02-27,Colo Colo,San Luis,2,0,2,W
233434,15,CHL1,2016-02-28,San Marcos de Arica,Antofagasta,0,2,-2,L
233435,15,CHL1,2016-02-28,CD Cobresal,Universidad de Chile,1,4,-3,L
233436,15,CHL1,2016-02-28,Universidad Catolica,CD Huachipato,2,2,0,D
233437,15,CHL1,2016-02-29,Audax Italiano,Higgins,2,2,0,D
233438,15,CHL1,2016-02-29,Union La Calera,Santiago Wanderers,3,3,0,D
233439,15,CHL1,2016-03-04,Antofagasta,Union La Calera,3,1,2,W
233440,15,CHL1,2016-03-05,San Luis,Universidad de Concepcion,2,2,0,D
233441,15,CHL1,2016-03-05,Union Espanola,Universidad de Chile,0,0,0,D
233442,15,CHL1,2016-03-05,CD Huachipato,San Marcos de Arica,1,1,0,D
233443,15,CHL1,2016-03-06,Santiago Wanderers,CD Cobresal,3,1,2,W
233444,15,CHL1,2016-03-06,Colo Colo,Universidad Catolica,3,0,3,W
233445,15,CHL1,2016-03-06,Municipal Iquique,Audax Italiano,1,1,0,D
233446,15,CHL1,2016-03-07,Higgins,CD Palestino,1,1,0,D
233447,15,CHL1,2016-03-11,Union La Calera,Union Espanola,2,1,1,W
233448,15,CHL1,2016-03-12,Municipal Iquique,Santiago Wanderers,1,2,-1,L
233449,15,CHL1,2016-03-12,Audax Italiano,CD Cobresal,0,1,-1,L
233450,15,CHL1,2016-03-12,Universidad Catolica,Antofagasta,2,1,1,W
233451,15,CHL1,2016-03-13,CD Huachipato,Higgins,0,1,-1,L
233452,15,CHL1,2016-03-13,San Marcos de Arica,Colo Colo,1,0,1,W
233453,15,CHL1,2016-03-13,Universidad de Chile,Universidad de Concepcion,1,3,-2,L
233454,15,CHL1,2016-03-14,CD Palestino,San Luis,2,2,0,D
233455,15,CHL1,2016-03-18,Higgins,Union Espanola,0,0,0,D
233456,15,CHL1,2016-03-19,CD Palestino,Universidad Catolica,0,1,-1,L
233457,15,CHL1,2016-03-19,Antofagasta,Municipal Iquique,2,3,-1,L
233458,15,CHL1,2016-03-20,Universidad de Concepcion,Audax Italiano,2,0,2,W
233459,15,CHL1,2016-03-20,San Luis,San Marcos de Arica,1,1,0,D
233460,15,CHL1,2016-03-20,Universidad de Chile,Colo Colo,0,0,0,D
233461,15,CHL1,2016-03-21,CD Cobresal,Union La Calera,0,0,0,D
233462,15,CHL1,2016-04-02,Santiago Wanderers,Universidad de Chile,5,4,1,W
233463,15,CHL1,2016-04-02,Colo Colo,CD Huachipato,1,1,0,D
233464,15,CHL1,2016-04-02,Municipal Iquique,Universidad de Concepcion,3,1,2,W
233465,15,CHL1,2016-04-03,Union La Calera,CD Palestino,1,1,0,D
233466,15,CHL1,2016-04-03,Antofagasta,Higgins,0,2,-2,L
233467,15,CHL1,2016-04-04,Universidad Catolica,CD Cobresal,1,0,1,W
233468,15,CHL1,2016-04-04,Union Espanola,San Marcos de Arica,1,1,0,D
233469,15,CHL1,2016-04-05,CD Huachipato,San Luis,3,3,0,D
233470,15,CHL1,2016-04-06,Santiago Wanderers,Audax Italiano,2,2,0,D
233471,15,CHL1,2016-04-09,Universidad de Chile,Municipal Iquique,2,1,1,W
233472,15,CHL1,2016-04-09,CD Palestino,Antofagasta,0,2,-2,L
233473,15,CHL1,2016-04-09,CD Cobresal,CD Huachipato,3,2,1,W
233474,15,CHL1,2016-04-10,Higgins,Colo Colo,3,0,3,W
233475,15,CHL1,2016-04-10,San Luis,Union La Calera,3,1,2,W
233476,15,CHL1,2016-04-10,Audax Italiano,Union Espanola,1,1,0,D
233477,15,CHL1,2016-04-11,San Marcos de Arica,Universidad Catolica,3,2,1,W
233478,15,CHL1,2016-04-12,Universidad de Concepcion,Santiago Wanderers,1,0,1,W
233479,15,CHL1,2016-04-16,Antofagasta,CD Cobresal,2,1,1,W
233480,15,CHL1,2016-04-16,CD Huachipato,Audax Italiano,0,3,-3,L
233481,15,CHL1,2016-04-17,Union Espanola,Santiago Wanderers,2,2,0,D
233482,15,CHL1,2016-04-17,San Marcos de Arica,Municipal Iquique,0,1,-1,L
233483,15,CHL1,2016-04-18,Union La Calera,Universidad de Concepcion,1,2,-1,L
233484,15,CHL1,2016-04-20,Colo Colo,CD Palestino,1,3,-2,L
233485,15,CHL1,2016-04-21,Higgins,San Luis,4,3,1,W
233486,15,CHL1,2016-04-23,Universidad Catolica,Universidad de Chile,2,1,1,W
233487,15,CHL1,2016-04-23,CD Palestino,CD Huachipato,1,1,0,D
233488,15,CHL1,2016-04-23,Municipal Iquique,Union Espanola,2,3,-1,L
233489,15,CHL1,2016-04-23,Audax Italiano,San Marcos de Arica,0,0,0,D
233490,15,CHL1,2016-04-24,Universidad de Concepcion,Colo Colo,0,2,-2,L
233491,15,CHL1,2016-04-24,CD Cobresal,Higgins,2,3,-1,L
233492,15,CHL1,2016-04-24,Santiago Wanderers,Antofagasta,1,1,0,D
233493,15,CHL1,2016-04-27,Universidad de Chile,Union La Calera,2,2,0,D
233494,15,CHL1,2016-04-27,San Luis,Universidad Catolica,1,0,1,W
233495,15,CHL1,2016-04-29,Union La Calera,Municipal Iquique,2,4,-2,L
233496,15,CHL1,2016-04-29,CD Huachipato,Universidad de Chile,4,2,2,W
233497,15,CHL1,2016-04-30,Antofagasta,San Luis,1,1,0,D
233498,15,CHL1,2016-04-30,Union Espanola,CD Cobresal,1,1,0,D
233499,15,CHL1,2016-04-30,San Marcos de Arica,CD Palestino,2,3,-1,L
233500,15,CHL1,2016-04-30,Universidad Catolica,Audax Italiano,2,1,1,W
233501,15,CHL1,2016-04-30,Colo Colo,Santiago Wanderers,2,1,1,W
233502,15,CHL1,2016-04-30,Higgins,Universidad de Concepcion,1,2,-1,L
233503,16,CHL1,2016-07-30,San Luis,Higgins,0,1,-1,L
233504,16,CHL1,2016-07-30,Santiago Wanderers,Universidad de Chile,1,0,1,W
233505,16,CHL1,2016-07-30,Universidad Catolica,CD Cobresal,1,1,0,D
233506,16,CHL1,2016-07-31,CD Huachipato,Audax Italiano,3,1,2,W
233507,16,CHL1,2016-07-31,Municipal Iquique,Everton CD,3,1,2,W
233508,16,CHL1,2016-07-31,Colo Colo,Union Espanola,1,2,-1,L
233509,16,CHL1,2016-07-31,Universidad de Concepcion,CD Palestino,1,0,1,W
233510,16,CHL1,2016-08-01,Antofagasta,Deportes Temuco,0,2,-2,L
233511,16,CHL1,2016-08-05,CD Cobresal,Santiago Wanderers,1,1,0,D
233512,16,CHL1,2016-08-06,Higgins,Universidad Catolica,1,1,0,D
233513,16,CHL1,2016-08-06,CD Palestino,CD Huachipato,2,1,1,W
233514,16,CHL1,2016-08-06,Universidad de Chile,Antofagasta,1,1,0,D
233515,16,CHL1,2016-08-07,Union Espanola,Universidad de Concepcion,3,0,3,W
233516,16,CHL1,2016-08-07,Deportes Temuco,Municipal Iquique,1,3,-2,L
233517,16,CHL1,2016-08-07,Audax Italiano,Colo Colo,0,2,-2,L
233518,16,CHL1,2016-08-07,Everton CD,San Luis,1,1,0,D
233519,16,CHL1,2016-08-13,Santiago Wanderers,Audax Italiano,2,0,2,W
233520,16,CHL1,2016-08-13,Municipal Iquique,Higgins,1,1,0,D
233521,16,CHL1,2016-08-13,San Luis,Universidad de Chile,2,4,-2,L
233522,16,CHL1,2016-08-13,Colo Colo,Deportes Temuco,0,2,-2,L
233523,16,CHL1,2016-08-14,Universidad de Concepcion,Everton CD,2,2,0,D
233524,16,CHL1,2016-08-14,Antofagasta,CD Cobresal,0,0,0,D
233525,16,CHL1,2016-08-14,CD Huachipato,Union Espanola,2,2,0,D
233526,16,CHL1,2016-08-14,Universidad Catolica,CD Palestino,1,1,0,D
233527,16,CHL1,2016-08-19,Everton CD,Union Espanola,1,1,0,D
233528,16,CHL1,2016-08-20,CD Cobresal,Municipal Iquique,1,2,-1,L
233529,16,CHL1,2016-08-20,Higgins,Deportes Temuco,1,0,1,W
233530,16,CHL1,2016-08-20,Universidad de Chile,Universidad de Concepcion,3,1,2,W
233531,16,CHL1,2016-08-21,CD Palestino,San Luis,3,4,-1,L
233532,16,CHL1,2016-08-21,CD Huachipato,Colo Colo,2,2,0,D
233533,16,CHL1,2016-08-21,Universidad Catolica,Santiago Wanderers,1,2,-1,L
233534,16,CHL1,2016-08-22,Audax Italiano,Antofagasta,1,0,1,W
233535,16,CHL1,2016-08-26,Colo Colo,Municipal Iquique,0,2,-2,L
233536,16,CHL1,2016-08-27,Universidad de Chile,Universidad Catolica,0,3,-3,L
233537,16,CHL1,2016-08-27,Deportes Temuco,CD Cobresal,1,2,-1,L
233538,16,CHL1,2016-08-28,Union Espanola,Higgins,1,1,0,D
233539,16,CHL1,2016-08-28,Santiago Wanderers,Antofagasta,0,1,-1,L
233540,16,CHL1,2016-08-28,Universidad de Concepcion,Audax Italiano,3,1,2,W
233541,16,CHL1,2016-08-29,San Luis,CD Huachipato,1,1,0,D
233542,16,CHL1,2016-08-29,Everton CD,CD Palestino,1,2,-1,L
233543,16,CHL1,2016-09-09,Universidad Catolica,Everton CD,3,1,2,W
233544,16,CHL1,2016-09-10,Municipal Iquique,Universidad de Concepcion,0,2,-2,L
233545,16,CHL1,2016-09-10,CD Palestino,Santiago Wanderers,0,0,0,D
233546,16,CHL1,2016-09-10,Deportes Temuco,San Luis,2,0,2,W
233547,16,CHL1,2016-09-11,Higgins,CD Huachipato,2,0,2,W
233548,16,CHL1,2016-09-11,CD Cobresal,Universidad de Chile,2,0,2,W
233549,16,CHL1,2016-09-11,Antofagasta,Colo Colo,2,2,0,D
233550,16,CHL1,2016-09-13,Audax Italiano,Union Espanola,3,1,2,W
233551,16,CHL1,2016-09-24,CD Huachipato,CD Cobresal,4,1,3,W
233552,16,CHL1,2016-09-24,Colo Colo,Santiago Wanderers,1,1,0,D
233553,16,CHL1,2016-09-24,Everton CD,Deportes Temuco,1,2,-1,L
233554,16,CHL1,2016-09-25,Universidad de Concepcion,Antofagasta,1,2,-1,L
233555,16,CHL1,2016-09-25,San Luis,Universidad Catolica,2,0,2,W
233556,16,CHL1,2016-09-25,Higgins,Audax Italiano,1,2,-1,L
233557,16,CHL1,2016-09-25,Universidad de Chile,CD Palestino,1,0,1,W
233558,16,CHL1,2016-09-26,Union Espanola,Municipal Iquique,3,1,2,W
233559,16,CHL1,2016-10-01,Antofagasta,San Luis,1,0,1,W
233560,16,CHL1,2016-10-01,CD Cobresal,Higgins,2,1,1,W
233561,16,CHL1,2016-10-01,Universidad Catolica,CD Huachipato,2,1,1,W
233562,16,CHL1,2016-10-02,Colo Colo,Universidad de Chile,2,0,2,W
233563,16,CHL1,2016-10-02,Municipal Iquique,CD Palestino,2,2,0,D
233564,16,CHL1,2016-10-02,Deportes Temuco,Union Espanola,1,2,-1,L
233565,16,CHL1,2016-10-03,Audax Italiano,Everton CD,0,3,-3,L
233566,16,CHL1,2016-10-15,San Luis,CD Cobresal,1,0,1,W
233567,16,CHL1,2016-10-15,CD Palestino,Antofagasta,5,1,4,W
233568,16,CHL1,2016-10-15,Santiago Wanderers,Everton CD,0,1,-1,L
233569,16,CHL1,2016-10-15,CD Huachipato,Municipal Iquique,1,2,-1,L
233570,16,CHL1,2016-10-15,Union Espanola,Universidad Catolica,3,4,-1,L
233571,16,CHL1,2016-10-16,Audax Italiano,Deportes Temuco,1,1,0,D
233572,16,CHL1,2016-10-16,Universidad de Concepcion,Colo Colo,0,2,-2,L
233573,16,CHL1,2016-10-16,Universidad de Chile,Higgins,0,0,0,D
233574,16,CHL1,2016-10-29,Municipal Iquique,Santiago Wanderers,3,0,3,W
233575,16,CHL1,2016-10-29,CD Cobresal,Union Espanola,0,2,-2,L
233576,16,CHL1,2016-10-29,Universidad Catolica,Audax Italiano,4,1,3,W
233577,16,CHL1,2016-10-30,Everton CD,Universidad de Chile,2,2,0,D
233578,16,CHL1,2016-10-30,Antofagasta,CD Huachipato,3,0,3,W
233579,16,CHL1,2016-10-30,Colo Colo,San Luis,3,3,0,D
233580,16,CHL1,2016-10-30,Deportes Temuco,Universidad de Concepcion,1,0,1,W
233581,16,CHL1,2016-10-31,Higgins,CD Palestino,3,2,1,W
233582,16,CHL1,2016-11-05,Santiago Wanderers,Union Espanola,0,2,-2,L
233583,16,CHL1,2016-11-05,CD Cobresal,Audax Italiano,1,1,0,D
233584,16,CHL1,2016-11-05,Higgins,Antofagasta,3,1,2,W
233585,16,CHL1,2016-11-05,Universidad de Chile,Municipal Iquique,2,2,0,D
233586,16,CHL1,2016-11-06,Universidad Catolica,Colo Colo,2,2,0,D
233587,16,CHL1,2016-11-06,CD Palestino,Deportes Temuco,2,0,2,W
233588,16,CHL1,2016-11-06,San Luis,Universidad de Concepcion,2,0,2,W
233589,16,CHL1,2016-11-06,CD Huachipato,Everton CD,2,2,0,D
233590,16,CHL1,2016-11-13,Santiago Wanderers,Universidad de Concepcion,2,0,2,W
233591,16,CHL1,2016-11-18,Colo Colo,CD Cobresal,3,0,3,W
233592,16,CHL1,2016-11-19,Municipal Iquique,San Luis,3,1,2,W
233593,16,CHL1,2016-11-19,Everton CD,Higgins,2,2,0,D
233594,16,CHL1,2016-11-19,Union Espanola,Universidad de Chile,2,3,-1,L
233595,16,CHL1,2016-11-19,Universidad de Concepcion,CD Huachipato,2,2,0,D
233596,16,CHL1,2016-11-20,Deportes Temuco,Santiago Wanderers,2,3,-1,L
233597,16,CHL1,2016-11-20,Antofagasta,Universidad Catolica,1,5,-4,L
233598,16,CHL1,2016-11-20,Audax Italiano,CD Palestino,2,1,1,W
233599,16,CHL1,2016-11-25,CD Huachipato,Deportes Temuco,1,0,1,W
233600,16,CHL1,2016-11-26,Everton CD,CD Cobresal,2,1,1,W
233601,16,CHL1,2016-11-26,Higgins,Colo Colo,1,0,1,W
233602,16,CHL1,2016-11-26,Universidad Catolica,Universidad de Concepcion,2,0,2,W
233603,16,CHL1,2016-11-27,Antofagasta,Municipal Iquique,0,0,0,D
233604,16,CHL1,2016-11-27,San Luis,Santiago Wanderers,2,1,1,W
233605,16,CHL1,2016-11-27,Universidad de Chile,Audax Italiano,2,2,0,D
233606,16,CHL1,2016-11-28,CD Palestino,Union Espanola,2,0,2,W
233607,16,CHL1,2016-12-01,Santiago Wanderers,CD Huachipato,0,2,-2,L
233608,16,CHL1,2016-12-03,CD Cobresal,CD Palestino,0,2,-2,L
233609,16,CHL1,2016-12-04,Deportes Temuco,Universidad de Chile,0,3,-3,L
233610,16,CHL1,2016-12-04,Municipal Iquique,Universidad Catolica,2,6,-4,L
233611,16,CHL1,2016-12-04,Union Espanola,Antofagasta,2,1,1,W
233612,16,CHL1,2016-12-04,Universidad de Concepcion,Higgins,3,1,2,W
233613,16,CHL1,2016-12-04,Colo Colo,Everton CD,4,2,2,W
233614,16,CHL1,2016-12-04,Audax Italiano,San Luis,1,2,-1,L
233615,16,CHL1,2016-12-08,CD Palestino,Colo Colo,1,2,-1,L
233616,16,CHL1,2016-12-08,Deportes Temuco,Universidad Catolica,0,2,-2,L
233617,16,CHL1,2016-12-08,Audax Italiano,Municipal Iquique,1,2,-1,L
233618,16,CHL1,2016-12-08,Union Espanola,San Luis,1,0,1,W
233619,16,CHL1,2016-12-08,Higgins,Santiago Wanderers,4,0,4,W
233620,16,CHL1,2016-12-09,CD Cobresal,Universidad de Concepcion,2,0,2,W
233621,16,CHL1,2016-12-09,Universidad de Chile,CD Huachipato,2,2,0,D
233622,16,CHL1,2016-12-10,Everton CD,Antofagasta,0,3,-3,L
233623,16,CHL1,2017-02-04,Antofagasta,Everton CD,0,2,-2,L
233624,16,CHL1,2017-02-04,Union Espanola,Colo Colo,0,3,-3,L
233625,16,CHL1,2017-02-04,Audax Italiano,CD Cobresal,2,0,2,W
233626,16,CHL1,2017-02-05,Municipal Iquique,Universidad de Chile,2,0,2,W
233627,16,CHL1,2017-02-05,CD Palestino,Universidad de Concepcion,1,2,-1,L
233628,16,CHL1,2017-02-05,Universidad Catolica,San Luis,1,0,1,W
233629,16,CHL1,2017-02-10,CD Cobresal,Antofagasta,3,1,2,W
233630,16,CHL1,2017-02-10,San Luis,Municipal Iquique,2,3,-1,L
233631,16,CHL1,2017-02-11,CD Huachipato,CD Palestino,3,2,1,W
233632,16,CHL1,2017-02-11,Higgins,Union Espanola,2,0,2,W
233633,16,CHL1,2017-02-11,Universidad de Chile,Deportes Temuco,1,0,1,W
233634,16,CHL1,2017-02-12,Everton CD,Universidad Catolica,2,1,1,W
233635,16,CHL1,2017-02-12,Colo Colo,Audax Italiano,4,0,4,W
233636,16,CHL1,2017-02-12,Universidad de Concepcion,Santiago Wanderers,1,0,1,W
233637,16,CHL1,2017-02-14,Deportes Temuco,CD Huachipato,1,0,1,W
233638,16,CHL1,2017-02-17,Municipal Iquique,CD Cobresal,3,1,2,W
233639,16,CHL1,2017-02-17,CD Huachipato,Universidad de Chile,2,1,1,W
233640,16,CHL1,2017-02-18,Santiago Wanderers,Universidad Catolica,3,0,3,W
233641,16,CHL1,2017-02-18,CD Palestino,Audax Italiano,0,2,-2,L
233642,16,CHL1,2017-02-18,Colo Colo,Higgins,2,1,1,W
233643,16,CHL1,2017-02-19,Antofagasta,Universidad de Concepcion,5,0,5,W
233644,16,CHL1,2017-02-19,San Luis,Everton CD,1,1,0,D
233645,16,CHL1,2017-02-19,Union Espanola,Deportes Temuco,5,2,3,W
233646,16,CHL1,2017-02-24,Universidad de Concepcion,Municipal Iquique,1,1,0,D
233647,16,CHL1,2017-02-25,Higgins,CD Cobresal,4,1,3,W
233648,16,CHL1,2017-02-25,Antofagasta,CD Palestino,1,1,0,D
233649,16,CHL1,2017-02-25,Universidad de Chile,Everton CD,0,0,0,D
233650,16,CHL1,2017-02-25,Audax Italiano,CD Huachipato,3,2,1,W
233651,16,CHL1,2017-02-26,Deportes Temuco,Colo Colo,2,2,0,D
233652,16,CHL1,2017-02-26,Santiago Wanderers,San Luis,0,3,-3,L
233653,16,CHL1,2017-02-26,Universidad Catolica,Union Espanola,2,3,-1,L
233654,16,CHL1,2017-03-03,Municipal Iquique,Audax Italiano,2,2,0,D
233655,16,CHL1,2017-03-03,Union Espanola,CD Huachipato,3,0,3,W
233656,16,CHL1,2017-03-04,Everton CD,Santiago Wanderers,2,2,0,D
233657,16,CHL1,2017-03-04,Colo Colo,Universidad Catolica,2,0,2,W
233658,16,CHL1,2017-03-04,CD Cobresal,Deportes Temuco,1,2,-1,L
233659,16,CHL1,2017-03-05,CD Palestino,Universidad de Chile,1,3,-2,L
233660,16,CHL1,2017-03-05,San Luis,Antofagasta,0,5,-5,L
233661,16,CHL1,2017-03-06,Higgins,Universidad de Concepcion,1,1,0,D
233662,16,CHL1,2017-03-10,Deportes Temuco,Everton CD,0,2,-2,L
233663,16,CHL1,2017-03-11,Universidad de Concepcion,San Luis,3,0,3,W
233664,16,CHL1,2017-03-11,Santiago Wanderers,Colo Colo,0,2,-2,L
233665,16,CHL1,2017-03-11,CD Palestino,Municipal Iquique,0,2,-2,L
233666,16,CHL1,2017-03-11,Universidad Catolica,Antofagasta,4,1,3,W
233667,16,CHL1,2017-03-12,CD Huachipato,Higgins,0,2,-2,L
233668,16,CHL1,2017-03-12,Audax Italiano,Universidad de Chile,0,3,-3,L
233669,16,CHL1,2017-03-12,Union Espanola,CD Cobresal,3,0,3,W
233670,16,CHL1,2017-03-15,Santiago Wanderers,Higgins,1,2,-1,L
233671,16,CHL1,2017-03-17,San Luis,CD Palestino,2,2,0,D
233672,16,CHL1,2017-03-18,Everton CD,Universidad de Concepcion,2,0,2,W
233673,16,CHL1,2017-03-18,Antofagasta,Santiago Wanderers,1,1,0,D
233674,16,CHL1,2017-03-18,Colo Colo,CD Huachipato,0,0,0,D
233675,16,CHL1,2017-03-19,CD Cobresal,Universidad Catolica,1,2,-1,L
233676,16,CHL1,2017-03-19,Universidad de Chile,Union Espanola,2,1,1,W
233677,16,CHL1,2017-03-20,Deportes Temuco,Audax Italiano,1,1,0,D
233678,16,CHL1,2017-03-21,Higgins,Municipal Iquique,1,1,0,D
233679,16,CHL1,2017-03-31,Antofagasta,Union Espanola,1,1,0,D
233680,16,CHL1,2017-04-01,Universidad de Concepcion,Universidad de Chile,0,0,0,D
233681,16,CHL1,2017-04-01,CD Cobresal,Everton CD,1,1,0,D
233682,16,CHL1,2017-04-01,Santiago Wanderers,CD Palestino,5,2,3,W
233683,16,CHL1,2017-04-02,Universidad Catolica,Deportes Temuco,2,1,1,W
233684,16,CHL1,2017-04-02,Municipal Iquique,Colo Colo,3,2,1,W
233685,16,CHL1,2017-04-02,CD Huachipato,San Luis,3,2,1,W
233686,16,CHL1,2017-04-02,Audax Italiano,Higgins,2,1,1,W
233687,16,CHL1,2017-04-08,CD Palestino,Universidad Catolica,0,0,0,D
233688,16,CHL1,2017-04-08,Universidad de Chile,Colo Colo,2,2,0,D
233689,16,CHL1,2017-04-08,CD Huachipato,Antofagasta,0,0,0,D
233690,16,CHL1,2017-04-08,Everton CD,Municipal Iquique,0,0,0,D
233691,16,CHL1,2017-04-09,Universidad de Concepcion,CD Cobresal,4,0,4,W
233692,16,CHL1,2017-04-09,Deportes Temuco,Higgins,2,0,2,W
233693,16,CHL1,2017-04-09,San Luis,Audax Italiano,1,0,1,W
233694,16,CHL1,2017-04-09,Union Espanola,Santiago Wanderers,1,0,1,W
233695,16,CHL1,2017-04-13,CD Cobresal,San Luis,1,2,-1,L
233696,16,CHL1,2017-04-15,Municipal Iquique,CD Huachipato,1,2,-1,L
233697,16,CHL1,2017-04-15,Colo Colo,Universidad de Concepcion,3,0,3,W
233698,16,CHL1,2017-04-15,Higgins,Everton CD,1,0,1,W
233699,16,CHL1,2017-04-16,Union Espanola,CD Palestino,1,2,-1,L
233700,16,CHL1,2017-04-16,Santiago Wanderers,Deportes Temuco,1,2,-1,L
233701,16,CHL1,2017-04-16,Antofagasta,Universidad de Chile,0,1,-1,L
233702,16,CHL1,2017-04-17,Audax Italiano,Universidad Catolica,5,2,3,W
233703,16,CHL1,2017-04-22,Universidad Catolica,Higgins,5,2,3,W
233704,16,CHL1,2017-04-22,Municipal Iquique,Union Espanola,2,2,0,D
233705,16,CHL1,2017-04-22,Universidad de Chile,Santiago Wanderers,2,0,2,W
233706,16,CHL1,2017-04-22,Deportes Temuco,Antofagasta,2,0,2,W
233707,16,CHL1,2017-04-23,Everton CD,Audax Italiano,2,2,0,D
233708,16,CHL1,2017-04-23,CD Palestino,CD Cobresal,3,2,1,W
233709,16,CHL1,2017-04-23,San Luis,Colo Colo,1,0,1,W
233710,16,CHL1,2017-04-24,CD Huachipato,Universidad de Concepcion,0,0,0,D
233711,16,CHL1,2017-04-29,Universidad de Concepcion,Deportes Temuco,1,0,1,W
233712,16,CHL1,2017-04-29,Universidad Catolica,Universidad de Chile,3,1,2,W
233713,16,CHL1,2017-04-29,CD Cobresal,CD Huachipato,3,2,1,W
233714,16,CHL1,2017-04-29,Santiago Wanderers,Municipal Iquique,1,1,0,D
233715,16,CHL1,2017-04-30,Union Espanola,Everton CD,2,1,1,W
233716,16,CHL1,2017-04-30,Higgins,San Luis,2,1,1,W
233717,16,CHL1,2017-04-30,Antofagasta,Audax Italiano,1,0,1,W
233718,16,CHL1,2017-04-30,Colo Colo,CD Palestino,0,0,0,D
233719,16,CHL1,2017-05-05,Universidad de Concepcion,Union Espanola,0,0,0,D
233720,16,CHL1,2017-05-06,Universidad de Chile,CD Cobresal,4,0,4,W
233721,16,CHL1,2017-05-06,CD Palestino,Higgins,1,1,0,D
233722,16,CHL1,2017-05-06,San Luis,Deportes Temuco,1,1,0,D
233723,16,CHL1,2017-05-06,Audax Italiano,Santiago Wanderers,3,0,3,W
233724,16,CHL1,2017-05-07,Everton CD,Colo Colo,2,3,-1,L
233725,16,CHL1,2017-05-07,Municipal Iquique,Antofagasta,2,4,-2,L
233726,16,CHL1,2017-05-07,CD Huachipato,Universidad Catolica,2,1,1,W
233727,16,CHL1,2017-05-13,Everton CD,CD Huachipato,2,0,2,W
233728,16,CHL1,2017-05-13,Santiago Wanderers,CD Cobresal,1,1,0,D
233729,16,CHL1,2017-05-13,Audax Italiano,Universidad de Concepcion,0,3,-3,L
233730,16,CHL1,2017-05-13,Universidad Catolica,Municipal Iquique,2,0,2,W
233731,16,CHL1,2017-05-14,San Luis,Union Espanola,3,2,1,W
233732,16,CHL1,2017-05-14,Deportes Temuco,CD Palestino,1,0,1,W
233733,16,CHL1,2017-05-14,Colo Colo,Antofagasta,1,1,0,D
233734,16,CHL1,2017-05-14,Higgins,Universidad de Chile,0,3,-3,L
233735,16,CHL1,2017-05-18,CD Huachipato,Santiago Wanderers,1,4,-3,L
233736,16,CHL1,2017-05-20,Union Espanola,Audax Italiano,1,1,0,D
233737,16,CHL1,2017-05-20,Municipal Iquique,Deportes Temuco,0,0,0,D
233738,16,CHL1,2017-05-20,Universidad de Chile,San Luis,1,0,1,W
233739,16,CHL1,2017-05-20,CD Cobresal,Colo Colo,1,3,-2,L
233740,16,CHL1,2017-05-21,Universidad de Concepcion,Universidad Catolica,0,0,0,D
233741,16,CHL1,2017-05-21,CD Palestino,Everton CD,1,0,1,W
233742,16,CHL1,2017-05-21,Antofagasta,Higgins,0,0,0,D
233743,18,CHL1,2018-02-02,Universidad Catolica,Deportes Temuco,2,1,1,W
233744,18,CHL1,2018-02-03,Antofagasta,Colo Colo,1,2,-1,L
233745,18,CHL1,2018-02-03,CD Palestino,Union La Calera,1,2,-1,L
233746,18,CHL1,2018-02-03,Universidad de Concepcion,Higgins,0,2,-2,L
233747,18,CHL1,2018-02-04,Everton,Municipal Iquique,2,3,-1,L
233748,18,CHL1,2018-02-04,Universidad de Chile,Union Espanola,1,2,-1,L
233749,18,CHL1,2018-02-04,Audax Italiano,CD Huachipato,2,4,-2,L
233750,18,CHL1,2018-02-05,San Luis,Curico Unido,1,0,1,W
233751,18,CHL1,2018-02-09,Union La Calera,Antofagasta,1,3,-2,L
233752,18,CHL1,2018-02-10,Union Espanola,CD Palestino,2,2,0,D
233753,18,CHL1,2018-02-10,Municipal Iquique,Universidad de Chile,1,2,-1,L
233754,18,CHL1,2018-02-10,Deportes Temuco,Universidad de Concepcion,1,1,0,D
233755,18,CHL1,2018-02-11,CD Huachipato,San Luis,1,1,0,D
233756,18,CHL1,2018-02-11,Curico Unido,Universidad Catolica,1,3,-2,L
233757,18,CHL1,2018-02-11,Colo Colo,Audax Italiano,3,2,1,W
233758,18,CHL1,2018-02-12,Higgins,Everton,1,2,-1,L
233759,18,CHL1,2018-02-16,Universidad de Chile,San Luis,3,0,3,W
233760,18,CHL1,2018-02-17,Everton,Universidad Catolica,0,1,-1,L
233761,18,CHL1,2018-02-17,CD Palestino,Colo Colo,2,1,1,W
233762,18,CHL1,2018-02-17,Universidad de Concepcion,Curico Unido,0,0,0,D
233763,18,CHL1,2018-02-18,Municipal Iquique,Union La Calera,0,1,-1,L
233764,18,CHL1,2018-02-18,Higgins,CD Huachipato,2,1,1,W
233765,18,CHL1,2018-02-18,Union Espanola,Antofagasta,1,1,0,D
233766,18,CHL1,2018-02-19,Audax Italiano,Deportes Temuco,1,1,0,D
233767,18,CHL1,2018-02-23,Colo Colo,Higgins,1,1,0,D
233768,18,CHL1,2018-02-24,CD Huachipato,Universidad de Concepcion,3,0,3,W
233769,18,CHL1,2018-02-24,San Luis,CD Palestino,0,1,-1,L
233770,18,CHL1,2018-02-24,Universidad Catolica,Union La Calera,1,0,1,W
233771,18,CHL1,2018-02-25,Antofagasta,Municipal Iquique,2,1,1,W
233772,18,CHL1,2018-02-25,Deportes Temuco,Universidad de Chile,0,1,-1,L
233773,18,CHL1,2018-02-25,Audax Italiano,Everton,1,0,1,W
233774,18,CHL1,2018-02-26,Curico Unido,Union Espanola,4,4,0,D
233775,18,CHL1,2018-03-02,CD Palestino,Audax Italiano,1,1,0,D
233776,18,CHL1,2018-03-02,Everton,San Luis,2,1,1,W
233777,18,CHL1,2018-03-03,Colo Colo,CD Huachipato,2,1,1,W
233778,18,CHL1,2018-03-03,Union Espanola,Universidad de Concepcion,2,3,-1,L
233779,18,CHL1,2018-03-04,Municipal Iquique,Universidad Catolica,0,1,-1,L
233780,18,CHL1,2018-03-04,Universidad de Chile,Antofagasta,2,0,2,W
233781,18,CHL1,2018-03-05,Union La Calera,Curico Unido,0,0,0,D
233782,18,CHL1,2018-03-06,Higgins,Deportes Temuco,2,0,2,W
233783,18,CHL1,2018-03-16,Deportes Temuco,CD Palestino,3,2,1,W
233784,18,CHL1,2018-03-17,Everton,Universidad de Chile,0,1,-1,L
233785,18,CHL1,2018-03-17,Curico Unido,Audax Italiano,3,0,3,W
233786,18,CHL1,2018-03-18,Universidad de Concepcion,Colo Colo,2,1,1,W
233787,18,CHL1,2018-03-18,San Luis,Municipal Iquique,0,0,0,D
233788,18,CHL1,2018-03-18,Antofagasta,Higgins,3,2,1,W
233789,18,CHL1,2018-03-18,Universidad Catolica,Union Espanola,3,1,2,W
233790,18,CHL1,2018-03-19,CD Huachipato,Union La Calera,2,0,2,W
233791,18,CHL1,2018-03-30,Audax Italiano,Universidad de Chile,2,3,-1,L
233792,18,CHL1,2018-03-31,Colo Colo,Universidad Catolica,1,0,1,W
233793,18,CHL1,2018-03-31,CD Huachipato,Everton,2,0,2,W
233794,18,CHL1,2018-03-31,Higgins,San Luis,4,0,4,W
233795,18,CHL1,2018-04-01,Curico Unido,Deportes Temuco,1,1,0,D
233796,18,CHL1,2018-04-01,Municipal Iquique,Universidad de Concepcion,1,3,-2,L
233797,18,CHL1,2018-04-01,CD Palestino,Antofagasta,1,1,0,D
233798,18,CHL1,2018-04-01,Union La Calera,Union Espanola,1,0,1,W
233799,18,CHL1,2018-04-07,Deportes Temuco,Municipal Iquique,0,4,-4,L
233800,18,CHL1,2018-04-07,Everton,Union La Calera,1,3,-2,L
233801,18,CHL1,2018-04-07,Antofagasta,CD Huachipato,0,0,0,D
233802,18,CHL1,2018-04-07,Universidad de Chile,Curico Unido,2,1,1,W
233803,18,CHL1,2018-04-08,Universidad de Concepcion,Audax Italiano,1,0,1,W
233804,18,CHL1,2018-04-08,San Luis,Colo Colo,1,0,1,W
233805,18,CHL1,2018-04-08,Universidad Catolica,CD Palestino,2,1,1,W
233806,18,CHL1,2018-04-09,Union Espanola,Higgins,2,0,2,W
233807,18,CHL1,2018-04-14,Union La Calera,Universidad de Concepcion,1,3,-2,L
233808,18,CHL1,2018-04-14,CD Palestino,Everton,2,1,1,W
233809,18,CHL1,2018-04-14,Higgins,Universidad Catolica,0,1,-1,L
233810,18,CHL1,2018-04-14,CD Huachipato,Deportes Temuco,0,0,0,D
233811,18,CHL1,2018-04-15,Curico Unido,Antofagasta,3,4,-1,L
233812,18,CHL1,2018-04-15,Universidad de Chile,Colo Colo,1,3,-2,L
233813,18,CHL1,2018-04-15,Municipal Iquique,Union Espanola,0,1,-1,L
233814,18,CHL1,2018-04-16,Audax Italiano,San Luis,1,1,0,D
233815,18,CHL1,2018-04-21,Union Espanola,CD Huachipato,2,1,1,W
233816,18,CHL1,2018-04-21,Municipal Iquique,CD Palestino,2,1,1,W
233817,18,CHL1,2018-04-21,Colo Colo,Deportes Temuco,2,0,2,W
233818,18,CHL1,2018-04-22,Universidad de Concepcion,Everton,2,0,2,W
233819,18,CHL1,2018-04-22,Higgins,Curico Unido,2,2,0,D
233820,18,CHL1,2018-04-22,Union La Calera,Universidad de Chile,6,1,5,W
233821,18,CHL1,2018-04-22,Universidad Catolica,Audax Italiano,1,0,1,W
233822,18,CHL1,2018-04-23,Antofagasta,San Luis,1,0,1,W
233823,18,CHL1,2018-04-28,Curico Unido,Colo Colo,0,0,0,D
233824,18,CHL1,2018-04-28,CD Huachipato,Municipal Iquique,2,2,0,D
233825,18,CHL1,2018-04-28,Everton,Union Espanola,1,1,0,D
233826,18,CHL1,2018-04-29,Audax Italiano,Antofagasta,0,0,0,D
233827,18,CHL1,2018-04-29,CD Palestino,Higgins,2,3,-1,L
233828,18,CHL1,2018-04-29,Deportes Temuco,Union La Calera,0,2,-2,L
233829,18,CHL1,2018-04-29,Universidad de Chile,Universidad de Concepcion,1,2,-1,L
233830,18,CHL1,2018-04-30,San Luis,Universidad Catolica,1,1,0,D
233831,18,CHL1,2018-05-05,Union Espanola,San Luis,4,0,4,W
233832,18,CHL1,2018-05-05,Municipal Iquique,Curico Unido,2,2,0,D
233833,18,CHL1,2018-05-05,Antofagasta,Deportes Temuco,3,2,1,W
233834,18,CHL1,2018-05-05,Union La Calera,Audax Italiano,1,0,1,W
233835,18,CHL1,2018-05-06,Universidad Catolica,CD Huachipato,3,1,2,W
233836,18,CHL1,2018-05-06,Higgins,Universidad de Chile,0,1,-1,L
233837,18,CHL1,2018-05-06,CD Palestino,Universidad de Concepcion,1,2,-1,L
233838,18,CHL1,2018-05-06,Colo Colo,Everton,3,1,2,W
233839,18,CHL1,2018-05-12,Colo Colo,Municipal Iquique,0,0,0,D
233840,18,CHL1,2018-05-12,San Luis,Union La Calera,1,2,-1,L
233841,18,CHL1,2018-05-12,CD Huachipato,CD Palestino,1,1,0,D
233842,18,CHL1,2018-05-13,Everton,Curico Unido,1,1,0,D
233843,18,CHL1,2018-05-13,Universidad Catolica,Universidad de Chile,1,1,0,D
233844,18,CHL1,2018-05-13,Deportes Temuco,Union Espanola,2,0,2,W
233845,18,CHL1,2018-05-13,Audax Italiano,Higgins,1,2,-1,L
233846,18,CHL1,2018-05-14,Universidad de Concepcion,Antofagasta,3,2,1,W
233847,18,CHL1,2018-05-19,Universidad de Chile,CD Palestino,1,2,-1,L
233848,18,CHL1,2018-05-19,Municipal Iquique,Audax Italiano,1,1,0,D
233849,18,CHL1,2018-05-19,Union La Calera,Higgins,4,0,4,W
233850,18,CHL1,2018-05-19,Union Espanola,Colo Colo,3,2,1,W
233851,18,CHL1,2018-05-20,Antofagasta,Everton,3,2,1,W
233852,18,CHL1,2018-05-20,Universidad de Concepcion,Universidad Catolica,0,0,0,D
233853,18,CHL1,2018-05-21,Curico Unido,CD Huachipato,2,1,1,W
233854,18,CHL1,2018-05-21,Deportes Temuco,San Luis,2,2,0,D
233855,18,CHL1,2018-05-26,San Luis,Universidad de Concepcion,0,3,-3,L
233856,18,CHL1,2018-05-26,CD Huachipato,Universidad de Chile,0,1,-1,L
233857,18,CHL1,2018-05-26,Higgins,Municipal Iquique,2,1,1,W
233858,18,CHL1,2018-05-27,Universidad Catolica,Antofagasta,0,0,0,D
233859,18,CHL1,2018-05-27,CD Palestino,Curico Unido,2,1,1,W
233860,18,CHL1,2018-05-27,Everton,Deportes Temuco,2,2,0,D
233861,18,CHL1,2018-05-27,Audax Italiano,Union Espanola,1,1,0,D
233862,18,CHL1,2018-05-29,Colo Colo,Union La Calera,0,2,-2,L
233863,18,CHL1,2018-07-21,Universidad de Concepcion,CD Palestino,3,2,1,W
233864,18,CHL1,2018-07-21,Union La Calera,Colo Colo,1,2,-1,L
233865,18,CHL1,2018-07-21,Deportes Temuco,Antofagasta,1,1,0,D
233866,18,CHL1,2018-07-21,Universidad Catolica,Municipal Iquique,2,2,0,D
233867,18,CHL1,2018-07-22,Union Espanola,Audax Italiano,2,4,-2,L
233868,18,CHL1,2018-07-22,Curico Unido,San Luis,1,0,1,W
233869,18,CHL1,2018-07-22,Universidad de Chile,CD Huachipato,2,2,0,D
233870,18,CHL1,2018-07-23,Everton,Higgins,0,1,-1,L
233871,18,CHL1,2018-07-28,CD Huachipato,Union Espanola,1,1,0,D
233872,18,CHL1,2018-07-28,CD Palestino,Universidad Catolica,2,2,0,D
233873,18,CHL1,2018-07-28,Antofagasta,Universidad de Chile,4,0,4,W
233874,18,CHL1,2018-07-29,Audax Italiano,Universidad de Concepcion,4,1,3,W
233875,18,CHL1,2018-07-29,Municipal Iquique,Everton,1,1,0,D
233876,18,CHL1,2018-07-29,San Luis,Deportes Temuco,1,2,-1,L
233877,18,CHL1,2018-07-29,Colo Colo,Curico Unido,2,0,2,W
233878,18,CHL1,2018-07-30,Higgins,Union La Calera,2,3,-1,L
233879,18,CHL1,2018-08-04,Union La Calera,CD Palestino,1,1,0,D
233880,18,CHL1,2018-08-04,Deportes Temuco,Colo Colo,1,0,1,W
233881,18,CHL1,2018-08-04,Universidad Catolica,Everton,2,1,1,W
233882,18,CHL1,2018-08-05,Universidad de Concepcion,CD Huachipato,1,0,1,W
233883,18,CHL1,2018-08-05,San Luis,Higgins,2,0,2,W
233884,18,CHL1,2018-08-05,Antofagasta,Curico Unido,2,0,2,W
233885,18,CHL1,2018-08-05,Universidad de Chile,Audax Italiano,1,2,-1,L
233886,18,CHL1,2018-08-06,Union Espanola,Municipal Iquique,0,0,0,D
233887,18,CHL1,2018-08-11,Everton,Universidad de Concepcion,1,0,1,W
233888,18,CHL1,2018-08-11,CD Palestino,Deportes Temuco,1,1,0,D
233889,18,CHL1,2018-08-11,Union La Calera,Universidad Catolica,2,2,0,D
233890,18,CHL1,2018-08-11,Union Espanola,Universidad de Chile,1,4,-3,L
233891,18,CHL1,2018-08-12,Curico Unido,Municipal Iquique,0,0,0,D
233892,18,CHL1,2018-08-12,Higgins,Antofagasta,0,3,-3,L
233893,18,CHL1,2018-08-12,Colo Colo,San Luis,3,2,1,W
233894,18,CHL1,2018-08-13,CD Huachipato,Audax Italiano,1,0,1,W
233895,18,CHL1,2018-08-18,Audax Italiano,CD Palestino,3,1,2,W
233896,18,CHL1,2018-08-18,San Luis,Union Espanola,0,2,-2,L
233897,18,CHL1,2018-08-18,Antofagasta,Union La Calera,0,2,-2,L
233898,18,CHL1,2018-08-18,Universidad de Chile,Higgins,1,0,1,W
233899,18,CHL1,2018-08-19,Everton,CD Huachipato,0,0,0,D
233900,18,CHL1,2018-08-19,Municipal Iquique,Colo Colo,2,1,1,W
233901,18,CHL1,2018-08-19,Universidad de Concepcion,Deportes Temuco,0,0,0,D
233902,18,CHL1,2018-08-19,Universidad Catolica,Curico Unido,2,1,1,W
233903,18,CHL1,2018-08-25,Curico Unido,Universidad de Concepcion,1,0,1,W
233904,18,CHL1,2018-08-25,Colo Colo,Universidad de Chile,1,0,1,W
233905,18,CHL1,2018-08-25,Deportes Temuco,Everton,1,1,0,D
233906,18,CHL1,2018-08-25,CD Huachipato,Antofagasta,0,0,0,D
233907,18,CHL1,2018-08-26,Higgins,Union Espanola,1,1,0,D
233908,18,CHL1,2018-08-26,CD Palestino,San Luis,0,1,-1,L
233909,18,CHL1,2018-08-26,Union La Calera,Municipal Iquique,1,0,1,W
233910,18,CHL1,2018-08-27,Audax Italiano,Universidad Catolica,0,0,0,D
233911,18,CHL1,2018-09-01,Universidad de Chile,Deportes Temuco,2,1,1,W
233912,18,CHL1,2018-09-01,Municipal Iquique,Higgins,3,1,2,W
233913,18,CHL1,2018-09-01,San Luis,Audax Italiano,0,0,0,D
233914,18,CHL1,2018-09-01,Union Espanola,Universidad Catolica,1,1,0,D
233915,18,CHL1,2018-09-02,Universidad de Concepcion,Union La Calera,2,1,1,W
233916,18,CHL1,2018-09-02,Everton,Colo Colo,4,2,2,W
233917,18,CHL1,2018-09-02,Antofagasta,CD Palestino,1,0,1,W
233918,18,CHL1,2018-09-02,CD Huachipato,Curico Unido,1,0,1,W
233919,18,CHL1,2018-09-22,Deportes Temuco,CD Huachipato,0,4,-4,L
233920,18,CHL1,2018-09-22,CD Palestino,Union Espanola,1,1,0,D
233921,18,CHL1,2018-09-22,Audax Italiano,Municipal Iquique,3,1,2,W
233922,18,CHL1,2018-09-22,Union La Calera,Everton,0,4,-4,L
233923,18,CHL1,2018-09-23,Universidad Catolica,San Luis,2,1,1,W
233924,18,CHL1,2018-09-23,Universidad de Concepcion,Universidad de Chile,3,1,2,W
233925,18,CHL1,2018-09-23,Curico Unido,Higgins,1,0,1,W
233926,18,CHL1,2018-09-23,Colo Colo,Antofagasta,3,4,-1,L
233927,18,CHL1,2018-09-29,San Luis,CD Huachipato,2,4,-2,L
233928,18,CHL1,2018-09-29,Municipal Iquique,Deportes Temuco,2,1,1,W
233929,18,CHL1,2018-09-29,Universidad de Chile,Union La Calera,1,0,1,W
233930,18,CHL1,2018-09-29,Higgins,CD Palestino,2,2,0,D
233931,18,CHL1,2018-09-30,Everton,Audax Italiano,1,0,1,W
233932,18,CHL1,2018-09-30,Universidad Catolica,Colo Colo,1,0,1,W
233933,18,CHL1,2018-09-30,Antofagasta,Universidad de Concepcion,1,0,1,W
233934,18,CHL1,2018-10-01,Union Espanola,Curico Unido,2,1,1,W
233935,18,CHL1,2018-10-06,Deportes Temuco,Higgins,0,1,-1,L
233936,18,CHL1,2018-10-06,CD Palestino,Universidad de Chile,1,3,-2,L
233937,18,CHL1,2018-10-06,CD Huachipato,Universidad Catolica,3,0,3,W
233938,18,CHL1,2018-10-07,Audax Italiano,Union La Calera,4,0,4,W
233939,18,CHL1,2018-10-07,Curico Unido,Everton,3,1,2,W
233940,18,CHL1,2018-10-07,San Luis,Antofagasta,1,1,0,D
233941,18,CHL1,2018-10-08,Colo Colo,Union Espanola,1,1,0,D
233942,18,CHL1,2018-10-09,Universidad de Concepcion,Municipal Iquique,3,0,3,W
233943,18,CHL1,2018-10-20,Union Espanola,Deportes Temuco,2,1,1,W
233944,18,CHL1,2018-10-20,Higgins,Colo Colo,1,1,0,D
233945,18,CHL1,2018-10-20,Curico Unido,CD Palestino,0,0,0,D
233946,18,CHL1,2018-10-20,Union La Calera,CD Huachipato,0,2,-2,L
233947,18,CHL1,2018-10-21,Universidad Catolica,Universidad de Concepcion,1,0,1,W
233948,18,CHL1,2018-10-21,Municipal Iquique,San Luis,2,2,0,D
233949,18,CHL1,2018-10-21,Antofagasta,Audax Italiano,1,1,0,D
233950,18,CHL1,2018-10-22,Universidad de Chile,Everton,2,0,2,W
233951,18,CHL1,2018-10-27,Universidad de Concepcion,Union Espanola,1,0,1,W
233952,18,CHL1,2018-10-27,Universidad de Chile,Universidad Catolica,2,0,2,W
233953,18,CHL1,2018-10-27,Union La Calera,San Luis,0,1,-1,L
233954,18,CHL1,2018-10-28,CD Huachipato,Higgins,0,1,-1,L
233955,18,CHL1,2018-10-28,CD Palestino,Municipal Iquique,5,1,4,W
233956,18,CHL1,2018-10-28,Everton,Antofagasta,3,2,1,W
233957,18,CHL1,2018-10-28,Audax Italiano,Colo Colo,1,1,0,D
233958,18,CHL1,2018-10-28,Deportes Temuco,Curico Unido,1,2,-1,L
233959,18,CHL1,2018-11-02,Higgins,Universidad de Concepcion,4,2,2,W
233960,18,CHL1,2018-11-03,Municipal Iquique,CD Huachipato,2,0,2,W
233961,18,CHL1,2018-11-03,Deportes Temuco,Audax Italiano,2,1,1,W
233962,18,CHL1,2018-11-03,Union Espanola,Everton,2,2,0,D
233963,18,CHL1,2018-11-04,Antofagasta,Universidad Catolica,1,1,0,D
233964,18,CHL1,2018-11-04,Curico Unido,Union La Calera,2,0,2,W
233965,18,CHL1,2018-11-04,Colo Colo,CD Palestino,0,0,0,D
233966,18,CHL1,2018-11-10,San Luis,Universidad de Chile,1,2,-1,L
233967,18,CHL1,2018-11-23,Audax Italiano,Curico Unido,4,1,3,W
233968,18,CHL1,2018-11-24,CD Huachipato,Colo Colo,1,2,-1,L
233969,18,CHL1,2018-11-24,Antofagasta,Union Espanola,1,1,0,D
233970,18,CHL1,2018-11-24,Everton,CD Palestino,3,0,3,W
233971,18,CHL1,2018-11-24,Union La Calera,Deportes Temuco,0,1,-1,L
233972,18,CHL1,2018-11-25,Universidad de Chile,Municipal Iquique,0,0,0,D
233973,18,CHL1,2018-11-25,Universidad de Concepcion,San Luis,2,0,2,W
233974,18,CHL1,2018-11-25,Universidad Catolica,Higgins,1,0,1,W
233975,18,CHL1,2018-11-28,San Luis,Everton,1,2,-1,L
233976,18,CHL1,2018-11-29,Union Espanola,Union La Calera,1,1,0,D
233977,18,CHL1,2018-11-29,Higgins,Audax Italiano,4,0,4,W
233978,18,CHL1,2018-12-02,Municipal Iquique,Antofagasta,0,2,-2,L
233979,18,CHL1,2018-12-02,Curico Unido,Universidad de Chile,1,2,-1,L
233980,18,CHL1,2018-12-02,Deportes Temuco,Universidad Catolica,1,2,-1,L
233981,18,CHL1,2018-12-02,CD Palestino,CD Huachipato,3,0,3,W
233982,18,CHL1,2018-12-02,Colo Colo,Universidad de Concepcion,0,2,-2,L
233983,19,CHL1,2019-02-15,Union La Calera,CD Palestino,2,0,2,W
233984,19,CHL1,2019-02-15,Coquimbo Unido,Universidad Catolica,1,2,-1,L
233985,19,CHL1,2019-02-16,Municipal Iquique,Curico Unido,0,0,0,D
233986,19,CHL1,2019-02-16,Universidad de Chile,CD Cobresal,1,1,0,D
233987,19,CHL1,2019-02-17,Universidad de Concepcion,Everton,0,0,0,D
233988,19,CHL1,2019-02-17,CD Huachipato,Higgins,2,1,1,W
233989,19,CHL1,2019-02-17,Union Espanola,Colo Colo,1,3,-2,L
233990,19,CHL1,2019-02-18,Audax Italiano,Antofagasta,0,3,-3,L
233991,19,CHL1,2019-02-22,Antofagasta,Union Espanola,1,2,-1,L
233992,19,CHL1,2019-02-22,Colo Colo,Universidad de Concepcion,1,0,1,W
233993,19,CHL1,2019-02-23,Everton,Union La Calera,1,2,-1,L
233994,19,CHL1,2019-02-23,Higgins,Universidad de Chile,1,0,1,W
233995,19,CHL1,2019-02-23,Curico Unido,Coquimbo Unido,0,0,0,D
233996,19,CHL1,2019-02-24,CD Cobresal,Audax Italiano,1,2,-1,L
233997,19,CHL1,2019-02-24,CD Palestino,CD Huachipato,3,1,2,W
233998,19,CHL1,2019-02-24,Universidad Catolica,Municipal Iquique,0,1,-1,L
233999,19,CHL1,2019-03-02,Audax Italiano,Universidad Catolica,0,2,-2,L
234000,19,CHL1,2019-03-02,Municipal Iquique,Higgins,1,3,-2,L
234001,19,CHL1,2019-03-02,Union Espanola,CD Palestino,1,0,1,W
234002,19,CHL1,2019-03-02,Universidad de Chile,CD Huachipato,3,0,3,W
234003,19,CHL1,2019-03-03,Coquimbo Unido,Everton,4,0,4,W
234004,19,CHL1,2019-03-03,Curico Unido,Colo Colo,3,4,-1,L
234005,19,CHL1,2019-03-04,Union La Calera,CD Cobresal,2,1,1,W
234006,19,CHL1,2019-03-08,Higgins,Coquimbo Unido,2,0,2,W
234007,19,CHL1,2019-03-09,CD Huachipato,Audax Italiano,2,0,2,W
234008,19,CHL1,2019-03-09,CD Palestino,Universidad de Concepcion,4,1,3,W
234009,19,CHL1,2019-03-09,Universidad Catolica,Union La Calera,1,0,1,W
234010,19,CHL1,2019-03-10,Everton,Municipal Iquique,2,0,2,W
234011,19,CHL1,2019-03-10,Universidad de Chile,Union Espanola,1,2,-1,L
234012,19,CHL1,2019-03-10,CD Cobresal,Colo Colo,0,0,0,D
234013,19,CHL1,2019-03-10,Antofagasta,Curico Unido,1,1,0,D
234014,19,CHL1,2019-03-15,Curico Unido,CD Cobresal,3,1,2,W
234015,19,CHL1,2019-03-15,Union Espanola,CD Huachipato,2,1,1,W
234016,19,CHL1,2019-03-16,Universidad de Concepcion,Universidad de Chile,2,1,1,W
234017,19,CHL1,2019-03-16,Audax Italiano,Higgins,2,2,0,D
234018,19,CHL1,2019-03-17,Colo Colo,Universidad Catolica,2,3,-1,L
234019,19,CHL1,2019-03-17,Municipal Iquique,CD Palestino,3,3,0,D
234020,19,CHL1,2019-03-17,Coquimbo Unido,Union La Calera,1,1,0,D
234021,19,CHL1,2019-03-17,Everton,Antofagasta,1,0,1,W
234022,19,CHL1,2019-03-25,Universidad de Concepcion,Antofagasta,1,1,0,D
234023,19,CHL1,2019-03-27,CD Palestino,Audax Italiano,1,2,-1,L
234024,19,CHL1,2019-03-29,Union La Calera,Universidad de Concepcion,3,1,2,W
234025,19,CHL1,2019-03-30,Colo Colo,Municipal Iquique,2,0,2,W
234026,19,CHL1,2019-03-30,Higgins,Union Espanola,0,2,-2,L
234027,19,CHL1,2019-03-31,Antofagasta,Universidad de Chile,3,1,2,W
234028,19,CHL1,2019-03-31,Universidad Catolica,Curico Unido,0,0,0,D
234029,19,CHL1,2019-04-01,CD Huachipato,Coquimbo Unido,0,0,0,D
234030,19,CHL1,2019-04-05,CD Palestino,Higgins,1,1,0,D
234031,19,CHL1,2019-04-06,CD Huachipato,CD Cobresal,3,1,2,W
234032,19,CHL1,2019-04-06,Coquimbo Unido,Colo Colo,2,0,2,W
234033,19,CHL1,2019-04-06,Universidad de Concepcion,Audax Italiano,1,0,1,W
234034,19,CHL1,2019-04-07,Municipal Iquique,Antofagasta,2,0,2,W
234035,19,CHL1,2019-04-07,Everton,Universidad Catolica,1,2,-1,L
234036,19,CHL1,2019-04-07,Universidad de Chile,Union La Calera,1,1,0,D
234037,19,CHL1,2019-04-08,Union Espanola,Curico Unido,2,1,1,W
234038,19,CHL1,2019-04-13,Curico Unido,Everton,2,2,0,D
234039,19,CHL1,2019-04-13,Municipal Iquique,Union Espanola,3,2,1,W
234040,19,CHL1,2019-04-13,Colo Colo,Higgins,3,2,1,W
234041,19,CHL1,2019-04-13,Audax Italiano,Coquimbo Unido,2,0,2,W
234042,19,CHL1,2019-04-14,Union La Calera,CD Huachipato,2,1,1,W
234043,19,CHL1,2019-04-14,Universidad Catolica,Universidad de Chile,4,0,4,W
234044,19,CHL1,2019-04-14,Antofagasta,CD Palestino,0,1,-1,L
234045,19,CHL1,2019-04-15,CD Cobresal,Universidad de Concepcion,1,0,1,W
234046,19,CHL1,2019-04-19,Universidad de Concepcion,Municipal Iquique,1,0,1,W
234047,19,CHL1,2019-04-19,Higgins,CD Cobresal,2,0,2,W
234048,19,CHL1,2019-04-20,CD Palestino,Universidad Catolica,1,2,-1,L
234049,19,CHL1,2019-04-20,CD Huachipato,Colo Colo,1,1,0,D
234050,19,CHL1,2019-04-21,Audax Italiano,Union La Calera,1,1,0,D
234051,19,CHL1,2019-04-21,Universidad de Chile,Curico Unido,3,3,0,D
234052,19,CHL1,2019-04-21,Antofagasta,Coquimbo Unido,0,1,-1,L
234053,19,CHL1,2019-04-22,Union Espanola,Everton,0,4,-4,L
234054,19,CHL1,2019-04-27,Colo Colo,Antofagasta,1,0,1,W
234055,19,CHL1,2019-04-27,Municipal Iquique,CD Cobresal,0,1,-1,L
234056,19,CHL1,2019-04-27,Everton,Universidad de Chile,1,1,0,D
234057,19,CHL1,2019-04-27,Curico Unido,CD Huachipato,4,2,2,W
234058,19,CHL1,2019-04-28,Union La Calera,Higgins,2,0,2,W
234059,19,CHL1,2019-04-28,Universidad Catolica,Universidad de Concepcion,3,1,2,W
234060,19,CHL1,2019-04-28,Union Espanola,Audax Italiano,0,2,-2,L
234061,19,CHL1,2019-04-29,Coquimbo Unido,CD Palestino,2,2,0,D
234062,19,CHL1,2019-05-03,CD Palestino,Everton,1,0,1,W
234063,19,CHL1,2019-05-04,Universidad de Concepcion,Curico Unido,1,2,-1,L
234064,19,CHL1,2019-05-04,Higgins,Universidad Catolica,1,0,1,W
234065,19,CHL1,2019-05-04,CD Huachipato,Municipal Iquique,1,1,0,D
234066,19,CHL1,2019-05-05,Coquimbo Unido,Union Espanola,2,0,2,W
234067,19,CHL1,2019-05-05,CD Cobresal,Antofagasta,2,2,0,D
234068,19,CHL1,2019-05-05,Union La Calera,Colo Colo,1,1,0,D
234069,19,CHL1,2019-05-05,Audax Italiano,Universidad de Chile,3,1,2,W
234070,19,CHL1,2019-05-11,Antofagasta,CD Huachipato,0,1,-1,L
234071,19,CHL1,2019-05-11,Municipal Iquique,Union La Calera,1,0,1,W
234072,19,CHL1,2019-05-11,Curico Unido,Higgins,2,1,1,W
234073,19,CHL1,2019-05-11,Colo Colo,CD Palestino,2,1,1,W
234074,19,CHL1,2019-05-12,Everton,Audax Italiano,0,2,-2,L
234075,19,CHL1,2019-05-12,CD Cobresal,Universidad Catolica,0,2,-2,L
234076,19,CHL1,2019-05-12,Union Espanola,Universidad de Concepcion,1,0,1,W
234077,19,CHL1,2019-05-13,Universidad de Chile,Coquimbo Unido,1,1,0,D
234078,19,CHL1,2019-05-17,CD Palestino,CD Cobresal,3,0,3,W
234079,19,CHL1,2019-05-17,Union La Calera,Union Espanola,1,2,-1,L
234080,19,CHL1,2019-05-18,Universidad Catolica,Antofagasta,5,1,4,W
234081,19,CHL1,2019-05-18,Universidad de Chile,Colo Colo,1,1,0,D
234082,19,CHL1,2019-05-18,Higgins,Everton,2,1,1,W
234083,19,CHL1,2019-05-19,CD Huachipato,Universidad de Concepcion,1,0,1,W
234084,19,CHL1,2019-05-19,Coquimbo Unido,Municipal Iquique,1,1,0,D
234085,19,CHL1,2019-05-19,Audax Italiano,Curico Unido,3,1,2,W
234086,19,CHL1,2019-05-24,CD Cobresal,Coquimbo Unido,4,1,3,W
234087,19,CHL1,2019-05-25,Everton,CD Huachipato,0,0,0,D
234088,19,CHL1,2019-05-25,Antofagasta,Union La Calera,1,1,0,D
234089,19,CHL1,2019-05-26,Colo Colo,Audax Italiano,3,0,3,W
234090,19,CHL1,2019-05-26,Municipal Iquique,Universidad de Chile,2,4,-2,L
234091,19,CHL1,2019-05-26,Curico Unido,CD Palestino,1,1,0,D
234092,19,CHL1,2019-05-26,Universidad de Concepcion,Higgins,1,1,0,D
234093,19,CHL1,2019-06-12,Universidad Catolica,Union Espanola,0,0,0,D
234094,19,CHL1,2019-06-13,Everton,CD Cobresal,2,1,1,W
234095,19,CHL1,2019-07-27,Coquimbo Unido,Universidad de Concepcion,2,2,0,D
234096,19,CHL1,2019-07-27,Union Espanola,CD Cobresal,1,3,-2,L
234097,19,CHL1,2019-07-27,CD Palestino,Universidad de Chile,1,1,0,D
234098,19,CHL1,2019-07-28,Audax Italiano,Municipal Iquique,3,1,2,W
234099,19,CHL1,2019-07-28,Higgins,Antofagasta,3,6,-3,L
234100,19,CHL1,2019-07-28,CD Huachipato,Universidad Catolica,0,1,-1,L
234101,19,CHL1,2019-07-28,Colo Colo,Everton,0,0,0,D
234102,19,CHL1,2019-07-29,Union La Calera,Curico Unido,2,0,2,W
234103,19,CHL1,2019-08-03,Union Espanola,Union La Calera,1,1,0,D
234104,19,CHL1,2019-08-03,Municipal Iquique,Coquimbo Unido,0,1,-1,L
234105,19,CHL1,2019-08-03,CD Cobresal,Higgins,2,1,1,W
234106,19,CHL1,2019-08-03,CD Huachipato,CD Palestino,0,2,-2,L
234107,19,CHL1,2019-08-04,Universidad de Chile,Audax Italiano,1,1,0,D
234108,19,CHL1,2019-08-04,Universidad de Concepcion,Universidad Catolica,0,3,-3,L
234109,19,CHL1,2019-08-04,Antofagasta,Everton,1,1,0,D
234110,19,CHL1,2019-08-04,Colo Colo,Curico Unido,0,1,-1,L
234111,19,CHL1,2019-08-10,Curico Unido,Universidad de Concepcion,4,2,2,W
234112,19,CHL1,2019-08-10,CD Cobresal,Municipal Iquique,0,1,-1,L
234113,19,CHL1,2019-08-10,Universidad de Chile,Antofagasta,1,0,1,W
234114,19,CHL1,2019-08-10,Everton,Union Espanola,1,0,1,W
234115,19,CHL1,2019-08-11,Audax Italiano,CD Huachipato,0,1,-1,L
234116,19,CHL1,2019-08-11,CD Palestino,Union La Calera,1,1,0,D
234117,19,CHL1,2019-08-11,Higgins,Colo Colo,1,0,1,W
234118,19,CHL1,2019-08-11,Universidad Catolica,Coquimbo Unido,1,1,0,D
234119,19,CHL1,2019-08-17,Colo Colo,Union Espanola,1,0,1,W
234120,19,CHL1,2019-08-17,Higgins,Municipal Iquique,4,1,3,W
234121,19,CHL1,2019-08-17,Coquimbo Unido,Curico Unido,2,1,1,W
234122,19,CHL1,2019-08-17,Universidad Catolica,Everton,1,0,1,W
234123,19,CHL1,2019-08-18,Universidad de Concepcion,CD Huachipato,1,1,0,D
234124,19,CHL1,2019-08-18,Union La Calera,Universidad de Chile,0,0,0,D
234125,19,CHL1,2019-08-18,Antofagasta,CD Cobresal,2,0,2,W
234126,19,CHL1,2019-08-18,Audax Italiano,CD Palestino,2,3,-1,L
234127,19,CHL1,2019-08-24,Union Espanola,Higgins,0,1,-1,L
234128,19,CHL1,2019-08-24,CD Cobresal,Union La Calera,1,0,1,W
234129,19,CHL1,2019-08-24,CD Palestino,Colo Colo,2,2,0,D
234130,19,CHL1,2019-08-24,Everton,Coquimbo Unido,0,2,-2,L
234131,19,CHL1,2019-08-25,Curico Unido,Audax Italiano,2,2,0,D
234132,19,CHL1,2019-08-25,Municipal Iquique,Universidad de Concepcion,2,2,0,D
234133,19,CHL1,2019-08-25,Universidad de Chile,Universidad Catolica,1,1,0,D
234134,19,CHL1,2019-08-25,CD Huachipato,Antofagasta,4,3,1,W
234135,19,CHL1,2019-08-31,Union La Calera,Everton,0,0,0,D
234136,19,CHL1,2019-08-31,Curico Unido,Municipal Iquique,1,2,-1,L
234137,19,CHL1,2019-08-31,Coquimbo Unido,Universidad de Chile,2,2,0,D
234138,19,CHL1,2019-09-01,Audax Italiano,Union Espanola,3,2,1,W
234139,19,CHL1,2019-09-01,Universidad de Concepcion,CD Palestino,0,0,0,D
234140,19,CHL1,2019-09-01,Antofagasta,Universidad Catolica,1,2,-1,L
234141,19,CHL1,2019-09-01,Higgins,CD Huachipato,0,3,-3,L
234142,19,CHL1,2019-09-02,Colo Colo,CD Cobresal,0,2,-2,L
234143,19,CHL1,2019-09-13,CD Huachipato,Curico Unido,2,0,2,W
234144,19,CHL1,2019-09-14,CD Palestino,Coquimbo Unido,2,0,2,W
234145,19,CHL1,2019-09-14,Municipal Iquique,Audax Italiano,1,3,-2,L
234146,19,CHL1,2019-09-14,Union Espanola,Universidad de Chile,1,1,0,D
234147,19,CHL1,2019-09-15,Universidad de Concepcion,Colo Colo,3,1,2,W
234148,19,CHL1,2019-09-15,CD Cobresal,Everton,2,1,1,W
234149,19,CHL1,2019-09-15,Universidad Catolica,Higgins,0,0,0,D
234150,19,CHL1,2019-09-16,Union La Calera,Antofagasta,2,3,-1,L
234151,19,CHL1,2019-09-28,Everton,Universidad de Concepcion,1,0,1,W
234152,19,CHL1,2019-09-28,Coquimbo Unido,Antofagasta,1,1,0,D
234153,19,CHL1,2019-09-28,Universidad de Chile,CD Palestino,2,3,-1,L
234154,19,CHL1,2019-09-28,Curico Unido,Universidad Catolica,1,4,-3,L
234155,19,CHL1,2019-09-29,Union Espanola,Municipal Iquique,4,0,4,W
234156,19,CHL1,2019-09-29,Audax Italiano,Colo Colo,2,4,-2,L
234157,19,CHL1,2019-09-29,CD Cobresal,CD Huachipato,1,1,0,D
234158,19,CHL1,2019-09-30,Higgins,Union La Calera,3,1,2,W
234159,19,CHL1,2019-10-05,CD Huachipato,Union La Calera,1,2,-1,L
234160,19,CHL1,2019-10-05,Antofagasta,Higgins,3,1,2,W
234161,19,CHL1,2019-10-05,Colo Colo,Universidad de Chile,3,2,1,W
234162,19,CHL1,2019-10-05,Universidad de Concepcion,Union Espanola,1,1,0,D
234163,19,CHL1,2019-10-06,Municipal Iquique,Everton,0,0,0,D
234164,19,CHL1,2019-10-06,CD Palestino,Curico Unido,4,2,2,W
234165,19,CHL1,2019-10-06,Universidad Catolica,CD Cobresal,5,0,5,W
234166,19,CHL1,2019-10-07,Coquimbo Unido,Audax Italiano,1,0,1,W
234167,19,CHL1,2019-10-13,Higgins,Universidad de Concepcion,1,2,-1,L
234168,19,CHL1,2019-10-15,CD Cobresal,CD Palestino,3,2,1,W
234169,19,CHL1,2019-10-15,Union Espanola,Coquimbo Unido,3,1,2,W
234170,19,CHL1,2019-10-16,Antofagasta,Audax Italiano,1,0,1,W
234171,19,CHL1,2019-10-16,Union La Calera,Universidad Catolica,1,0,1,W
234172,19,CHL1,2019-10-17,Colo Colo,CD Huachipato,2,2,0,D
234173,19,CHL1,2019-10-17,Everton,Curico Unido,2,1,1,W
234174,19,CHL1,2019-10-18,Universidad de Chile,Municipal Iquique,2,1,1,W
234175,19,CHL1,2019-11-22,CD Cobresal,Union Espanola,3,2,1,W
234176,20,CHL1,2020-01-24,Everton,Universidad de Concepcion,2,1,1,W
234177,20,CHL1,2020-01-25,Higgins,Union La Calera,1,2,-1,L
234178,20,CHL1,2020-01-25,Antofagasta,Coquimbo Unido,2,1,1,W
234179,20,CHL1,2020-01-25,Audax Italiano,CD Cobresal,4,1,3,W
234180,20,CHL1,2020-01-26,Santiago Wanderers,Universidad Catolica,0,3,-3,L
234181,20,CHL1,2020-01-26,CD Huachipato,Universidad de Chile,2,1,1,W
234182,20,CHL1,2020-01-26,Union Espanola,Municipal Iquique,3,2,1,W
234183,20,CHL1,2020-01-28,Curico Unido,La Serena,1,0,1,W
234184,20,CHL1,2020-01-28,Colo Colo,CD Palestino,3,0,3,W
234185,20,CHL1,2020-02-01,Union La Calera,Union Espanola,1,0,1,W
234186,20,CHL1,2020-02-01,Universidad de Concepcion,Santiago Wanderers,0,2,-2,L
234187,20,CHL1,2020-02-01,CD Palestino,CD Huachipato,1,0,1,W
234188,20,CHL1,2020-02-01,Universidad de Chile,Curico Unido,5,1,4,W
234189,20,CHL1,2020-02-02,CD Cobresal,Colo Colo,2,1,1,W
234190,20,CHL1,2020-02-02,Universidad Catolica,Higgins,3,2,1,W
234191,20,CHL1,2020-02-02,Municipal Iquique,Everton,2,2,0,D
234192,20,CHL1,2020-02-03,La Serena,Antofagasta,0,1,-1,L
234193,20,CHL1,2020-02-08,La Serena,CD Cobresal,1,2,-1,L
234194,20,CHL1,2020-02-08,CD Huachipato,Universidad de Concepcion,1,1,0,D
234195,20,CHL1,2020-02-08,Universidad de Chile,Union La Calera,3,0,3,W
234196,20,CHL1,2020-02-08,Curico Unido,Municipal Iquique,1,0,1,W
234197,20,CHL1,2020-02-09,Antofagasta,Universidad Catolica,2,3,-1,L
234198,20,CHL1,2020-02-09,Audax Italiano,Colo Colo,2,1,1,W
234199,20,CHL1,2020-02-09,Union Espanola,CD Palestino,1,1,0,D
234200,20,CHL1,2020-02-10,Higgins,Santiago Wanderers,2,1,1,W
234201,20,CHL1,2020-02-10,Everton,Coquimbo Unido,1,0,1,W
234202,20,CHL1,2020-02-14,Union La Calera,La Serena,2,1,1,W
234203,20,CHL1,2020-02-15,Santiago Wanderers,Universidad de Chile,1,2,-1,L
234204,20,CHL1,2020-02-15,CD Palestino,Higgins,0,0,0,D
234205,20,CHL1,2020-02-16,Municipal Iquique,Antofagasta,0,4,-4,L
234206,20,CHL1,2020-02-16,CD Cobresal,Everton,1,1,0,D
234207,20,CHL1,2020-02-17,Universidad de Concepcion,Curico Unido,1,2,-1,L
234208,20,CHL1,2020-02-17,Union Espanola,Audax Italiano,1,2,-1,L
234209,20,CHL1,2020-02-21,Antofagasta,Universidad de Concepcion,1,1,0,D
234210,20,CHL1,2020-02-21,Universidad Catolica,Municipal Iquique,3,1,2,W
234211,20,CHL1,2020-02-22,CD Huachipato,CD Cobresal,1,0,1,W
234212,20,CHL1,2020-02-22,Everton,Union La Calera,0,1,-1,L
234213,20,CHL1,2020-02-23,La Serena,Santiago Wanderers,3,0,3,W
234214,20,CHL1,2020-02-23,Universidad de Chile,Coquimbo Unido,1,1,0,D
234215,20,CHL1,2020-02-23,Audax Italiano,CD Palestino,0,1,-1,L
234216,20,CHL1,2020-02-24,Curico Unido,Colo Colo,1,0,1,W
234217,20,CHL1,2020-02-24,Higgins,Union Espanola,1,3,-2,L
234218,20,CHL1,2020-02-28,Union La Calera,Universidad Catolica,1,1,0,D
234219,20,CHL1,2020-02-29,CD Cobresal,Municipal Iquique,1,1,0,D
234220,20,CHL1,2020-02-29,Colo Colo,Universidad de Concepcion,2,2,0,D
234221,20,CHL1,2020-02-29,Union Espanola,Everton,2,0,2,W
234222,20,CHL1,2020-03-01,Coquimbo Unido,La Serena,2,1,1,W
234223,20,CHL1,2020-03-01,Higgins,Universidad de Chile,2,3,-1,L
234224,20,CHL1,2020-03-01,CD Palestino,Antofagasta,2,2,0,D
234225,20,CHL1,2020-03-02,Curico Unido,CD Huachipato,1,0,1,W
234226,20,CHL1,2020-03-03,Santiago Wanderers,Audax Italiano,3,3,0,D
234227,20,CHL1,2020-03-05,Universidad de Chile,Everton,0,0,0,D
234228,20,CHL1,2020-03-05,Universidad de Concepcion,CD Cobresal,2,2,0,D
234229,20,CHL1,2020-03-07,La Serena,Colo Colo,1,2,-1,L
234230,20,CHL1,2020-03-07,Antofagasta,Curico Unido,0,0,0,D
234231,20,CHL1,2020-03-07,Municipal Iquique,Higgins,1,0,1,W
234232,20,CHL1,2020-03-09,Union La Calera,Coquimbo Unido,2,0,2,W
234233,20,CHL1,2020-03-10,Santiago Wanderers,CD Palestino,1,2,-1,L
234234,20,CHL1,2020-03-10,CD Huachipato,Audax Italiano,2,1,1,W
234235,20,CHL1,2020-03-14,CD Cobresal,Universidad Catolica,0,1,-1,L
234236,20,CHL1,2020-03-14,Everton,La Serena,0,0,0,D
234237,20,CHL1,2020-03-15,Coquimbo Unido,Municipal Iquique,0,3,-3,L
234238,20,CHL1,2020-03-15,Union Espanola,CD Huachipato,4,4,0,D
234239,20,CHL1,2020-03-15,Audax Italiano,Universidad de Concepcion,1,1,0,D
234240,20,CHL1,2020-08-29,Coquimbo Unido,CD Huachipato,1,2,-1,L
234241,20,CHL1,2020-08-29,Universidad Catolica,Union Espanola,0,1,-1,L
234242,20,CHL1,2020-08-29,Colo Colo,Santiago Wanderers,2,3,-1,L
234243,20,CHL1,2020-08-30,Higgins,Antofagasta,0,1,-1,L
234244,20,CHL1,2020-08-30,CD Palestino,Universidad de Chile,2,2,0,D
234245,20,CHL1,2020-08-30,Curico Unido,Union La Calera,0,2,-2,L
234246,20,CHL1,2020-09-01,Coquimbo Unido,Audax Italiano,0,0,0,D
234247,20,CHL1,2020-09-03,Universidad de Concepcion,Union Espanola,2,3,-1,L
234248,20,CHL1,2020-09-03,CD Palestino,Everton,1,0,1,W
234249,20,CHL1,2020-09-04,Union La Calera,CD Cobresal,2,2,0,D
234250,20,CHL1,2020-09-04,La Serena,Higgins,1,1,0,D
234251,20,CHL1,2020-09-05,Municipal Iquique,CD Huachipato,1,0,1,W
234252,20,CHL1,2020-09-05,Universidad Catolica,Coquimbo Unido,4,1,3,W
234253,20,CHL1,2020-09-05,Santiago Wanderers,Curico Unido,2,0,2,W
234254,20,CHL1,2020-09-06,Antofagasta,Audax Italiano,2,2,0,D
234255,20,CHL1,2020-09-06,Universidad de Chile,Colo Colo,1,1,0,D
234256,20,CHL1,2020-09-08,Universidad de Concepcion,Union La Calera,2,1,1,W
234257,20,CHL1,2020-09-08,Union Espanola,Santiago Wanderers,2,1,1,W
234258,20,CHL1,2020-09-09,CD Huachipato,Universidad Catolica,1,3,-2,L
234259,20,CHL1,2020-09-09,CD Cobresal,Curico Unido,4,0,4,W
234260,20,CHL1,2020-09-09,Colo Colo,Higgins,0,1,-1,L
234261,20,CHL1,2020-09-09,Coquimbo Unido,CD Palestino,1,0,1,W
234262,20,CHL1,2020-09-10,Audax Italiano,La Serena,2,1,1,W
234263,20,CHL1,2020-09-10,Municipal Iquique,Universidad de Chile,0,2,-2,L
234264,20,CHL1,2020-09-10,Everton,Antofagasta,0,0,0,D
234265,20,CHL1,2020-09-12,Union La Calera,Colo Colo,0,0,0,D
234266,20,CHL1,2020-09-13,Santiago Wanderers,CD Huachipato,3,2,1,W
234267,20,CHL1,2020-09-13,Universidad Catolica,Audax Italiano,3,0,3,W
234268,20,CHL1,2020-09-13,Higgins,Everton,1,2,-1,L
234269,20,CHL1,2020-09-14,Universidad de Chile,CD Cobresal,2,1,1,W
234270,20,CHL1,2020-09-15,La Serena,Universidad de Concepcion,0,1,-1,L
234271,20,CHL1,2020-09-15,Curico Unido,Coquimbo Unido,2,1,1,W
234272,20,CHL1,2020-09-16,CD Palestino,Municipal Iquique,2,0,2,W
234273,20,CHL1,2020-09-17,Antofagasta,Union Espanola,2,0,2,W
234274,20,CHL1,2020-09-24,Municipal Iquique,Union La Calera,0,3,-3,L
234275,20,CHL1,2020-09-24,Universidad de Concepcion,Higgins,1,4,-3,L
234276,20,CHL1,2020-09-24,CD Cobresal,CD Palestino,2,1,1,W
234277,20,CHL1,2020-09-25,Coquimbo Unido,Santiago Wanderers,2,1,1,W
234278,20,CHL1,2020-09-25,CD Huachipato,La Serena,1,1,0,D
234279,20,CHL1,2020-09-26,Everton,Universidad Catolica,2,2,0,D
234280,20,CHL1,2020-09-26,Audax Italiano,Curico Unido,0,0,0,D
234281,20,CHL1,2020-09-27,Union Espanola,Universidad de Chile,3,1,2,W
234282,20,CHL1,2020-10-01,CD Palestino,Universidad de Concepcion,0,1,-1,L
234283,20,CHL1,2020-10-02,Santiago Wanderers,Municipal Iquique,3,1,2,W
234284,20,CHL1,2020-10-02,Higgins,Coquimbo Unido,1,4,-3,L
234285,20,CHL1,2020-10-03,La Serena,Union Espanola,0,2,-2,L
234286,20,CHL1,2020-10-03,Antofagasta,CD Cobresal,2,1,1,W
234287,20,CHL1,2020-10-03,Curico Unido,Everton,1,3,-2,L
234288,20,CHL1,2020-10-03,Colo Colo,CD Huachipato,0,1,-1,L
234289,20,CHL1,2020-10-04,Universidad Catolica,Universidad de Chile,3,0,3,W
234290,20,CHL1,2020-10-04,Union La Calera,Audax Italiano,3,2,1,W
234291,20,CHL1,2020-10-08,Higgins,CD Cobresal,0,2,-2,L
234292,20,CHL1,2020-10-09,Union Espanola,Curico Unido,2,1,1,W
234293,20,CHL1,2020-10-09,Coquimbo Unido,Colo Colo,2,2,0,D
234294,20,CHL1,2020-10-10,Municipal Iquique,Audax Italiano,2,1,1,W
234295,20,CHL1,2020-10-10,CD Huachipato,Antofagasta,0,0,0,D
234296,20,CHL1,2020-10-10,Everton,Santiago Wanderers,2,2,0,D
234297,20,CHL1,2020-10-10,Universidad Catolica,Universidad de Concepcion,1,1,0,D
234298,20,CHL1,2020-10-11,Union La Calera,CD Palestino,1,0,1,W
234299,20,CHL1,2020-10-11,Universidad de Chile,La Serena,3,0,3,W
234300,20,CHL1,2020-10-14,La Serena,CD Palestino,4,2,2,W
234301,20,CHL1,2020-10-14,CD Cobresal,Coquimbo Unido,0,1,-1,L
234302,20,CHL1,2020-10-14,CD Huachipato,Everton,1,0,1,W
234303,20,CHL1,2020-10-14,Colo Colo,Union Espanola,3,5,-2,L
234304,20,CHL1,2020-10-15,Universidad de Concepcion,Municipal Iquique,1,1,0,D
234305,20,CHL1,2020-10-15,Santiago Wanderers,Union La Calera,0,3,-3,L
234306,20,CHL1,2020-10-15,Antofagasta,Universidad de Chile,1,0,1,W
234307,20,CHL1,2020-10-15,Audax Italiano,Higgins,2,1,1,W
234308,20,CHL1,2020-10-20,Municipal Iquique,La Serena,2,0,2,W
234309,20,CHL1,2020-10-20,Union La Calera,CD Huachipato,3,0,3,W
234310,20,CHL1,2020-10-20,Higgins,Curico Unido,2,2,0,D
234311,20,CHL1,2020-10-21,Santiago Wanderers,Antofagasta,2,1,1,W
234312,20,CHL1,2020-10-21,Coquimbo Unido,Universidad de Concepcion,0,2,-2,L
234313,20,CHL1,2020-10-21,Universidad de Chile,Audax Italiano,2,2,0,D
234314,20,CHL1,2020-10-21,Union Espanola,CD Cobresal,1,0,1,W
234315,20,CHL1,2020-10-28,Everton,Colo Colo,1,1,0,D
234316,20,CHL1,2020-10-29,CD Cobresal,Santiago Wanderers,1,0,1,W
234317,20,CHL1,2020-10-29,Universidad de Concepcion,Universidad de Chile,1,0,1,W
234318,20,CHL1,2020-10-30,Antofagasta,Union La Calera,3,1,2,W
234319,20,CHL1,2020-10-31,Colo Colo,Municipal Iquique,0,2,-2,L
234320,20,CHL1,2020-10-31,CD Huachipato,Higgins,2,0,2,W
234321,20,CHL1,2020-10-31,Curico Unido,CD Palestino,1,0,1,W
234322,20,CHL1,2020-10-31,Audax Italiano,Everton,1,2,-1,L
234323,20,CHL1,2020-11-01,Coquimbo Unido,Union Espanola,1,1,0,D
234324,20,CHL1,2020-11-01,Universidad Catolica,La Serena,3,0,3,W
234325,20,CHL1,2020-11-08,CD Palestino,Universidad Catolica,1,4,-3,L
234326,20,CHL1,2020-11-10,Colo Colo,Antofagasta,1,0,1,W
234327,20,CHL1,2020-11-11,Curico Unido,Universidad Catolica,3,2,1,W
234328,20,CHL1,2020-11-13,Everton,Higgins,0,1,-1,L
234329,20,CHL1,2020-11-14,CD Palestino,Colo Colo,3,1,2,W
234330,20,CHL1,2020-11-14,Municipal Iquique,Curico Unido,1,2,-1,L
234331,20,CHL1,2020-11-14,Union Espanola,Union La Calera,3,2,1,W
234332,20,CHL1,2020-11-15,Audax Italiano,Coquimbo Unido,2,0,2,W
234333,20,CHL1,2020-11-15,Universidad de Concepcion,Antofagasta,2,0,2,W
234334,20,CHL1,2020-11-15,La Serena,CD Huachipato,1,0,1,W
234335,20,CHL1,2020-11-15,Universidad de Chile,Santiago Wanderers,3,0,3,W
234336,20,CHL1,2020-11-16,Universidad Catolica,CD Cobresal,2,1,1,W
234337,20,CHL1,2020-11-17,Higgins,CD Palestino,1,0,1,W
234338,20,CHL1,2020-11-18,Curico Unido,Universidad de Concepcion,2,2,0,D
234339,20,CHL1,2020-11-18,CD Cobresal,La Serena,1,2,-1,L
234340,20,CHL1,2020-11-18,Union La Calera,Universidad de Chile,1,0,1,W
234341,20,CHL1,2020-11-19,Coquimbo Unido,Universidad Catolica,2,1,1,W
234342,20,CHL1,2020-11-19,Antofagasta,Everton,1,1,0,D
234343,20,CHL1,2020-11-19,CD Huachipato,Municipal Iquique,1,1,0,D
234344,20,CHL1,2020-11-19,Colo Colo,Audax Italiano,1,0,1,W
234345,20,CHL1,2020-11-20,Santiago Wanderers,Union Espanola,1,0,1,W
234346,20,CHL1,2020-11-21,Coquimbo Unido,Union La Calera,1,2,-1,L
234347,20,CHL1,2020-11-22,CD Palestino,La Serena,1,3,-2,L
234348,20,CHL1,2020-11-22,Everton,Universidad de Chile,1,1,0,D
234349,20,CHL1,2020-11-23,Universidad Catolica,Antofagasta,5,3,2,W
234350,20,CHL1,2020-11-23,Municipal Iquique,CD Cobresal,0,0,0,D
234351,20,CHL1,2020-11-23,Universidad de Concepcion,CD Huachipato,0,1,-1,L
234352,20,CHL1,2020-11-24,Union Espanola,Higgins,0,2,-2,L
234353,20,CHL1,2020-11-25,Audax Italiano,Santiago Wanderers,1,1,0,D
234354,20,CHL1,2020-11-25,Colo Colo,Curico Unido,0,2,-2,L
234355,20,CHL1,2020-12-02,Antofagasta,CD Palestino,1,1,0,D
234356,20,CHL1,2020-12-03,Curico Unido,Audax Italiano,4,1,3,W
234357,20,CHL1,2020-12-03,Union Espanola,Universidad de Concepcion,1,1,0,D
234358,20,CHL1,2020-12-04,CD Cobresal,Higgins,1,1,0,D
234359,20,CHL1,2020-12-04,La Serena,Municipal Iquique,1,0,1,W
234360,20,CHL1,2020-12-05,CD Huachipato,Colo Colo,2,2,0,D
234361,20,CHL1,2020-12-06,Santiago Wanderers,Coquimbo Unido,1,1,0,D
234362,20,CHL1,2020-12-06,Union La Calera,Everton,6,2,4,W
234363,20,CHL1,2020-12-08,CD Cobresal,Universidad de Concepcion,3,1,2,W
234364,20,CHL1,2020-12-08,Municipal Iquique,Union Espanola,1,1,0,D
234365,20,CHL1,2020-12-08,Colo Colo,La Serena,0,2,-2,L
234366,20,CHL1,2020-12-09,Higgins,CD Huachipato,2,1,1,W
234367,20,CHL1,2020-12-09,CD Palestino,Union La Calera,3,1,2,W
234368,20,CHL1,2020-12-09,Audax Italiano,Universidad de Chile,1,3,-2,L
234369,20,CHL1,2020-12-11,Everton,Curico Unido,3,1,2,W
234370,20,CHL1,2020-12-12,Union Espanola,Colo Colo,1,2,-1,L
234371,20,CHL1,2020-12-12,Universidad de Concepcion,Audax Italiano,3,1,2,W
234372,20,CHL1,2020-12-13,La Serena,Coquimbo Unido,1,0,1,W
234373,20,CHL1,2020-12-13,Santiago Wanderers,Everton,2,1,1,W
234374,20,CHL1,2020-12-14,Antofagasta,CD Huachipato,2,1,1,W
234375,20,CHL1,2020-12-14,Curico Unido,CD Cobresal,0,1,-1,L
234376,20,CHL1,2020-12-16,CD Palestino,Santiago Wanderers,3,1,2,W
234377,20,CHL1,2020-12-16,Municipal Iquique,Universidad de Concepcion,4,0,4,W
234378,20,CHL1,2020-12-16,Everton,Union Espanola,1,2,-1,L
234379,20,CHL1,2020-12-17,Audax Italiano,Antofagasta,3,0,3,W
234380,20,CHL1,2020-12-17,La Serena,Universidad de Chile,0,0,0,D
234381,20,CHL1,2020-12-17,CD Huachipato,Curico Unido,1,0,1,W
234382,20,CHL1,2020-12-19,Universidad Catolica,Colo Colo,0,0,0,D
234383,20,CHL1,2020-12-20,CD Palestino,Audax Italiano,1,0,1,W
234384,20,CHL1,2020-12-20,Antofagasta,Santiago Wanderers,1,1,0,D
234385,20,CHL1,2020-12-20,Universidad de Chile,CD Huachipato,2,2,0,D
234386,20,CHL1,2020-12-21,Coquimbo Unido,Higgins,0,3,-3,L
234387,20,CHL1,2020-12-21,Universidad de Concepcion,La Serena,0,2,-2,L
234388,20,CHL1,2020-12-22,Everton,CD Cobresal,3,0,3,W
234389,20,CHL1,2020-12-23,Universidad de Chile,Universidad Catolica,0,0,0,D
234390,20,CHL1,2020-12-23,Coquimbo Unido,Antofagasta,0,1,-1,L
234391,20,CHL1,2020-12-26,Santiago Wanderers,Higgins,1,0,1,W
234392,20,CHL1,2020-12-27,Union Espanola,Antofagasta,1,1,0,D
234393,20,CHL1,2020-12-27,CD Huachipato,Coquimbo Unido,0,1,-1,L
234394,20,CHL1,2020-12-27,Audax Italiano,Universidad Catolica,2,2,0,D
234395,20,CHL1,2020-12-28,Municipal Iquique,CD Palestino,0,2,-2,L
234396,20,CHL1,2020-12-28,CD Cobresal,Universidad de Chile,2,0,2,W
234397,20,CHL1,2020-12-28,Universidad de Concepcion,Everton,0,0,0,D
234398,20,CHL1,2020-12-30,Universidad Catolica,Santiago Wanderers,1,1,0,D
234399,20,CHL1,2020-12-30,Union La Calera,Higgins,0,1,-1,L
234400,20,CHL1,2021-01-02,Higgins,La Serena,1,1,0,D
234401,20,CHL1,2021-01-02,Everton,Municipal Iquique,1,0,1,W
234402,20,CHL1,2021-01-02,Union La Calera,Santiago Wanderers,3,0,3,W
234403,20,CHL1,2021-01-03,Antofagasta,Colo Colo,0,1,-1,L
234404,20,CHL1,2021-01-03,Universidad de Chile,Universidad de Concepcion,2,0,2,W
234405,20,CHL1,2021-01-04,CD Palestino,Curico Unido,4,2,2,W
234406,20,CHL1,2021-01-04,Universidad Catolica,CD Huachipato,3,0,3,W
234407,20,CHL1,2021-01-05,Audax Italiano,Union Espanola,2,2,0,D
234408,20,CHL1,2021-01-06,Santiago Wanderers,Colo Colo,3,0,3,W
234409,20,CHL1,2021-01-06,La Serena,Everton,1,1,0,D
234410,20,CHL1,2021-01-06,Universidad de Chile,Higgins,0,1,-1,L
234411,20,CHL1,2021-01-07,Curico Unido,Antofagasta,2,0,2,W
234412,20,CHL1,2021-01-07,Universidad de Concepcion,CD Palestino,1,1,0,D
234413,20,CHL1,2021-01-07,CD Huachipato,Union La Calera,4,3,1,W
234414,20,CHL1,2021-01-08,Municipal Iquique,Universidad Catolica,0,1,-1,L
234415,20,CHL1,2021-01-08,CD Cobresal,Audax Italiano,1,2,-1,L
234416,20,CHL1,2021-01-10,Universidad Catolica,Curico Unido,1,1,0,D
234417,20,CHL1,2021-01-10,Colo Colo,Everton,1,0,1,W
234418,20,CHL1,2021-01-11,Union La Calera,Universidad de Concepcion,1,2,-1,L
234419,20,CHL1,2021-01-11,CD Palestino,Union Espanola,2,2,0,D
234420,20,CHL1,2021-01-11,Antofagasta,La Serena,2,2,0,D
234421,20,CHL1,2021-01-11,Santiago Wanderers,CD Cobresal,1,0,1,W
234422,20,CHL1,2021-01-12,Audax Italiano,CD Huachipato,2,0,2,W
234423,20,CHL1,2021-01-12,Higgins,Municipal Iquique,2,2,0,D
234424,20,CHL1,2021-01-13,Universidad de Concepcion,Colo Colo,1,1,0,D
234425,20,CHL1,2021-01-14,Everton,Audax Italiano,2,1,1,W
234426,20,CHL1,2021-01-14,Universidad de Chile,CD Palestino,1,1,0,D
234427,20,CHL1,2021-01-15,Union Espanola,Universidad Catolica,1,1,0,D
234428,20,CHL1,2021-01-15,CD Cobresal,Antofagasta,3,1,2,W
234429,20,CHL1,2021-01-15,La Serena,Union La Calera,0,3,-3,L
234430,20,CHL1,2021-01-15,Curico Unido,Higgins,1,3,-2,L
234431,20,CHL1,2021-01-16,CD Huachipato,Santiago Wanderers,4,0,4,W
234432,20,CHL1,2021-01-17,Colo Colo,Universidad de Chile,0,0,0,D
234433,20,CHL1,2021-01-18,CD Palestino,CD Cobresal,3,2,1,W
234434,20,CHL1,2021-01-18,Santiago Wanderers,La Serena,0,0,0,D
234435,20,CHL1,2021-01-18,Audax Italiano,Union La Calera,1,3,-2,L
234436,20,CHL1,2021-01-19,Antofagasta,Municipal Iquique,3,1,2,W
234437,20,CHL1,2021-01-19,CD Huachipato,Union Espanola,4,1,3,W
234438,20,CHL1,2021-01-19,Universidad Catolica,Everton,1,1,0,D
234439,20,CHL1,2021-01-20,Higgins,Universidad de Concepcion,0,0,0,D
234440,20,CHL1,2021-01-21,Coquimbo Unido,Curico Unido,0,0,0,D
234441,20,CHL1,2021-01-23,Colo Colo,Coquimbo Unido,2,1,1,W
234442,20,CHL1,2021-01-23,CD Cobresal,Union La Calera,1,1,0,D
234443,20,CHL1,2021-01-24,Universidad de Chile,Municipal Iquique,2,2,0,D
234444,20,CHL1,2021-01-24,La Serena,Curico Unido,2,0,2,W
234445,20,CHL1,2021-01-25,Universidad Catolica,CD Palestino,2,3,-1,L
234446,20,CHL1,2021-01-26,Union Espanola,Coquimbo Unido,0,1,-1,L
234447,20,CHL1,2021-01-28,Union La Calera,Municipal Iquique,1,2,-1,L
234448,20,CHL1,2021-01-29,Coquimbo Unido,Universidad de Chile,0,1,-1,L
234449,20,CHL1,2021-01-30,Higgins,Universidad Catolica,2,0,2,W
234450,20,CHL1,2021-01-31,Colo Colo,Union La Calera,2,1,1,W
234451,20,CHL1,2021-02-01,Curico Unido,Union Espanola,2,4,-2,L
234452,20,CHL1,2021-02-02,Municipal Iquique,Coquimbo Unido,2,2,0,D
234453,20,CHL1,2021-02-04,Coquimbo Unido,CD Cobresal,0,1,-1,L
234454,20,CHL1,2021-02-05,La Serena,Universidad Catolica,1,2,-1,L
234455,20,CHL1,2021-02-05,Union La Calera,Antofagasta,1,1,0,D
234456,20,CHL1,2021-02-06,Curico Unido,Santiago Wanderers,1,3,-2,L
234457,20,CHL1,2021-02-06,Higgins,Audax Italiano,0,0,0,D
234458,20,CHL1,2021-02-06,Everton,CD Palestino,1,3,-2,L
234459,20,CHL1,2021-02-06,Universidad de Chile,Union Espanola,3,0,3,W
234460,20,CHL1,2021-02-07,Municipal Iquique,Colo Colo,0,0,0,D
234461,20,CHL1,2021-02-07,Universidad de Concepcion,Coquimbo Unido,2,1,1,W
234462,20,CHL1,2021-02-08,CD Cobresal,CD Huachipato,2,1,1,W
234463,20,CHL1,2021-02-10,Antofagasta,Higgins,1,0,1,W
234464,20,CHL1,2021-02-10,Union Espanola,La Serena,1,1,0,D
234465,20,CHL1,2021-02-10,Curico Unido,Universidad de Chile,0,0,0,D
234466,20,CHL1,2021-02-11,Universidad Catolica,Union La Calera,0,0,0,D
234467,20,CHL1,2021-02-11,Audax Italiano,Municipal Iquique,1,1,0,D
234468,20,CHL1,2021-02-11,Santiago Wanderers,Universidad de Concepcion,1,1,0,D
234469,20,CHL1,2021-02-11,Coquimbo Unido,Everton,3,0,3,W
234470,20,CHL1,2021-02-11,Colo Colo,CD Cobresal,0,0,0,D
234471,20,CHL1,2021-02-12,CD Huachipato,CD Palestino,1,0,1,W
234472,20,CHL1,2021-02-13,Union La Calera,Curico Unido,2,3,-1,L
234473,20,CHL1,2021-02-13,Universidad de Chile,Antofagasta,3,1,2,W
234474,20,CHL1,2021-02-14,Universidad de Concepcion,Universidad Catolica,1,2,-1,L
234475,20,CHL1,2021-02-14,Everton,CD Huachipato,1,0,1,W
234476,20,CHL1,2021-02-14,Municipal Iquique,Santiago Wanderers,2,0,2,W
234477,20,CHL1,2021-02-14,La Serena,Audax Italiano,0,2,-2,L
234478,20,CHL1,2021-02-14,CD Palestino,Coquimbo Unido,2,2,0,D
234479,20,CHL1,2021-02-14,Higgins,Colo Colo,1,1,0,D
234480,20,CHL1,2021-02-15,CD Cobresal,Union Espanola,4,1,3,W
234481,21,CHL1,2021-03-27,Curico Unido,Melipilla,2,0,2,W
234482,21,CHL1,2021-03-27,Everton,Higgins,1,1,0,D
234483,21,CHL1,2021-03-27,Colo Colo,Union La Calera,0,0,0,D
234484,21,CHL1,2021-03-28,Union Espanola,Santiago Wanderers,3,1,2,W
234485,21,CHL1,2021-03-28,CD Palestino,Antofagasta,2,4,-2,L
234486,21,CHL1,2021-03-28,CD Huachipato,CD Cobresal,0,0,0,D
234487,21,CHL1,2021-03-28,Nublense,Universidad Catolica,0,1,-1,L
234488,21,CHL1,2021-03-31,Audax Italiano,La Serena,2,1,1,W
234489,21,CHL1,2021-04-02,Antofagasta,Everton,1,2,-1,L
234490,21,CHL1,2021-04-02,Union La Calera,Union Espanola,1,0,1,W
234491,21,CHL1,2021-04-03,Melipilla,Nublense,1,1,0,D
234492,21,CHL1,2021-04-03,Universidad de Chile,CD Huachipato,1,1,0,D
234493,21,CHL1,2021-04-04,CD Cobresal,Colo Colo,1,2,-1,L
234494,21,CHL1,2021-04-04,La Serena,Curico Unido,2,0,2,W
234495,21,CHL1,2021-04-05,Universidad Catolica,CD Palestino,2,1,1,W
234496,21,CHL1,2021-04-05,Higgins,Audax Italiano,0,0,0,D
234497,21,CHL1,2021-04-10,Union Espanola,Melipilla,0,2,-2,L
234498,21,CHL1,2021-04-10,Audax Italiano,Universidad Catolica,1,0,1,W
234499,21,CHL1,2021-04-11,La Serena,Universidad de Chile,0,0,0,D
234500,21,CHL1,2021-04-11,Santiago Wanderers,Union La Calera,1,2,-1,L
234501,21,CHL1,2021-04-12,Colo Colo,Higgins,1,2,-1,L
234502,21,CHL1,2021-04-12,Nublense,CD Cobresal,3,1,2,W
234503,21,CHL1,2021-04-12,CD Palestino,Everton,1,1,0,D
234504,21,CHL1,2021-04-12,Curico Unido,Antofagasta,1,1,0,D
234505,21,CHL1,2021-04-16,Melipilla,CD Palestino,0,1,-1,L
234506,21,CHL1,2021-04-16,CD Huachipato,Nublense,5,3,2,W
234507,21,CHL1,2021-04-17,Universidad Catolica,Curico Unido,2,1,1,W
234508,21,CHL1,2021-04-17,Higgins,La Serena,0,0,0,D
234509,21,CHL1,2021-04-18,Union La Calera,Audax Italiano,1,1,0,D
234510,21,CHL1,2021-04-18,CD Cobresal,Santiago Wanderers,2,1,1,W
234511,21,CHL1,2021-04-18,Everton,Colo Colo,0,2,-2,L
234512,21,CHL1,2021-04-20,Universidad de Chile,Union Espanola,2,1,1,W
234513,21,CHL1,2021-04-24,Curico Unido,Everton,1,1,0,D
234514,21,CHL1,2021-04-24,Antofagasta,CD Cobresal,2,1,1,W
234515,21,CHL1,2021-04-24,La Serena,Union Espanola,0,0,0,D
234516,21,CHL1,2021-04-24,Higgins,Union La Calera,1,0,1,W
234517,21,CHL1,2021-04-25,Santiago Wanderers,Nublense,1,2,-1,L
234518,21,CHL1,2021-04-25,Colo Colo,Universidad de Chile,1,0,1,W
234519,21,CHL1,2021-04-27,Audax Italiano,Melipilla,1,0,1,W
234520,21,CHL1,2021-05-01,Everton,La Serena,0,4,-4,L
234521,21,CHL1,2021-05-01,Union La Calera,Antofagasta,2,1,1,W
234522,21,CHL1,2021-05-01,Union Espanola,Audax Italiano,1,1,0,D
234523,21,CHL1,2021-05-01,Nublense,Colo Colo,5,1,4,W
234524,21,CHL1,2021-05-02,CD Cobresal,Curico Unido,2,0,2,W
234525,21,CHL1,2021-05-02,CD Huachipato,Higgins,0,1,-1,L
234526,21,CHL1,2021-05-02,Melipilla,Universidad Catolica,2,0,2,W
234527,21,CHL1,2021-05-04,Universidad de Chile,Santiago Wanderers,1,0,1,W
234528,21,CHL1,2021-05-08,Higgins,Union Espanola,1,4,-3,L
234529,21,CHL1,2021-05-08,Universidad Catolica,Union La Calera,3,0,3,W
234530,21,CHL1,2021-05-08,La Serena,Nublense,1,0,1,W
234531,21,CHL1,2021-05-08,Santiago Wanderers,Melipilla,0,3,-3,L
234532,21,CHL1,2021-05-09,Colo Colo,CD Palestino,1,2,-1,L
234533,21,CHL1,2021-05-09,Curico Unido,CD Huachipato,2,2,0,D
234534,21,CHL1,2021-05-09,Antofagasta,Universidad de Chile,1,2,-1,L
234535,21,CHL1,2021-05-09,Audax Italiano,CD Cobresal,0,0,0,D
234536,21,CHL1,2021-05-22,CD Cobresal,La Serena,2,0,2,W
234537,21,CHL1,2021-05-22,Nublense,Curico Unido,2,0,2,W
234538,21,CHL1,2021-05-22,Santiago Wanderers,Higgins,0,0,0,D
234539,21,CHL1,2021-05-23,Union Espanola,Universidad Catolica,3,2,1,W
234540,21,CHL1,2021-05-23,Melipilla,Antofagasta,1,1,0,D
234541,21,CHL1,2021-05-23,CD Huachipato,Colo Colo,0,2,-2,L
234542,21,CHL1,2021-05-24,Universidad de Chile,Everton,0,1,-1,L
234543,21,CHL1,2021-05-29,Curico Unido,Union Espanola,1,2,-1,L
234544,21,CHL1,2021-05-29,La Serena,Melipilla,5,1,4,W
234545,21,CHL1,2021-05-29,Higgins,CD Palestino,1,0,1,W
234546,21,CHL1,2021-05-30,Everton,Santiago Wanderers,1,0,1,W
234547,21,CHL1,2021-05-31,Universidad Catolica,CD Cobresal,2,1,1,W
234548,21,CHL1,2021-05-31,Antofagasta,CD Huachipato,1,0,1,W
234549,21,CHL1,2021-05-31,Union La Calera,Nublense,1,0,1,W
234550,21,CHL1,2021-06-01,Audax Italiano,Universidad de Chile,2,1,1,W
234551,21,CHL1,2021-06-05,CD Cobresal,Union La Calera,0,1,-1,L
234552,21,CHL1,2021-06-05,Santiago Wanderers,Universidad Catolica,0,1,-1,L
234553,21,CHL1,2021-06-05,CD Palestino,Universidad de Chile,0,0,0,D
234554,21,CHL1,2021-06-06,CD Huachipato,Everton,0,0,0,D
234555,21,CHL1,2021-06-06,Union Espanola,Antofagasta,1,1,0,D
234556,21,CHL1,2021-06-06,Colo Colo,La Serena,2,0,2,W
234557,21,CHL1,2021-06-07,Melipilla,Higgins,3,1,2,W
234558,21,CHL1,2021-06-08,Nublense,Audax Italiano,1,0,1,W
234559,21,CHL1,2021-06-15,CD Palestino,Audax Italiano,0,2,-2,L
234560,21,CHL1,2021-07-15,CD Palestino,CD Huachipato,2,0,2,W
234561,21,CHL1,2021-07-16,Higgins,CD Cobresal,1,1,0,D
234562,21,CHL1,2021-07-16,Antofagasta,Santiago Wanderers,1,0,1,W
234563,21,CHL1,2021-07-17,Union La Calera,Curico Unido,1,0,1,W
234564,21,CHL1,2021-07-17,Universidad Catolica,Colo Colo,0,0,0,D
234565,21,CHL1,2021-07-19,Audax Italiano,CD Huachipato,3,3,0,D
234566,21,CHL1,2021-07-20,Everton,Nublense,0,0,0,D
234567,21,CHL1,2021-07-20,La Serena,CD Palestino,4,3,1,W
234568,21,CHL1,2021-07-21,Universidad de Chile,Melipilla,2,0,2,W
234569,21,CHL1,2021-07-24,Everton,Union Espanola,2,0,2,W
234570,21,CHL1,2021-07-24,Nublense,Antofagasta,0,0,0,D
234571,21,CHL1,2021-07-24,Melipilla,Union La Calera,3,3,0,D
234572,21,CHL1,2021-07-25,Colo Colo,Audax Italiano,1,1,0,D
234573,21,CHL1,2021-07-25,CD Huachipato,La Serena,0,0,0,D
234574,21,CHL1,2021-07-25,CD Palestino,Santiago Wanderers,2,0,2,W
234575,21,CHL1,2021-07-25,Curico Unido,Universidad de Chile,1,2,-1,L
234576,21,CHL1,2021-07-26,Universidad Catolica,Higgins,3,0,3,W
234577,21,CHL1,2021-07-28,Audax Italiano,Everton,0,2,-2,L
234578,21,CHL1,2021-07-28,CD Cobresal,Melipilla,1,1,0,D
234579,21,CHL1,2021-07-28,Union Espanola,CD Huachipato,3,1,2,W
234580,21,CHL1,2021-07-28,Higgins,Curico Unido,2,2,0,D
234581,21,CHL1,2021-07-29,Union La Calera,CD Palestino,2,1,1,W
234582,21,CHL1,2021-07-29,Antofagasta,Universidad Catolica,3,2,1,W
234583,21,CHL1,2021-07-29,Santiago Wanderers,Colo Colo,0,4,-4,L
234584,21,CHL1,2021-07-30,Universidad de Chile,Nublense,1,1,0,D
234585,21,CHL1,2021-08-01,CD Huachipato,Union La Calera,0,0,0,D
234586,21,CHL1,2021-08-01,CD Palestino,Union Espanola,3,2,1,W
234587,21,CHL1,2021-08-01,Universidad de Chile,Universidad Catolica,2,1,1,W
234588,21,CHL1,2021-08-02,Melipilla,Colo Colo,2,4,-2,L
234589,21,CHL1,2021-08-02,La Serena,Antofagasta,1,1,0,D
234590,21,CHL1,2021-08-02,Nublense,Higgins,0,0,0,D
234591,21,CHL1,2021-08-03,Curico Unido,Santiago Wanderers,2,1,1,W
234592,21,CHL1,2021-08-04,Everton,CD Cobresal,3,0,3,W
234593,21,CHL1,2021-08-07,Higgins,Universidad de Chile,1,3,-2,L
234594,21,CHL1,2021-08-07,Union Espanola,Nublense,3,2,1,W
234595,21,CHL1,2021-08-08,Universidad Catolica,La Serena,4,3,1,W
234596,21,CHL1,2021-08-08,Santiago Wanderers,CD Huachipato,1,4,-3,L
234597,21,CHL1,2021-08-08,Antofagasta,Audax Italiano,0,1,-1,L
234598,21,CHL1,2021-08-08,Colo Colo,Curico Unido,2,0,2,W
234599,21,CHL1,2021-08-09,Union La Calera,Everton,1,0,1,W
234600,21,CHL1,2021-08-09,CD Cobresal,CD Palestino,3,1,2,W
234601,21,CHL1,2021-08-14,Audax Italiano,Santiago Wanderers,1,0,1,W
234602,21,CHL1,2021-08-14,Antofagasta,Higgins,2,1,1,W
234603,21,CHL1,2021-08-14,La Serena,Union La Calera,1,2,-1,L
234604,21,CHL1,2021-08-14,Union Espanola,Colo Colo,0,1,-1,L
234605,21,CHL1,2021-08-15,Everton,Melipilla,1,2,-1,L
234606,21,CHL1,2021-08-15,CD Palestino,Curico Unido,0,2,-2,L
234607,21,CHL1,2021-08-15,Universidad de Chile,CD Cobresal,0,2,-2,L
234608,21,CHL1,2021-08-16,CD Huachipato,Universidad Catolica,2,1,1,W
234609,21,CHL1,2021-08-21,Santiago Wanderers,La Serena,2,2,0,D
234610,21,CHL1,2021-08-21,Nublense,CD Palestino,2,2,0,D
234611,21,CHL1,2021-08-21,Colo Colo,Antofagasta,2,0,2,W
234612,21,CHL1,2021-08-22,Curico Unido,Audax Italiano,2,2,0,D
234613,21,CHL1,2021-08-22,CD Cobresal,Union Espanola,2,0,2,W
234614,21,CHL1,2021-08-22,Melipilla,CD Huachipato,1,2,-1,L
234615,21,CHL1,2021-08-22,Union La Calera,Universidad de Chile,1,4,-3,L
234616,21,CHL1,2021-08-23,Universidad Catolica,Everton,2,0,2,W
234617,21,CHL1,2021-08-25,Melipilla,Curico Unido,1,1,0,D
234618,21,CHL1,2021-08-25,Antofagasta,CD Palestino,2,1,1,W
234619,21,CHL1,2021-08-25,Union La Calera,Colo Colo,1,1,0,D
234620,21,CHL1,2021-08-26,Universidad Catolica,Nublense,2,2,0,D
234621,21,CHL1,2021-08-26,La Serena,Audax Italiano,0,2,-2,L
234622,21,CHL1,2021-08-26,Santiago Wanderers,Union Espanola,1,2,-1,L
234623,21,CHL1,2021-08-27,Higgins,Everton,1,0,1,W
234624,21,CHL1,2021-08-28,CD Palestino,Universidad Catolica,3,0,3,W
234625,21,CHL1,2021-08-29,Nublense,Melipilla,3,0,3,W
234626,21,CHL1,2021-08-29,Everton,Antofagasta,1,1,0,D
234627,21,CHL1,2021-08-29,CD Huachipato,Universidad de Chile,1,1,0,D
234628,21,CHL1,2021-08-29,Colo Colo,CD Cobresal,0,1,-1,L
234629,21,CHL1,2021-08-30,Union Espanola,Union La Calera,2,1,1,W
234630,21,CHL1,2021-08-30,Audax Italiano,Higgins,1,0,1,W
234631,21,CHL1,2021-08-31,Curico Unido,La Serena,2,0,2,W
234632,21,CHL1,2021-09-06,CD Cobresal,Nublense,4,1,3,W
234633,21,CHL1,2021-09-07,Universidad de Chile,La Serena,1,1,0,D
234634,21,CHL1,2021-09-07,Melipilla,Union Espanola,0,3,-3,L
234635,21,CHL1,2021-09-07,Antofagasta,Curico Unido,1,1,0,D
234636,21,CHL1,2021-09-08,Universidad Catolica,Audax Italiano,3,1,2,W
234637,21,CHL1,2021-09-08,Union La Calera,Santiago Wanderers,0,1,-1,L
234638,21,CHL1,2021-09-08,Higgins,Colo Colo,2,3,-1,L
234639,21,CHL1,2021-09-09,Everton,CD Palestino,1,0,1,W
234640,21,CHL1,2021-09-12,Santiago Wanderers,CD Cobresal,2,1,1,W
234641,21,CHL1,2021-09-12,Audax Italiano,Union La Calera,2,3,-1,L
234642,21,CHL1,2021-09-13,Curico Unido,Universidad Catolica,2,4,-2,L
234643,21,CHL1,2021-09-13,Nublense,CD Huachipato,2,2,0,D
234644,21,CHL1,2021-09-13,Union Espanola,Universidad de Chile,2,3,-1,L
234645,21,CHL1,2021-09-14,La Serena,Higgins,2,0,2,W
234646,21,CHL1,2021-09-14,Colo Colo,Everton,2,0,2,W
234647,21,CHL1,2021-09-15,CD Palestino,Melipilla,3,1,2,W
234648,21,CHL1,2021-09-17,CD Cobresal,CD Huachipato,1,1,0,D
234649,21,CHL1,2021-09-24,CD Huachipato,CD Palestino,1,1,0,D
234650,21,CHL1,2021-09-25,Union La Calera,Higgins,2,0,2,W
234651,21,CHL1,2021-09-25,CD Cobresal,Antofagasta,2,0,2,W
234652,21,CHL1,2021-09-25,Union Espanola,La Serena,2,1,1,W
234653,21,CHL1,2021-09-25,Melipilla,Audax Italiano,1,1,0,D
234654,21,CHL1,2021-09-26,Everton,Curico Unido,0,0,0,D
234655,21,CHL1,2021-09-26,Nublense,Santiago Wanderers,1,2,-1,L
234656,21,CHL1,2021-09-26,Universidad de Chile,Colo Colo,1,3,-2,L
234657,21,CHL1,2021-09-28,La Serena,Everton,0,2,-2,L
234658,21,CHL1,2021-09-29,Higgins,CD Huachipato,2,0,2,W
234659,21,CHL1,2021-09-29,Santiago Wanderers,Universidad de Chile,2,1,1,W
234660,21,CHL1,2021-09-29,Antofagasta,Union La Calera,1,3,-2,L
234661,21,CHL1,2021-09-30,Universidad Catolica,Melipilla,4,0,4,W
234662,21,CHL1,2021-09-30,Curico Unido,CD Cobresal,1,0,1,W
234663,21,CHL1,2021-09-30,Colo Colo,Nublense,0,1,-1,L
234664,21,CHL1,2021-10-01,Audax Italiano,Union Espanola,2,0,2,W
234665,21,CHL1,2021-10-03,Union La Calera,Universidad Catolica,0,2,-2,L
234666,21,CHL1,2021-10-03,CD Palestino,Colo Colo,1,2,-1,L
234667,21,CHL1,2021-10-03,Universidad de Chile,Antofagasta,2,2,0,D
234668,21,CHL1,2021-10-04,Union Espanola,Higgins,3,2,1,W
234669,21,CHL1,2021-10-04,CD Cobresal,Audax Italiano,1,2,-1,L
234670,21,CHL1,2021-10-04,Melipilla,Santiago Wanderers,1,1,0,D
234671,21,CHL1,2021-10-05,CD Huachipato,Curico Unido,1,4,-3,L
234672,21,CHL1,2021-10-06,Nublense,La Serena,0,1,-1,L
234673,21,CHL1,2021-10-07,Universidad Catolica,Union Espanola,2,1,1,W
234674,21,CHL1,2021-10-09,Audax Italiano,CD Palestino,2,3,-1,L
234675,21,CHL1,2021-10-09,Everton,Universidad de Chile,1,0,1,W
234676,21,CHL1,2021-10-09,Antofagasta,Melipilla,1,0,1,W
234677,21,CHL1,2021-10-10,Colo Colo,CD Huachipato,2,0,2,W
234678,21,CHL1,2021-10-10,La Serena,CD Cobresal,2,1,1,W
234679,21,CHL1,2021-10-11,Higgins,Santiago Wanderers,1,0,1,W
234680,21,CHL1,2021-10-12,Curico Unido,Nublense,0,0,0,D
234681,21,CHL1,2021-10-15,CD Huachipato,Antofagasta,0,1,-1,L
234682,21,CHL1,2021-10-15,CD Palestino,Higgins,2,2,0,D
234683,21,CHL1,2021-10-15,Universidad de Chile,Audax Italiano,0,1,-1,L
234684,21,CHL1,2021-10-16,Nublense,Union La Calera,0,2,-2,L
234685,21,CHL1,2021-10-16,CD Cobresal,Universidad Catolica,1,3,-2,L
234686,21,CHL1,2021-10-16,Santiago Wanderers,Everton,2,1,1,W
234687,21,CHL1,2021-10-16,Union Espanola,Curico Unido,2,1,1,W
234688,21,CHL1,2021-10-17,Melipilla,La Serena,1,1,0,D
234689,21,CHL1,2021-10-19,Audax Italiano,Nublense,0,3,-3,L
234690,21,CHL1,2021-10-20,Higgins,Melipilla,1,2,-1,L
234691,21,CHL1,2021-10-20,La Serena,Colo Colo,1,4,-3,L
234692,21,CHL1,2021-10-20,Universidad Catolica,Santiago Wanderers,3,2,1,W
234693,21,CHL1,2021-10-21,Everton,CD Huachipato,1,0,1,W
234694,21,CHL1,2021-10-21,Antofagasta,Union Espanola,1,2,-1,L
234695,21,CHL1,2021-10-21,Universidad de Chile,CD Palestino,0,1,-1,L
234696,21,CHL1,2021-10-22,Union La Calera,CD Cobresal,1,2,-1,L
234697,21,CHL1,2021-10-23,Nublense,Everton,1,1,0,D
234698,21,CHL1,2021-10-24,Melipilla,Universidad de Chile,3,0,3,W
234699,21,CHL1,2021-10-24,Colo Colo,Universidad Catolica,2,1,1,W
234700,21,CHL1,2021-10-25,CD Huachipato,Audax Italiano,0,0,0,D
234701,21,CHL1,2021-10-25,Santiago Wanderers,Antofagasta,0,1,-1,L
234702,21,CHL1,2021-10-25,CD Palestino,La Serena,3,3,0,D
234703,21,CHL1,2021-10-26,Curico Unido,Union La Calera,1,1,0,D
234704,21,CHL1,2021-10-26,CD Cobresal,Higgins,2,3,-1,L
234705,21,CHL1,2021-10-28,Audax Italiano,Colo Colo,2,0,2,W
234706,21,CHL1,2021-10-29,Santiago Wanderers,CD Palestino,1,1,0,D
234707,21,CHL1,2021-10-29,La Serena,CD Huachipato,2,2,0,D
234708,21,CHL1,2021-10-30,Universidad de Chile,Curico Unido,1,2,-1,L
234709,21,CHL1,2021-10-30,Union Espanola,Everton,3,2,1,W
234710,21,CHL1,2021-10-31,Antofagasta,Nublense,2,1,1,W
234711,21,CHL1,2021-10-31,Higgins,Universidad Catolica,1,3,-2,L
234712,21,CHL1,2021-10-31,Union La Calera,Melipilla,2,3,-1,L
234713,21,CHL1,2021-11-03,Everton,Audax Italiano,1,2,-1,L
234714,21,CHL1,2021-11-03,Melipilla,CD Cobresal,2,1,1,W
234715,21,CHL1,2021-11-03,CD Huachipato,Union Espanola,1,0,1,W
234716,21,CHL1,2021-11-04,Curico Unido,Higgins,0,2,-2,L
234717,21,CHL1,2021-11-04,CD Palestino,Union La Calera,1,2,-1,L
234718,21,CHL1,2021-11-04,Universidad Catolica,Antofagasta,4,0,4,W
234719,21,CHL1,2021-11-04,Nublense,Universidad de Chile,1,0,1,W
234720,21,CHL1,2021-11-06,Colo Colo,Santiago Wanderers,3,0,3,W
234721,21,CHL1,2021-11-07,Universidad Catolica,Universidad de Chile,1,0,1,W
234722,21,CHL1,2021-11-07,Higgins,Nublense,1,1,0,D
234723,21,CHL1,2021-11-07,CD Cobresal,Everton,2,2,0,D
234724,21,CHL1,2021-11-08,Union La Calera,CD Huachipato,0,2,-2,L
234725,21,CHL1,2021-11-08,Antofagasta,La Serena,0,0,0,D
234726,21,CHL1,2021-11-08,Union Espanola,CD Palestino,1,3,-2,L
234727,21,CHL1,2021-11-09,Santiago Wanderers,Curico Unido,0,3,-3,L
234728,21,CHL1,2021-11-10,Colo Colo,Melipilla,1,0,1,W
234729,21,CHL1,2021-11-13,Nublense,Union Espanola,6,1,5,W
234730,21,CHL1,2021-11-13,La Serena,Universidad Catolica,0,2,-2,L
234731,21,CHL1,2021-11-14,Everton,Union La Calera,1,2,-1,L
234732,21,CHL1,2021-11-14,Audax Italiano,Antofagasta,0,0,0,D
234733,21,CHL1,2021-11-14,CD Palestino,CD Cobresal,2,1,1,W
234734,21,CHL1,2021-11-14,Curico Unido,Colo Colo,0,0,0,D
234735,21,CHL1,2021-11-15,CD Huachipato,Santiago Wanderers,2,0,2,W
234736,21,CHL1,2021-11-15,Universidad de Chile,Higgins,0,0,0,D
234737,21,CHL1,2021-11-27,CD Cobresal,Universidad de Chile,0,0,0,D
234738,21,CHL1,2021-11-27,Higgins,Antofagasta,0,0,0,D
234739,21,CHL1,2021-11-27,Melipilla,Everton,1,0,1,W
234740,21,CHL1,2021-11-28,Santiago Wanderers,Audax Italiano,2,2,0,D
234741,21,CHL1,2021-11-28,Union La Calera,La Serena,1,2,-1,L
234742,21,CHL1,2021-11-28,Colo Colo,Union Espanola,0,1,-1,L
234743,21,CHL1,2021-11-28,Curico Unido,CD Palestino,1,1,0,D
234744,21,CHL1,2021-11-28,Universidad Catolica,CD Huachipato,2,0,2,W
234745,21,CHL1,2021-12-04,Antofagasta,Colo Colo,1,0,1,W
234746,21,CHL1,2021-12-04,Everton,Universidad Catolica,0,3,-3,L
234747,21,CHL1,2021-12-04,La Serena,Santiago Wanderers,0,0,0,D
234748,21,CHL1,2021-12-04,CD Palestino,Nublense,1,4,-3,L
234749,21,CHL1,2021-12-05,Union Espanola,CD Cobresal,0,1,-1,L
234750,21,CHL1,2021-12-05,Universidad de Chile,Union La Calera,3,2,1,W
234751,21,CHL1,2021-12-05,CD Huachipato,Melipilla,3,1,2,W
234752,21,CHL1,2021-12-05,Audax Italiano,Curico Unido,1,1,0,D
234753,22,CHL1,2022-02-04,Higgins,La Serena,3,0,3,W
234754,22,CHL1,2022-02-05,Union Espanola,CD Palestino,1,1,0,D
234755,22,CHL1,2022-02-05,Coquimbo Unido,Universidad Catolica,2,3,-1,L
234756,22,CHL1,2022-02-06,Antofagasta,CD Cobresal,0,1,-1,L
234757,22,CHL1,2022-02-06,Union La Calera,Universidad de Chile,2,4,-2,L
234758,22,CHL1,2022-02-06,Colo Colo,Everton,2,0,2,W
234759,22,CHL1,2022-02-07,Audax Italiano,Nublense,1,2,-1,L
234760,22,CHL1,2022-02-07,Curico Unido,CD Huachipato,4,0,4,W
234761,22,CHL1,2022-02-11,CD Palestino,Higgins,1,0,1,W
234762,22,CHL1,2022-02-11,Everton,Coquimbo Unido,2,0,2,W
234763,22,CHL1,2022-02-12,CD Huachipato,Audax Italiano,2,1,1,W
234764,22,CHL1,2022-02-12,Universidad de Chile,Antofagasta,2,1,1,W
234765,22,CHL1,2022-02-13,La Serena,Colo Colo,1,1,0,D
234766,22,CHL1,2022-02-13,Universidad Catolica,Union Espanola,2,1,1,W
234767,22,CHL1,2022-02-14,Nublense,Union La Calera,0,0,0,D
234768,22,CHL1,2022-02-14,CD Cobresal,Curico Unido,2,3,-1,L
234769,22,CHL1,2022-02-18,Higgins,CD Huachipato,1,1,0,D
234770,22,CHL1,2022-02-18,Union Espanola,Everton,1,1,0,D
234771,22,CHL1,2022-02-19,Colo Colo,Audax Italiano,1,1,0,D
234772,22,CHL1,2022-02-19,Antofagasta,La Serena,2,2,0,D
234773,22,CHL1,2022-02-20,Coquimbo Unido,CD Palestino,2,2,0,D
234774,22,CHL1,2022-02-20,Union La Calera,CD Cobresal,0,2,-2,L
234775,22,CHL1,2022-02-20,Universidad Catolica,Curico Unido,1,0,1,W
234776,22,CHL1,2022-02-21,Nublense,Universidad de Chile,3,2,1,W
234777,22,CHL1,2022-02-25,Union La Calera,Everton,1,1,0,D
234778,22,CHL1,2022-02-26,La Serena,Coquimbo Unido,1,1,0,D
234779,22,CHL1,2022-02-26,CD Cobresal,Nublense,1,1,0,D
234780,22,CHL1,2022-02-26,Audax Italiano,Antofagasta,0,3,-3,L
234781,22,CHL1,2022-02-27,CD Huachipato,Colo Colo,1,0,1,W
234782,22,CHL1,2022-02-27,CD Palestino,Universidad Catolica,3,2,1,W
234783,22,CHL1,2022-02-28,Curico Unido,Union Espanola,0,1,-1,L
234784,22,CHL1,2022-02-28,Universidad de Chile,Higgins,0,1,-1,L
234785,22,CHL1,2022-03-04,CD Palestino,Union La Calera,0,0,0,D
234786,22,CHL1,2022-03-04,Nublense,La Serena,3,1,2,W
234787,22,CHL1,2022-03-05,Coquimbo Unido,Antofagasta,3,2,1,W
234788,22,CHL1,2022-03-05,Union Espanola,CD Huachipato,1,0,1,W
234789,22,CHL1,2022-03-05,Everton,Curico Unido,1,1,0,D
234790,22,CHL1,2022-03-06,Colo Colo,Universidad de Chile,4,1,3,W
234791,22,CHL1,2022-03-06,Higgins,Audax Italiano,2,2,0,D
234792,22,CHL1,2022-03-06,CD Cobresal,Universidad Catolica,3,1,2,W
234793,22,CHL1,2022-03-11,La Serena,CD Cobresal,2,3,-1,L
234794,22,CHL1,2022-03-12,Coquimbo Unido,Nublense,0,1,-1,L
234795,22,CHL1,2022-03-12,Universidad Catolica,Everton,0,1,-1,L
234796,22,CHL1,2022-03-12,Union La Calera,CD Huachipato,1,0,1,W
234797,22,CHL1,2022-03-13,Curico Unido,Higgins,5,0,5,W
234798,22,CHL1,2022-03-13,Audax Italiano,CD Palestino,3,1,2,W
234799,22,CHL1,2022-03-14,Antofagasta,Colo Colo,0,1,-1,L
234800,22,CHL1,2022-03-17,Universidad de Chile,Curico Unido,1,1,0,D
234801,22,CHL1,2022-03-19,Higgins,Universidad Catolica,2,1,1,W
234802,22,CHL1,2022-03-19,CD Cobresal,Coquimbo Unido,2,1,1,W
234803,22,CHL1,2022-03-20,CD Huachipato,La Serena,2,3,-1,L
234804,22,CHL1,2022-03-20,CD Palestino,Colo Colo,0,5,-5,L
234805,22,CHL1,2022-03-20,Everton,Audax Italiano,0,0,0,D
234806,22,CHL1,2022-03-21,Antofagasta,Union La Calera,0,0,0,D
234807,22,CHL1,2022-03-21,Union Espanola,Nublense,1,0,1,W
234808,22,CHL1,2022-03-27,Universidad de Chile,Union Espanola,2,0,2,W
234809,22,CHL1,2022-03-31,Colo Colo,Union La Calera,4,0,4,W
234810,22,CHL1,2022-04-01,La Serena,Everton,1,3,-2,L
234811,22,CHL1,2022-04-02,Higgins,Coquimbo Unido,2,1,1,W
234812,22,CHL1,2022-04-02,Nublense,Antofagasta,1,1,0,D
234813,22,CHL1,2022-04-02,Universidad Catolica,Universidad de Chile,2,1,1,W
234814,22,CHL1,2022-04-03,CD Huachipato,CD Cobresal,1,0,1,W
234815,22,CHL1,2022-04-03,Audax Italiano,Union Espanola,0,1,-1,L
234816,22,CHL1,2022-04-05,Curico Unido,CD Palestino,0,0,0,D
234817,22,CHL1,2022-04-09,Everton,CD Huachipato,0,1,-1,L
234818,22,CHL1,2022-04-09,Coquimbo Unido,Universidad de Chile,1,0,1,W
234819,22,CHL1,2022-04-10,Universidad Catolica,La Serena,0,2,-2,L
234820,22,CHL1,2022-04-10,CD Cobresal,Audax Italiano,0,1,-1,L
234821,22,CHL1,2022-04-10,CD Palestino,Nublense,1,1,0,D
234822,22,CHL1,2022-04-10,Union Espanola,Colo Colo,2,1,1,W
234823,22,CHL1,2022-04-11,Union La Calera,Curico Unido,0,0,0,D
234824,22,CHL1,2022-04-15,La Serena,Union Espanola,1,2,-1,L
234825,22,CHL1,2022-04-16,Audax Italiano,Coquimbo Unido,1,1,0,D
234826,22,CHL1,2022-04-16,Universidad de Chile,CD Palestino,0,0,0,D
234827,22,CHL1,2022-04-17,Curico Unido,Antofagasta,2,0,2,W
234828,22,CHL1,2022-04-17,CD Huachipato,Universidad Catolica,1,0,1,W
234829,22,CHL1,2022-04-17,Colo Colo,CD Cobresal,2,1,1,W
234830,22,CHL1,2022-04-18,Nublense,Everton,2,1,1,W
234831,22,CHL1,2022-04-19,Union La Calera,Higgins,0,0,0,D
234832,22,CHL1,2022-04-23,Everton,CD Palestino,0,0,0,D
234833,22,CHL1,2022-04-23,Antofagasta,CD Huachipato,0,0,0,D
234834,22,CHL1,2022-04-23,La Serena,Curico Unido,1,3,-2,L
234835,22,CHL1,2022-04-24,Universidad Catolica,Colo Colo,1,1,0,D
234836,22,CHL1,2022-04-24,Higgins,Nublense,1,0,1,W
234837,22,CHL1,2022-04-25,Coquimbo Unido,Union La Calera,3,2,1,W
234838,22,CHL1,2022-04-27,Union Espanola,CD Cobresal,2,2,0,D
234839,22,CHL1,2022-04-29,Audax Italiano,Universidad de Chile,2,0,2,W
234840,22,CHL1,2022-04-30,Antofagasta,Higgins,1,0,1,W
234841,22,CHL1,2022-05-07,Higgins,Union Espanola,2,2,0,D
234842,22,CHL1,2022-05-07,Universidad de Chile,La Serena,2,0,2,W
234843,22,CHL1,2022-05-08,CD Palestino,Antofagasta,1,0,1,W
234844,22,CHL1,2022-05-08,Nublense,Universidad Catolica,4,0,4,W
234845,22,CHL1,2022-05-09,Coquimbo Unido,CD Huachipato,1,2,-1,L
234846,22,CHL1,2022-05-09,CD Cobresal,Everton,0,0,0,D
234847,22,CHL1,2022-05-09,Curico Unido,Colo Colo,1,2,-1,L
234848,22,CHL1,2022-05-10,Union La Calera,Audax Italiano,1,0,1,W
234849,22,CHL1,2022-05-13,Universidad Catolica,Union La Calera,3,0,3,W
234850,22,CHL1,2022-05-14,Union Espanola,Antofagasta,2,0,2,W
234851,22,CHL1,2022-05-14,La Serena,CD Palestino,0,0,0,D
234852,22,CHL1,2022-05-14,Everton,Universidad de Chile,2,1,1,W
234853,22,CHL1,2022-05-14,Colo Colo,Coquimbo Unido,4,0,4,W
234854,22,CHL1,2022-05-15,CD Cobresal,Higgins,2,0,2,W
234855,22,CHL1,2022-05-15,CD Huachipato,Nublense,1,3,-2,L
234856,22,CHL1,2022-05-17,Curico Unido,Audax Italiano,4,1,3,W
234857,22,CHL1,2022-05-21,Coquimbo Unido,Union Espanola,2,4,-2,L
234858,22,CHL1,2022-05-21,Audax Italiano,Universidad Catolica,3,2,1,W
234859,22,CHL1,2022-05-21,Antofagasta,Everton,2,2,0,D
234860,22,CHL1,2022-05-21,Universidad de Chile,CD Huachipato,3,2,1,W
234861,22,CHL1,2022-05-22,Union La Calera,La Serena,1,1,0,D
234862,22,CHL1,2022-05-22,CD Palestino,CD Cobresal,3,1,2,W
234863,22,CHL1,2022-05-22,Higgins,Colo Colo,1,1,0,D
234864,22,CHL1,2022-05-23,Nublense,Curico Unido,3,1,2,W
234865,22,CHL1,2022-05-28,Curico Unido,Coquimbo Unido,3,0,3,W
234866,22,CHL1,2022-05-28,La Serena,Audax Italiano,3,2,1,W
234867,22,CHL1,2022-05-28,CD Cobresal,Universidad de Chile,1,0,1,W
234868,22,CHL1,2022-05-29,CD Huachipato,CD Palestino,2,1,1,W
234869,22,CHL1,2022-05-29,Universidad Catolica,Antofagasta,1,0,1,W
234870,22,CHL1,2022-05-30,Union Espanola,Union La Calera,1,1,0,D
234871,22,CHL1,2022-05-30,Colo Colo,Nublense,0,0,0,D
234872,22,CHL1,2022-05-31,Everton,Higgins,0,0,0,D
234873,22,CHL1,2022-07-01,Nublense,Audax Italiano,1,2,-1,L
234874,22,CHL1,2022-07-01,Everton,Colo Colo,1,1,0,D
234875,22,CHL1,2022-07-02,CD Palestino,Union Espanola,1,0,1,W
234876,22,CHL1,2022-07-02,Universidad de Chile,Union La Calera,2,1,1,W
234877,22,CHL1,2022-07-03,CD Huachipato,Curico Unido,2,2,0,D
234878,22,CHL1,2022-07-03,La Serena,Higgins,1,0,1,W
234879,22,CHL1,2022-07-03,Universidad Catolica,Coquimbo Unido,2,0,2,W
234880,22,CHL1,2022-07-04,CD Cobresal,Antofagasta,2,1,1,W
234881,22,CHL1,2022-07-09,Higgins,CD Palestino,1,2,-1,L
234882,22,CHL1,2022-07-09,Curico Unido,CD Cobresal,1,0,1,W
234883,22,CHL1,2022-07-09,Audax Italiano,CD Huachipato,1,1,0,D
234884,22,CHL1,2022-07-10,Coquimbo Unido,Everton,1,1,0,D
234885,22,CHL1,2022-07-10,Antofagasta,Universidad de Chile,1,1,0,D
234886,22,CHL1,2022-07-10,Colo Colo,La Serena,3,0,3,W
234887,22,CHL1,2022-07-11,Union La Calera,Nublense,2,2,0,D
234888,22,CHL1,2022-07-16,CD Palestino,Coquimbo Unido,5,1,4,W
234889,22,CHL1,2022-07-16,Audax Italiano,Colo Colo,1,2,-1,L
234890,22,CHL1,2022-07-16,CD Cobresal,Union La Calera,3,1,2,W
234891,22,CHL1,2022-07-17,Everton,Union Espanola,2,1,1,W
234892,22,CHL1,2022-07-17,La Serena,Antofagasta,0,1,-1,L
234893,22,CHL1,2022-07-17,Universidad de Chile,Nublense,0,1,-1,L
234894,22,CHL1,2022-07-17,Curico Unido,Universidad Catolica,3,2,1,W
234895,22,CHL1,2022-07-18,CD Huachipato,Higgins,1,2,-1,L
234896,22,CHL1,2022-07-23,Nublense,CD Cobresal,3,2,1,W
234897,22,CHL1,2022-07-23,Antofagasta,Audax Italiano,2,3,-1,L
234898,22,CHL1,2022-07-23,Coquimbo Unido,La Serena,2,0,2,W
234899,22,CHL1,2022-07-23,Colo Colo,CD Huachipato,1,0,1,W
234900,22,CHL1,2022-07-24,Everton,Union La Calera,0,1,-1,L
234901,22,CHL1,2022-07-24,Higgins,Universidad de Chile,1,0,1,W
234902,22,CHL1,2022-07-24,Universidad Catolica,CD Palestino,0,1,-1,L
234903,22,CHL1,2022-07-25,Union Espanola,Curico Unido,1,3,-2,L
234904,22,CHL1,2022-07-29,CD Huachipato,Union Espanola,2,5,-3,L
234905,22,CHL1,2022-07-30,Union La Calera,CD Palestino,2,2,0,D
234906,22,CHL1,2022-07-30,Antofagasta,Coquimbo Unido,2,1,1,W
234907,22,CHL1,2022-07-30,La Serena,Nublense,3,0,3,W
234908,22,CHL1,2022-07-30,Universidad Catolica,CD Cobresal,1,0,1,W
234909,22,CHL1,2022-07-31,Curico Unido,Everton,0,4,-4,L
234910,22,CHL1,2022-07-31,Universidad de Chile,Colo Colo,1,3,-2,L
234911,22,CHL1,2022-07-31,Audax Italiano,Higgins,2,1,1,W
234912,22,CHL1,2022-08-06,Higgins,Curico Unido,0,0,0,D
234913,22,CHL1,2022-08-06,CD Cobresal,La Serena,1,1,0,D
234914,22,CHL1,2022-08-06,Everton,Universidad Catolica,1,1,0,D
234915,22,CHL1,2022-08-07,CD Palestino,Audax Italiano,3,3,0,D
234916,22,CHL1,2022-08-07,Union Espanola,Universidad de Chile,1,1,0,D
234917,22,CHL1,2022-08-07,Colo Colo,Antofagasta,1,0,1,W
234918,22,CHL1,2022-08-08,Nublense,Coquimbo Unido,2,1,1,W
234919,22,CHL1,2022-08-08,CD Huachipato,Union La Calera,3,4,-1,L
234920,22,CHL1,2022-08-12,Universidad Catolica,Higgins,2,2,0,D
234921,22,CHL1,2022-08-13,Coquimbo Unido,CD Cobresal,3,1,2,W
234922,22,CHL1,2022-08-13,Audax Italiano,Everton,1,0,1,W
234923,22,CHL1,2022-08-13,Curico Unido,Universidad de Chile,3,1,2,W
234924,22,CHL1,2022-08-14,Union La Calera,Antofagasta,1,1,0,D
234925,22,CHL1,2022-08-14,La Serena,CD Huachipato,0,1,-1,L
234926,22,CHL1,2022-08-14,Colo Colo,CD Palestino,1,0,1,W
234927,22,CHL1,2022-08-15,Nublense,Union Espanola,1,2,-1,L
234928,22,CHL1,2022-08-27,Everton,La Serena,4,0,4,W
234929,22,CHL1,2022-08-27,CD Palestino,Curico Unido,2,1,1,W
234930,22,CHL1,2022-08-27,Universidad de Chile,Universidad Catolica,0,3,-3,L
234931,22,CHL1,2022-08-27,Coquimbo Unido,Higgins,0,1,-1,L
234932,22,CHL1,2022-08-28,Antofagasta,Nublense,1,0,1,W
234933,22,CHL1,2022-08-28,CD Cobresal,CD Huachipato,2,0,2,W
234934,22,CHL1,2022-08-28,Union La Calera,Colo Colo,2,1,1,W
234935,22,CHL1,2022-08-29,Union Espanola,Audax Italiano,2,3,-1,L
234936,22,CHL1,2022-09-07,Universidad de Chile,Coquimbo Unido,0,0,0,D
234937,22,CHL1,2022-09-08,Audax Italiano,CD Cobresal,2,2,0,D
234938,22,CHL1,2022-09-08,Colo Colo,Union Espanola,4,0,4,W
234939,22,CHL1,2022-09-09,Curico Unido,Union La Calera,2,0,2,W
234940,22,CHL1,2022-09-09,Higgins,Antofagasta,1,0,1,W
234941,22,CHL1,2022-09-10,CD Huachipato,Everton,1,1,0,D
234942,22,CHL1,2022-09-10,La Serena,Universidad Catolica,0,4,-4,L
234943,22,CHL1,2022-09-10,Nublense,CD Palestino,2,0,2,W
234944,22,CHL1,2022-09-13,Coquimbo Unido,Audax Italiano,0,1,-1,L
234945,22,CHL1,2022-09-14,Higgins,Union La Calera,2,2,0,D
234946,22,CHL1,2022-09-14,Union Espanola,La Serena,0,1,-1,L
234947,22,CHL1,2022-09-14,CD Cobresal,Colo Colo,0,2,-2,L
234948,22,CHL1,2022-09-14,Everton,Nublense,1,1,0,D
234949,22,CHL1,2022-09-15,Universidad Catolica,CD Huachipato,1,0,1,W
234950,22,CHL1,2022-09-15,CD Palestino,Universidad de Chile,1,2,-1,L
234951,22,CHL1,2022-09-15,Antofagasta,Curico Unido,0,0,0,D
234952,22,CHL1,2022-10-01,Union La Calera,Coquimbo Unido,2,0,2,W
234953,22,CHL1,2022-10-01,CD Huachipato,Antofagasta,1,0,1,W
234954,22,CHL1,2022-10-01,CD Palestino,Everton,1,4,-3,L
234955,22,CHL1,2022-10-02,Curico Unido,La Serena,1,0,1,W
234956,22,CHL1,2022-10-02,Nublense,Higgins,2,2,0,D
234957,22,CHL1,2022-10-02,CD Cobresal,Union Espanola,2,0,2,W
234958,22,CHL1,2022-10-03,Universidad de Chile,Audax Italiano,2,3,-1,L
234959,22,CHL1,2022-10-04,Colo Colo,Universidad Catolica,0,0,0,D
234960,22,CHL1,2022-10-07,CD Huachipato,Coquimbo Unido,0,1,-1,L
234961,22,CHL1,2022-10-08,Universidad Catolica,Nublense,2,2,0,D
234962,22,CHL1,2022-10-09,Union Espanola,Higgins,0,0,0,D
234963,22,CHL1,2022-10-09,La Serena,Universidad de Chile,1,2,-1,L
234964,22,CHL1,2022-10-09,Colo Colo,Curico Unido,1,1,0,D
234965,22,CHL1,2022-10-10,Everton,CD Cobresal,3,3,0,D
234966,22,CHL1,2022-10-10,Audax Italiano,Union La Calera,0,2,-2,L
234967,22,CHL1,2022-10-19,Union Espanola,Universidad Catolica,1,2,-1,L
234968,22,CHL1,2022-10-21,Higgins,CD Cobresal,1,0,1,W
234969,22,CHL1,2022-10-22,Nublense,CD Huachipato,2,0,2,W
234970,22,CHL1,2022-10-23,Universidad de Chile,Everton,1,1,0,D
234971,22,CHL1,2022-10-23,Antofagasta,Union Espanola,2,0,2,W
234972,22,CHL1,2022-10-23,Coquimbo Unido,Colo Colo,0,2,-2,L
234973,22,CHL1,2022-10-23,CD Palestino,La Serena,5,0,5,W
234974,22,CHL1,2022-10-23,Union La Calera,Universidad Catolica,4,0,4,W
234975,22,CHL1,2022-10-25,Audax Italiano,Curico Unido,1,1,0,D
234976,22,CHL1,2022-10-30,CD Cobresal,CD Palestino,1,0,1,W
234977,22,CHL1,2022-10-30,CD Huachipato,Universidad de Chile,4,0,4,W
234978,22,CHL1,2022-10-30,Everton,Antofagasta,3,0,3,W
234979,22,CHL1,2022-10-30,La Serena,Union La Calera,2,1,1,W
234980,22,CHL1,2022-10-30,Union Espanola,Coquimbo Unido,1,3,-2,L
234981,22,CHL1,2022-10-30,Colo Colo,Higgins,2,0,2,W
234982,22,CHL1,2022-10-31,Curico Unido,Nublense,1,2,-1,L
234983,22,CHL1,2022-10-31,Universidad Catolica,Audax Italiano,0,0,0,D
234984,22,CHL1,2022-11-05,Higgins,Everton,2,0,2,W
234985,22,CHL1,2022-11-05,CD Palestino,CD Huachipato,5,0,5,W
234986,22,CHL1,2022-11-05,Universidad de Chile,CD Cobresal,3,4,-1,L
234987,22,CHL1,2022-11-06,Audax Italiano,La Serena,3,0,3,W
234988,22,CHL1,2022-11-06,Antofagasta,Universidad Catolica,0,2,-2,L
234989,22,CHL1,2022-11-06,Coquimbo Unido,Curico Unido,1,1,0,D
234990,22,CHL1,2022-11-06,Nublense,Colo Colo,1,1,0,D
234991,22,CHL1,2022-11-06,Union La Calera,Union Espanola,2,1,1,W
234992,23,CHL1,2023-01-20,Deportes Magallanes,Higgins,0,1,-1,L
234993,23,CHL1,2023-01-20,Union Espanola,Nublense,0,1,-1,L
234994,23,CHL1,2023-01-21,CD Palestino,Audax Italiano,1,1,0,D
234995,23,CHL1,2023-01-21,CD Cobresal,Union La Calera,3,1,2,W
234996,23,CHL1,2023-01-22,Everton,Universidad Catolica,0,3,-3,L
234997,23,CHL1,2023-01-22,Deportes Copiapo,Colo Colo,2,5,-3,L
234998,23,CHL1,2023-01-23,Curico Unido,Coquimbo Unido,1,0,1,W
234999,23,CHL1,2023-01-23,Universidad de Chile,CD Huachipato,1,3,-2,L
235000,23,CHL1,2023-01-27,Nublense,Deportes Magallanes,3,2,1,W
235001,23,CHL1,2023-01-28,Union La Calera,Everton,3,2,1,W
235002,23,CHL1,2023-01-28,Coquimbo Unido,CD Palestino,1,1,0,D
235003,23,CHL1,2023-01-28,Universidad de Chile,Union Espanola,1,0,1,W
235004,23,CHL1,2023-01-28,Universidad Catolica,Curico Unido,3,1,2,W
235005,23,CHL1,2023-01-29,CD Huachipato,CD Cobresal,2,1,1,W
235006,23,CHL1,2023-01-29,Higgins,Colo Colo,5,1,4,W
235007,23,CHL1,2023-01-29,Audax Italiano,Deportes Copiapo,3,0,3,W
235008,23,CHL1,2023-02-03,Coquimbo Unido,Universidad Catolica,2,1,1,W
235009,23,CHL1,2023-02-04,Curico Unido,Audax Italiano,2,1,1,W
235010,23,CHL1,2023-02-04,Deportes Magallanes,Union La Calera,1,1,0,D
235011,23,CHL1,2023-02-04,Union Espanola,Everton,1,1,0,D
235012,23,CHL1,2023-02-05,CD Palestino,Universidad de Chile,2,0,2,W
235013,23,CHL1,2023-02-05,CD Cobresal,Deportes Copiapo,1,0,1,W
235014,23,CHL1,2023-02-06,Higgins,CD Huachipato,0,1,-1,L
235015,23,CHL1,2023-02-10,Audax Italiano,Union Espanola,1,1,0,D
235016,23,CHL1,2023-02-11,Deportes Copiapo,CD Palestino,1,3,-2,L
235017,23,CHL1,2023-02-11,Union La Calera,Curico Unido,3,2,1,W
235018,23,CHL1,2023-02-11,Universidad de Chile,Deportes Magallanes,2,1,1,W
235019,23,CHL1,2023-02-11,Everton,Coquimbo Unido,2,0,2,W
235020,23,CHL1,2023-02-12,Universidad Catolica,CD Cobresal,3,3,0,D
235021,23,CHL1,2023-02-13,Colo Colo,Nublense,1,0,1,W
235022,23,CHL1,2023-02-16,Curico Unido,Deportes Copiapo,1,2,-1,L
235023,23,CHL1,2023-02-17,Union Espanola,Deportes Magallanes,1,2,-1,L
235024,23,CHL1,2023-02-18,Coquimbo Unido,CD Huachipato,1,2,-1,L
235025,23,CHL1,2023-02-18,CD Cobresal,Nublense,1,1,0,D
235026,23,CHL1,2023-02-18,Audax Italiano,Universidad Catolica,1,2,-1,L
235027,23,CHL1,2023-02-19,Higgins,Universidad de Chile,0,1,-1,L
235028,23,CHL1,2023-02-19,Colo Colo,Everton,1,1,0,D
235029,23,CHL1,2023-02-20,CD Palestino,Union La Calera,1,1,0,D
235030,23,CHL1,2023-02-24,Curico Unido,Universidad de Chile,1,3,-2,L
235031,23,CHL1,2023-02-25,Universidad Catolica,CD Palestino,5,2,3,W
235032,23,CHL1,2023-02-26,Deportes Magallanes,CD Cobresal,2,1,1,W
235033,23,CHL1,2023-02-26,Union La Calera,Nublense,1,1,0,D
235034,23,CHL1,2023-02-26,Colo Colo,Coquimbo Unido,2,3,-1,L
235035,23,CHL1,2023-02-27,Deportes Copiapo,Higgins,2,2,0,D
235036,23,CHL1,2023-02-27,Everton,Audax Italiano,3,1,2,W
235037,23,CHL1,2023-03-02,Universidad de Chile,Union La Calera,1,1,0,D
235038,23,CHL1,2023-03-03,Coquimbo Unido,Audax Italiano,3,1,2,W
235039,23,CHL1,2023-03-03,CD Palestino,CD Huachipato,2,1,1,W
235040,23,CHL1,2023-03-03,Nublense,Universidad Catolica,1,2,-1,L
235041,23,CHL1,2023-03-04,Higgins,Curico Unido,2,2,0,D
235042,23,CHL1,2023-03-04,Union Espanola,Deportes Copiapo,3,0,3,W
235043,23,CHL1,2023-03-05,Colo Colo,Deportes Magallanes,2,0,2,W
235044,23,CHL1,2023-03-05,CD Cobresal,Everton,3,2,1,W
235045,23,CHL1,2023-03-10,Deportes Copiapo,Union La Calera,0,0,0,D
235046,23,CHL1,2023-03-11,Everton,Nublense,1,0,1,W
235047,23,CHL1,2023-03-11,Curico Unido,CD Huachipato,1,3,-2,L
235048,23,CHL1,2023-03-12,Universidad Catolica,Union Espanola,2,2,0,D
235049,23,CHL1,2023-03-12,Colo Colo,Universidad de Chile,0,0,0,D
235050,23,CHL1,2023-03-13,Audax Italiano,Higgins,2,2,0,D
235051,23,CHL1,2023-03-13,Coquimbo Unido,CD Cobresal,2,1,1,W
235052,23,CHL1,2023-03-17,Nublense,Curico Unido,1,2,-1,L
235053,23,CHL1,2023-03-18,CD Huachipato,Everton,3,0,3,W
235054,23,CHL1,2023-03-18,Higgins,Coquimbo Unido,0,2,-2,L
235055,23,CHL1,2023-03-18,CD Cobresal,Colo Colo,3,1,2,W
235056,23,CHL1,2023-03-18,Union La Calera,Audax Italiano,0,0,0,D
235057,23,CHL1,2023-03-19,Universidad de Chile,Deportes Copiapo,0,0,0,D
235058,23,CHL1,2023-03-19,Deportes Magallanes,Universidad Catolica,1,1,0,D
235059,23,CHL1,2023-03-19,Union Espanola,CD Palestino,2,0,2,W
235060,23,CHL1,2023-03-31,Nublense,Higgins,2,1,1,W
235061,23,CHL1,2023-04-01,CD Huachipato,Colo Colo,0,1,-1,L
235062,23,CHL1,2023-04-01,CD Palestino,Deportes Magallanes,3,2,1,W
