,Sea,Lge,Date,HT,AT,HS,AS,GD,WDL
131439,0,BEL1,2000-08-12,Beveren,Charleroi,1,2,-1,L
131440,0,BEL1,2000-08-12,Mechelen,Genk,0,0,0,D
131441,0,BEL1,2000-08-12,Louvieroise,Lokeren,0,0,0,D
131442,0,BEL1,2000-08-12,Mouscron,Germinal,3,0,3,W
131443,0,BEL1,2000-08-12,Westerlo,Antwerp,2,1,1,W
131444,0,BEL1,2000-08-13,Aalst,Lierse,1,3,-2,L
131445,0,BEL1,2000-08-13,Club Brugge,Gent,6,2,4,W
131446,0,BEL1,2000-08-13,Harelbeke,Standard,3,4,-1,L
131447,0,BEL1,2000-08-13,St Truiden,Anderlecht,0,0,0,D
131448,0,BEL1,2000-08-19,Gent,Mechelen,2,1,1,W
131449,0,BEL1,2000-08-19,Anderlecht,Westerlo,3,2,1,W
131450,0,BEL1,2000-08-19,Antwerp,Beveren,0,1,-1,L
131451,0,BEL1,2000-08-19,Charleroi,Harelbeke,5,0,5,W
131452,0,BEL1,2000-08-19,Genk,Aalst,3,1,2,W
131453,0,BEL1,2000-08-19,Lokeren,Germinal,2,0,2,W
131454,0,BEL1,2000-08-19,St Truiden,Lierse,0,1,-1,L
131455,0,BEL1,2000-08-19,Standard,Louvieroise,3,0,3,W
131456,0,BEL1,2000-08-20,Mouscron,Club Brugge,1,2,-1,L
131457,0,BEL1,2000-08-25,Germinal,Standard,1,0,1,W
131458,0,BEL1,2000-08-26,Anderlecht,Beveren,4,0,4,W
131459,0,BEL1,2000-08-26,Mechelen,Mouscron,1,5,-4,L
131460,0,BEL1,2000-08-26,St Truiden,Genk,2,2,0,D
131461,0,BEL1,2000-08-27,Aalst,Gent,1,4,-3,L
131462,0,BEL1,2000-08-27,Charleroi,Antwerp,1,0,1,W
131463,0,BEL1,2000-08-27,Club Brugge,Lokeren,3,1,2,W
131464,0,BEL1,2000-08-27,Harelbeke,Louvieroise,2,2,0,D
131465,0,BEL1,2000-08-27,Westerlo,Lierse,1,0,1,W
131466,0,BEL1,2000-09-05,Anderlecht,Charleroi,7,2,5,W
131467,0,BEL1,2000-09-06,Gent,St Truiden,2,1,1,W
131468,0,BEL1,2000-09-06,Antwerp,Harelbeke,2,0,2,W
131469,0,BEL1,2000-09-06,Genk,Westerlo,1,2,-1,L
131470,0,BEL1,2000-09-06,Louvieroise,Germinal,0,5,-5,L
131471,0,BEL1,2000-09-06,Lierse,Beveren,3,0,3,W
131472,0,BEL1,2000-09-06,Lokeren,Mechelen,3,2,1,W
131473,0,BEL1,2000-09-06,Mouscron,Aalst,2,0,2,W
131474,0,BEL1,2000-09-06,Standard,Club Brugge,0,4,-4,L
131475,0,BEL1,2000-09-09,Antwerp,Anderlecht,0,3,-3,L
131476,0,BEL1,2000-09-09,Beveren,Genk,2,0,2,W
131477,0,BEL1,2000-09-09,Charleroi,Lierse,2,0,2,W
131478,0,BEL1,2000-09-09,Mechelen,Standard,0,4,-4,L
131479,0,BEL1,2000-09-09,St Truiden,Mouscron,1,4,-3,L
131480,0,BEL1,2000-09-09,Westerlo,Gent,0,0,0,D
131481,0,BEL1,2000-09-10,Aalst,Lokeren,2,2,0,D
131482,0,BEL1,2000-09-10,Club Brugge,Louvieroise,3,0,3,W
131483,0,BEL1,2000-09-10,Harelbeke,Germinal,3,0,3,W
131484,0,BEL1,2000-09-16,Gent,Beveren,5,0,5,W
131485,0,BEL1,2000-09-16,Anderlecht,Harelbeke,4,3,1,W
131486,0,BEL1,2000-09-16,Louvieroise,Mechelen,2,2,0,D
131487,0,BEL1,2000-09-16,Lierse,Antwerp,4,1,3,W
131488,0,BEL1,2000-09-16,Lokeren,St Truiden,2,1,1,W
131489,0,BEL1,2000-09-16,Mouscron,Westerlo,3,5,-2,L
131490,0,BEL1,2000-09-16,Standard,Aalst,7,0,7,W
131491,0,BEL1,2000-09-17,Germinal,Club Brugge,2,3,-1,L
131492,0,BEL1,2000-09-17,Genk,Charleroi,2,1,1,W
131493,0,BEL1,2000-09-22,Anderlecht,Lierse,5,2,3,W
131494,0,BEL1,2000-09-23,Beveren,Mouscron,0,0,0,D
131495,0,BEL1,2000-09-23,Charleroi,Gent,4,3,1,W
131496,0,BEL1,2000-09-23,Mechelen,Germinal,2,3,-1,L
131497,0,BEL1,2000-09-23,St Truiden,Standard,1,1,0,D
131498,0,BEL1,2000-09-23,Westerlo,Lokeren,1,1,0,D
131499,0,BEL1,2000-09-24,Aalst,Louvieroise,1,0,1,W
131500,0,BEL1,2000-09-24,Harelbeke,Club Brugge,0,6,-6,L
131501,0,BEL1,2000-09-29,Mouscron,Charleroi,3,0,3,W
131502,0,BEL1,2000-09-30,Germinal,Aalst,2,0,2,W
131503,0,BEL1,2000-09-30,Louvieroise,St Truiden,1,0,1,W
131504,0,BEL1,2000-09-30,Lierse,Harelbeke,4,1,3,W
131505,0,BEL1,2000-09-30,Lokeren,Beveren,1,1,0,D
131506,0,BEL1,2000-09-30,Standard,Westerlo,5,3,2,W
131507,0,BEL1,2000-10-01,Gent,Antwerp,4,2,2,W
131508,0,BEL1,2000-10-01,Club Brugge,Mechelen,5,2,3,W
131509,0,BEL1,2000-10-01,Genk,Anderlecht,1,1,0,D
131510,0,BEL1,2000-10-13,Lierse,Genk,1,1,0,D
131511,0,BEL1,2000-10-14,Anderlecht,Gent,2,1,1,W
131512,0,BEL1,2000-10-14,Antwerp,Mouscron,1,0,1,W
131513,0,BEL1,2000-10-14,Beveren,Standard,0,3,-3,L
131514,0,BEL1,2000-10-14,Charleroi,Lokeren,1,0,1,W
131515,0,BEL1,2000-10-14,St Truiden,Germinal,3,2,1,W
131516,0,BEL1,2000-10-15,Aalst,Club Brugge,0,2,-2,L
131517,0,BEL1,2000-10-15,Harelbeke,Mechelen,1,0,1,W
131518,0,BEL1,2000-10-15,Westerlo,Louvieroise,2,1,1,W
131519,0,BEL1,2000-10-20,Standard,Charleroi,4,0,4,W
131520,0,BEL1,2000-10-21,Gent,Lierse,2,3,-1,L
131521,0,BEL1,2000-10-21,Germinal,Westerlo,3,1,2,W
131522,0,BEL1,2000-10-21,Genk,Harelbeke,4,0,4,W
131523,0,BEL1,2000-10-21,Louvieroise,Beveren,2,3,-1,L
131524,0,BEL1,2000-10-21,Lokeren,Antwerp,0,1,-1,L
131525,0,BEL1,2000-10-21,Mouscron,Anderlecht,1,2,-1,L
131526,0,BEL1,2000-10-22,Club Brugge,St Truiden,5,0,5,W
131527,0,BEL1,2000-10-22,Mechelen,Aalst,4,1,3,W
131528,0,BEL1,2000-10-27,Lierse,Mouscron,1,4,-3,L
131529,0,BEL1,2000-10-28,Anderlecht,Lokeren,8,0,8,W
131530,0,BEL1,2000-10-28,Beveren,Germinal,2,1,1,W
131531,0,BEL1,2000-10-28,Charleroi,Louvieroise,2,1,1,W
131532,0,BEL1,2000-10-28,Genk,Gent,1,1,0,D
131533,0,BEL1,2000-10-28,St Truiden,Mechelen,1,0,1,W
131534,0,BEL1,2000-10-29,Antwerp,Standard,1,2,-1,L
131535,0,BEL1,2000-10-29,Harelbeke,Aalst,2,4,-2,L
131536,0,BEL1,2000-10-29,Westerlo,Club Brugge,0,2,-2,L
131537,0,BEL1,2000-11-01,Antwerp,Genk,1,0,1,W
131538,0,BEL1,2000-11-11,Gent,Harelbeke,2,1,1,W
131539,0,BEL1,2000-11-11,Germinal,Charleroi,0,2,-2,L
131540,0,BEL1,2000-11-11,Mechelen,Westerlo,0,1,-1,L
131541,0,BEL1,2000-11-11,Lokeren,Lierse,2,0,2,W
131542,0,BEL1,2000-11-12,Aalst,St Truiden,4,1,3,W
131543,0,BEL1,2000-11-12,Club Brugge,Beveren,6,0,6,W
131544,0,BEL1,2000-11-12,Louvieroise,Antwerp,2,2,0,D
131545,0,BEL1,2000-11-12,Mouscron,Genk,2,0,2,W
131546,0,BEL1,2000-11-12,Standard,Anderlecht,1,1,0,D
131547,0,BEL1,2000-11-17,Charleroi,Club Brugge,0,4,-4,L
131548,0,BEL1,2000-11-18,Gent,Mouscron,1,0,1,W
131549,0,BEL1,2000-11-18,Anderlecht,Louvieroise,2,0,2,W
131550,0,BEL1,2000-11-18,Beveren,Mechelen,1,1,0,D
131551,0,BEL1,2000-11-18,Genk,Lokeren,0,0,0,D
131552,0,BEL1,2000-11-18,Lierse,Standard,1,1,0,D
131553,0,BEL1,2000-11-18,Westerlo,Aalst,1,1,0,D
131554,0,BEL1,2000-11-19,Antwerp,Germinal,1,2,-1,L
131555,0,BEL1,2000-11-19,Harelbeke,St Truiden,0,4,-4,L
131556,0,BEL1,2000-11-24,Standard,Genk,2,1,1,W
131557,0,BEL1,2000-11-25,Germinal,Anderlecht,0,1,-1,L
131558,0,BEL1,2000-11-25,Mechelen,Charleroi,4,3,1,W
131559,0,BEL1,2000-11-25,Louvieroise,Lierse,0,2,-2,L
131560,0,BEL1,2000-11-25,Lokeren,Gent,1,1,0,D
131561,0,BEL1,2000-11-25,Mouscron,Harelbeke,4,3,1,W
131562,0,BEL1,2000-11-25,St Truiden,Westerlo,1,2,-1,L
131563,0,BEL1,2000-11-26,Aalst,Beveren,1,1,0,D
131564,0,BEL1,2000-11-26,Club Brugge,Antwerp,2,0,2,W
131565,0,BEL1,2000-12-01,Anderlecht,Club Brugge,2,0,2,W
131566,0,BEL1,2000-12-02,Gent,Standard,2,1,1,W
131567,0,BEL1,2000-12-02,Antwerp,Mechelen,3,1,2,W
131568,0,BEL1,2000-12-02,Charleroi,Aalst,0,0,0,D
131569,0,BEL1,2000-12-02,Genk,Louvieroise,1,0,1,W
131570,0,BEL1,2000-12-02,Lierse,Germinal,1,1,0,D
131571,0,BEL1,2000-12-02,Mouscron,Lokeren,2,1,1,W
131572,0,BEL1,2000-12-03,Beveren,St Truiden,0,0,0,D
131573,0,BEL1,2000-12-03,Harelbeke,Westerlo,0,4,-4,L
131574,0,BEL1,2000-12-08,Standard,Mouscron,3,3,0,D
131575,0,BEL1,2000-12-09,Germinal,Genk,5,1,4,W
131576,0,BEL1,2000-12-09,Mechelen,Anderlecht,0,2,-2,L
131577,0,BEL1,2000-12-09,Louvieroise,Gent,1,1,0,D
131578,0,BEL1,2000-12-09,St Truiden,Charleroi,1,3,-2,L
131579,0,BEL1,2000-12-09,Westerlo,Beveren,1,2,-1,L
131580,0,BEL1,2000-12-10,Aalst,Antwerp,0,4,-4,L
131581,0,BEL1,2000-12-10,Club Brugge,Lierse,1,0,1,W
131582,0,BEL1,2000-12-10,Harelbeke,Lokeren,1,6,-5,L
131583,0,BEL1,2000-12-15,Charleroi,Westerlo,2,2,0,D
131584,0,BEL1,2000-12-16,Gent,Germinal,3,1,2,W
131585,0,BEL1,2000-12-16,Anderlecht,Aalst,3,0,3,W
131586,0,BEL1,2000-12-16,Antwerp,St Truiden,2,0,2,W
131587,0,BEL1,2000-12-16,Beveren,Harelbeke,2,1,1,W
131588,0,BEL1,2000-12-16,Lierse,Mechelen,1,1,0,D
131589,0,BEL1,2000-12-16,Lokeren,Standard,2,1,1,W
131590,0,BEL1,2000-12-16,Mouscron,Louvieroise,0,0,0,D
131591,0,BEL1,2000-12-17,Genk,Club Brugge,0,1,-1,L
131592,0,BEL1,2000-12-20,Anderlecht,St Truiden,3,2,1,W
131593,0,BEL1,2000-12-20,Antwerp,Westerlo,1,3,-2,L
131594,0,BEL1,2000-12-20,Charleroi,Beveren,5,0,5,W
131595,0,BEL1,2000-12-20,Germinal,Mouscron,4,1,3,W
131596,0,BEL1,2000-12-20,Genk,Mechelen,3,1,2,W
131597,0,BEL1,2000-12-20,Lierse,Aalst,2,0,2,W
131598,0,BEL1,2000-12-20,Lokeren,Louvieroise,3,1,2,W
131599,0,BEL1,2000-12-20,Standard,Harelbeke,3,0,3,W
131600,0,BEL1,2001-01-19,Club Brugge,Mouscron,2,2,0,D
131601,0,BEL1,2001-01-20,Beveren,Antwerp,2,1,1,W
131602,0,BEL1,2001-01-20,Germinal,Lokeren,2,0,2,W
131603,0,BEL1,2001-01-20,Mechelen,Gent,3,3,0,D
131604,0,BEL1,2001-01-20,Louvieroise,Standard,0,4,-4,L
131605,0,BEL1,2001-01-20,Lierse,St Truiden,2,1,1,W
131606,0,BEL1,2001-01-21,Aalst,Genk,4,2,2,W
131607,0,BEL1,2001-01-21,Harelbeke,Charleroi,1,0,1,W
131608,0,BEL1,2001-01-27,Gent,Aalst,1,0,1,W
131609,0,BEL1,2001-01-27,Antwerp,Charleroi,1,1,0,D
131610,0,BEL1,2001-01-27,Beveren,Anderlecht,1,3,-2,L
131611,0,BEL1,2001-01-27,Genk,St Truiden,3,0,3,W
131612,0,BEL1,2001-01-27,Lierse,Westerlo,1,2,-1,L
131613,0,BEL1,2001-01-27,Lokeren,Club Brugge,2,2,0,D
131614,0,BEL1,2001-01-28,Louvieroise,Harelbeke,0,2,-2,L
131615,0,BEL1,2001-01-28,Mouscron,Mechelen,4,2,2,W
131616,0,BEL1,2001-01-28,Standard,Germinal,1,1,0,D
131617,0,BEL1,2001-02-02,Charleroi,Anderlecht,0,4,-4,L
131618,0,BEL1,2001-02-03,Beveren,Lierse,2,1,1,W
131619,0,BEL1,2001-02-03,Germinal,Louvieroise,3,1,2,W
131620,0,BEL1,2001-02-03,Mechelen,Lokeren,0,3,-3,L
131621,0,BEL1,2001-02-03,St Truiden,Gent,0,1,-1,L
131622,0,BEL1,2001-02-03,Westerlo,Genk,5,0,5,W
131623,0,BEL1,2001-02-04,Aalst,Mouscron,1,0,1,W
131624,0,BEL1,2001-02-04,Club Brugge,Standard,1,1,0,D
131625,0,BEL1,2001-02-04,Harelbeke,Antwerp,2,0,2,W
131626,0,BEL1,2001-02-09,Anderlecht,Antwerp,2,0,2,W
131627,0,BEL1,2001-02-09,Louvieroise,Club Brugge,1,1,0,D
131628,0,BEL1,2001-02-10,Gent,Westerlo,3,1,2,W
131629,0,BEL1,2001-02-10,Germinal,Harelbeke,2,1,1,W
131630,0,BEL1,2001-02-10,Genk,Beveren,1,0,1,W
131631,0,BEL1,2001-02-10,Lierse,Charleroi,2,0,2,W
131632,0,BEL1,2001-02-10,Lokeren,Aalst,2,0,2,W
131633,0,BEL1,2001-02-10,Mouscron,St Truiden,1,0,1,W
131634,0,BEL1,2001-02-11,Standard,Mechelen,2,0,2,W
131635,0,BEL1,2001-02-16,Westerlo,Mouscron,1,0,1,W
131636,0,BEL1,2001-02-17,Antwerp,Lierse,0,0,0,D
131637,0,BEL1,2001-02-17,Beveren,Gent,1,1,0,D
131638,0,BEL1,2001-02-17,Charleroi,Genk,2,1,1,W
131639,0,BEL1,2001-02-17,Mechelen,Louvieroise,0,0,0,D
131640,0,BEL1,2001-02-17,St Truiden,Lokeren,2,0,2,W
131641,0,BEL1,2001-02-18,Aalst,Standard,1,1,0,D
131642,0,BEL1,2001-02-18,Club Brugge,Germinal,2,2,0,D
131643,0,BEL1,2001-02-18,Harelbeke,Anderlecht,1,4,-3,L
131644,0,BEL1,2001-02-24,Gent,Club Brugge,0,2,-2,L
131645,0,BEL1,2001-02-24,Westerlo,Anderlecht,2,2,0,D
131646,0,BEL1,2001-03-03,Gent,Charleroi,1,1,0,D
131647,0,BEL1,2001-03-03,Germinal,Mechelen,4,1,3,W
131648,0,BEL1,2001-03-03,Genk,Antwerp,1,1,0,D
131649,0,BEL1,2001-03-03,Louvieroise,Aalst,3,0,3,W
131650,0,BEL1,2001-03-03,Lierse,Anderlecht,0,0,0,D
131651,0,BEL1,2001-03-03,Mouscron,Beveren,0,0,0,D
131652,0,BEL1,2001-03-03,Standard,St Truiden,1,1,0,D
131653,0,BEL1,2001-03-04,Club Brugge,Harelbeke,0,0,0,D
131654,0,BEL1,2001-03-04,Lokeren,Westerlo,2,0,2,W
131655,0,BEL1,2001-03-09,Westerlo,Standard,2,2,0,D
131656,0,BEL1,2001-03-10,Anderlecht,Genk,1,0,1,W
131657,0,BEL1,2001-03-10,Beveren,Lokeren,0,2,-2,L
131658,0,BEL1,2001-03-10,Charleroi,Mouscron,1,3,-2,L
131659,0,BEL1,2001-03-10,Mechelen,Club Brugge,1,1,0,D
131660,0,BEL1,2001-03-11,Aalst,Germinal,2,0,2,W
131661,0,BEL1,2001-03-11,Antwerp,Gent,1,0,1,W
131662,0,BEL1,2001-03-11,Harelbeke,Lierse,1,0,1,W
131663,0,BEL1,2001-03-11,St Truiden,Louvieroise,1,1,0,D
131664,0,BEL1,2001-03-17,Gent,Anderlecht,2,1,1,W
131665,0,BEL1,2001-03-17,Germinal,St Truiden,1,0,1,W
131666,0,BEL1,2001-03-17,Genk,Lierse,2,0,2,W
131667,0,BEL1,2001-03-17,Louvieroise,Westerlo,3,1,2,W
131668,0,BEL1,2001-03-17,Lokeren,Charleroi,1,0,1,W
131669,0,BEL1,2001-03-17,Mouscron,Antwerp,3,2,1,W
131670,0,BEL1,2001-03-17,Standard,Beveren,4,2,2,W
131671,0,BEL1,2001-03-18,Club Brugge,Aalst,1,1,0,D
131672,0,BEL1,2001-03-18,Mechelen,Harelbeke,2,0,2,W
131673,0,BEL1,2001-03-30,Anderlecht,Mouscron,3,3,0,D
131674,0,BEL1,2001-03-31,Antwerp,Lokeren,2,1,1,W
131675,0,BEL1,2001-03-31,Lierse,Gent,2,0,2,W
131676,0,BEL1,2001-03-31,St Truiden,Club Brugge,1,2,-1,L
131677,0,BEL1,2001-03-31,Westerlo,Germinal,1,2,-1,L
131678,0,BEL1,2001-04-01,Aalst,Mechelen,1,3,-2,L
131679,0,BEL1,2001-04-01,Beveren,Louvieroise,0,1,-1,L
131680,0,BEL1,2001-04-01,Charleroi,Standard,2,3,-1,L
131681,0,BEL1,2001-04-01,Harelbeke,Genk,1,2,-1,L
131682,0,BEL1,2001-04-06,Louvieroise,Charleroi,1,1,0,D
131683,0,BEL1,2001-04-07,Gent,Genk,2,1,1,W
131684,0,BEL1,2001-04-07,Aalst,Harelbeke,0,0,0,D
131685,0,BEL1,2001-04-07,Club Brugge,Westerlo,2,2,0,D
131686,0,BEL1,2001-04-07,Germinal,Beveren,2,0,2,W
131687,0,BEL1,2001-04-07,Mechelen,St Truiden,1,2,-1,L
131688,0,BEL1,2001-04-07,Lokeren,Anderlecht,0,0,0,D
131689,0,BEL1,2001-04-07,Mouscron,Lierse,1,2,-1,L
131690,0,BEL1,2001-04-07,Standard,Antwerp,0,1,-1,L
131691,0,BEL1,2001-04-13,Anderlecht,Standard,0,0,0,D
131692,0,BEL1,2001-04-14,Antwerp,Louvieroise,1,1,0,D
131693,0,BEL1,2001-04-14,Beveren,Club Brugge,0,2,-2,L
131694,0,BEL1,2001-04-14,Charleroi,Germinal,2,1,1,W
131695,0,BEL1,2001-04-14,Genk,Mouscron,4,0,4,W
131696,0,BEL1,2001-04-14,Harelbeke,Gent,2,1,1,W
131697,0,BEL1,2001-04-14,Lierse,Lokeren,1,4,-3,L
131698,0,BEL1,2001-04-14,St Truiden,Aalst,1,0,1,W
131699,0,BEL1,2001-04-14,Westerlo,Mechelen,0,0,0,D
131700,0,BEL1,2001-04-20,Louvieroise,Anderlecht,0,1,-1,L
131701,0,BEL1,2001-04-21,Mechelen,Beveren,2,2,0,D
131702,0,BEL1,2001-04-21,Lokeren,Genk,2,2,0,D
131703,0,BEL1,2001-04-21,Mouscron,Gent,2,2,0,D
131704,0,BEL1,2001-04-21,St Truiden,Harelbeke,1,1,0,D
131705,0,BEL1,2001-04-21,Standard,Lierse,3,2,1,W
131706,0,BEL1,2001-04-22,Aalst,Westerlo,1,2,-1,L
131707,0,BEL1,2001-04-22,Club Brugge,Charleroi,1,0,1,W
131708,0,BEL1,2001-04-22,Germinal,Antwerp,3,1,2,W
131709,0,BEL1,2001-04-28,Gent,Lokeren,3,2,1,W
131710,0,BEL1,2001-04-28,Anderlecht,Germinal,7,0,7,W
131711,0,BEL1,2001-04-28,Beveren,Aalst,1,0,1,W
131712,0,BEL1,2001-04-28,Charleroi,Mechelen,4,1,3,W
131713,0,BEL1,2001-04-28,Genk,Standard,2,2,0,D
131714,0,BEL1,2001-04-28,Lierse,Louvieroise,1,2,-1,L
131715,0,BEL1,2001-04-28,Westerlo,St Truiden,4,6,-2,L
131716,0,BEL1,2001-04-29,Antwerp,Club Brugge,0,1,-1,L
131717,0,BEL1,2001-04-29,Harelbeke,Mouscron,0,1,-1,L
131718,0,BEL1,2001-05-04,Mechelen,Antwerp,0,3,-3,L
131719,0,BEL1,2001-05-05,Club Brugge,Anderlecht,0,1,-1,L
131720,0,BEL1,2001-05-05,Germinal,Lierse,6,0,6,W
131721,0,BEL1,2001-05-05,Louvieroise,Genk,2,1,1,W
131722,0,BEL1,2001-05-05,Lokeren,Mouscron,2,1,1,W
131723,0,BEL1,2001-05-05,St Truiden,Beveren,1,0,1,W
131724,0,BEL1,2001-05-05,Standard,Gent,1,0,1,W
131725,0,BEL1,2001-05-06,Aalst,Charleroi,4,0,4,W
131726,0,BEL1,2001-05-06,Westerlo,Harelbeke,1,0,1,W
131727,0,BEL1,2001-05-12,Gent,Louvieroise,2,2,0,D
131728,0,BEL1,2001-05-12,Anderlecht,Mechelen,1,0,1,W
131729,0,BEL1,2001-05-12,Antwerp,Aalst,0,0,0,D
131730,0,BEL1,2001-05-12,Beveren,Westerlo,1,4,-3,L
131731,0,BEL1,2001-05-12,Charleroi,St Truiden,1,7,-6,L
131732,0,BEL1,2001-05-12,Genk,Germinal,2,0,2,W
131733,0,BEL1,2001-05-12,Lierse,Club Brugge,0,2,-2,L
131734,0,BEL1,2001-05-12,Lokeren,Harelbeke,3,0,3,W
131735,0,BEL1,2001-05-12,Mouscron,Standard,1,1,0,D
131736,0,BEL1,2001-05-19,Louvieroise,Mouscron,1,3,-2,L
131737,0,BEL1,2001-05-20,Aalst,Anderlecht,1,5,-4,L
131738,0,BEL1,2001-05-20,Club Brugge,Genk,6,0,6,W
131739,0,BEL1,2001-05-20,Germinal,Gent,1,3,-2,L
131740,0,BEL1,2001-05-20,Harelbeke,Beveren,3,2,1,W
131741,0,BEL1,2001-05-20,Mechelen,Lierse,1,1,0,D
131742,0,BEL1,2001-05-20,St Truiden,Antwerp,1,1,0,D
131743,0,BEL1,2001-05-20,Standard,Lokeren,1,3,-2,L
131744,0,BEL1,2001-05-20,Westerlo,Charleroi,0,1,-1,L
131745,1,BEL1,2001-08-11,Gent,St Truiden,4,2,2,W
131746,1,BEL1,2001-08-11,Anderlecht,Antwerp,3,0,3,W
131747,1,BEL1,2001-08-11,Genk,Beveren,5,1,4,W
131748,1,BEL1,2001-08-11,Lierse,Lokeren,1,1,0,D
131749,1,BEL1,2001-08-11,Lommel,Molenbeek,1,0,1,W
131750,1,BEL1,2001-08-12,Aalst,Mouscron,1,0,1,W
131751,1,BEL1,2001-08-12,Charleroi,Standard,0,0,0,D
131752,1,BEL1,2001-08-12,Club Brugge,Westerlo,4,2,2,W
131753,1,BEL1,2001-08-12,Germinal,Louvieroise,8,2,6,W
131754,1,BEL1,2001-08-17,Mouscron,Gent,0,1,-1,L
131755,1,BEL1,2001-08-18,Antwerp,Genk,3,0,3,W
131756,1,BEL1,2001-08-18,Beveren,Lierse,1,1,0,D
131757,1,BEL1,2001-08-18,Louvieroise,Anderlecht,1,3,-2,L
131758,1,BEL1,2001-08-18,Molenbeek,Charleroi,0,1,-1,L
131759,1,BEL1,2001-08-18,St Truiden,Lommel,4,3,1,W
131760,1,BEL1,2001-08-18,Standard,Germinal,3,0,3,W
131761,1,BEL1,2001-08-18,Westerlo,Aalst,0,1,-1,L
131762,1,BEL1,2001-08-19,Lokeren,Club Brugge,0,1,-1,L
131763,1,BEL1,2001-08-25,Gent,Westerlo,4,1,3,W
131764,1,BEL1,2001-08-25,Charleroi,St Truiden,0,3,-3,L
131765,1,BEL1,2001-08-25,Lierse,Antwerp,2,1,1,W
131766,1,BEL1,2001-08-25,Lommel,Mouscron,3,2,1,W
131767,1,BEL1,2001-08-26,Aalst,Lokeren,2,1,1,W
131768,1,BEL1,2001-08-26,Club Brugge,Beveren,6,1,5,W
131769,1,BEL1,2001-08-26,Germinal,Anderlecht,1,1,0,D
131770,1,BEL1,2001-08-26,Genk,Louvieroise,5,1,4,W
131771,1,BEL1,2001-08-26,Standard,Molenbeek,2,1,1,W
131772,1,BEL1,2001-09-07,Mouscron,Charleroi,0,1,-1,L
131773,1,BEL1,2001-09-08,Anderlecht,Genk,3,3,0,D
131774,1,BEL1,2001-09-08,Beveren,Aalst,0,4,-4,L
131775,1,BEL1,2001-09-08,Louvieroise,Lierse,0,0,0,D
131776,1,BEL1,2001-09-08,St Truiden,Standard,1,1,0,D
131777,1,BEL1,2001-09-08,Westerlo,Lommel,6,0,6,W
131778,1,BEL1,2001-09-09,Antwerp,Club Brugge,1,2,-1,L
131779,1,BEL1,2001-09-09,Lokeren,Gent,0,1,-1,L
131780,1,BEL1,2001-09-09,Molenbeek,Germinal,2,2,0,D
131781,1,BEL1,2001-09-15,Gent,Beveren,2,1,1,W
131782,1,BEL1,2001-09-15,Germinal,Genk,1,1,0,D
131783,1,BEL1,2001-09-15,Lierse,Anderlecht,2,0,2,W
131784,1,BEL1,2001-09-15,Lommel,Lokeren,3,4,-1,L
131785,1,BEL1,2001-09-15,Molenbeek,St Truiden,1,2,-1,L
131786,1,BEL1,2001-09-16,Aalst,Antwerp,0,0,0,D
131787,1,BEL1,2001-09-16,Charleroi,Westerlo,4,2,2,W
131788,1,BEL1,2001-09-16,Club Brugge,Louvieroise,2,1,1,W
131789,1,BEL1,2001-09-16,Standard,Mouscron,2,1,1,W
131790,1,BEL1,2001-09-22,Genk,Lierse,4,2,2,W
131791,1,BEL1,2001-09-22,Louvieroise,Aalst,1,3,-2,L
131792,1,BEL1,2001-09-22,Mouscron,Molenbeek,4,1,3,W
131793,1,BEL1,2001-09-22,St Truiden,Germinal,2,2,0,D
131794,1,BEL1,2001-09-23,Antwerp,Gent,2,3,-1,L
131795,1,BEL1,2001-09-23,Beveren,Lommel,0,2,-2,L
131796,1,BEL1,2001-09-29,Gent,Louvieroise,2,1,1,W
131797,1,BEL1,2001-09-29,Charleroi,Beveren,1,1,0,D
131798,1,BEL1,2001-09-29,Germinal,Lierse,2,0,2,W
131799,1,BEL1,2001-09-29,Lommel,Antwerp,2,2,0,D
131800,1,BEL1,2001-09-29,Molenbeek,Westerlo,0,1,-1,L
131801,1,BEL1,2001-09-29,St Truiden,Mouscron,1,2,-1,L
131802,1,BEL1,2001-09-30,Aalst,Anderlecht,1,5,-4,L
131803,1,BEL1,2001-09-30,Club Brugge,Genk,1,2,-1,L
131804,1,BEL1,2001-09-30,Standard,Lokeren,0,2,-2,L
131805,1,BEL1,2001-10-09,Louvieroise,Lommel,0,0,0,D
131806,1,BEL1,2001-10-10,Anderlecht,Gent,2,0,2,W
131807,1,BEL1,2001-10-10,Antwerp,Charleroi,2,0,2,W
131808,1,BEL1,2001-10-10,Beveren,Standard,1,1,0,D
131809,1,BEL1,2001-10-10,Genk,Aalst,5,0,5,W
131810,1,BEL1,2001-10-10,Lierse,Club Brugge,0,2,-2,L
131811,1,BEL1,2001-10-10,Lokeren,Molenbeek,4,0,4,W
131812,1,BEL1,2001-10-10,Mouscron,Germinal,3,1,2,W
131813,1,BEL1,2001-10-10,Westerlo,St Truiden,0,0,0,D
131814,1,BEL1,2001-10-13,Gent,Genk,0,0,0,D
131815,1,BEL1,2001-10-13,Charleroi,Louvieroise,2,1,1,W
131816,1,BEL1,2001-10-13,Lommel,Anderlecht,2,2,0,D
131817,1,BEL1,2001-10-13,Molenbeek,Beveren,3,0,3,W
131818,1,BEL1,2001-10-13,Mouscron,Westerlo,1,2,-1,L
131819,1,BEL1,2001-10-13,St Truiden,Lokeren,1,0,1,W
131820,1,BEL1,2001-10-13,Standard,Antwerp,4,2,2,W
131821,1,BEL1,2001-10-14,Aalst,Lierse,0,2,-2,L
131822,1,BEL1,2001-10-14,Germinal,Club Brugge,1,2,-1,L
131823,1,BEL1,2001-10-20,Anderlecht,Charleroi,2,1,1,W
131824,1,BEL1,2001-10-20,Antwerp,Molenbeek,1,2,-1,L
131825,1,BEL1,2001-10-20,Genk,Lommel,4,2,2,W
131826,1,BEL1,2001-10-20,Lokeren,Mouscron,2,1,1,W
131827,1,BEL1,2001-10-21,Beveren,St Truiden,3,2,1,W
131828,1,BEL1,2001-10-21,Club Brugge,Aalst,3,0,3,W
131829,1,BEL1,2001-10-21,Louvieroise,Standard,3,1,2,W
131830,1,BEL1,2001-10-21,Lierse,Gent,1,2,-1,L
131831,1,BEL1,2001-10-21,Westerlo,Germinal,1,2,-1,L
131832,1,BEL1,2001-10-27,Charleroi,Genk,0,3,-3,L
131833,1,BEL1,2001-10-27,Germinal,Aalst,4,0,4,W
131834,1,BEL1,2001-10-27,Molenbeek,Louvieroise,1,0,1,W
131835,1,BEL1,2001-10-27,St Truiden,Antwerp,3,1,2,W
131836,1,BEL1,2001-10-27,Standard,Anderlecht,1,0,1,W
131837,1,BEL1,2001-10-27,Westerlo,Lokeren,0,1,-1,L
131838,1,BEL1,2001-10-28,Gent,Club Brugge,2,2,0,D
131839,1,BEL1,2001-10-28,Lommel,Lierse,2,2,0,D
131840,1,BEL1,2001-10-28,Mouscron,Beveren,3,0,3,W
131841,1,BEL1,2001-10-31,Lokeren,Charleroi,1,0,1,W
131842,1,BEL1,2001-11-03,Anderlecht,Molenbeek,2,2,0,D
131843,1,BEL1,2001-11-03,Antwerp,Mouscron,2,1,1,W
131844,1,BEL1,2001-11-03,Beveren,Westerlo,1,1,0,D
131845,1,BEL1,2001-11-03,Lierse,Charleroi,1,2,-1,L
131846,1,BEL1,2001-11-03,Lokeren,Germinal,3,2,1,W
131847,1,BEL1,2001-11-04,Aalst,Gent,1,3,-2,L
131848,1,BEL1,2001-11-04,Club Brugge,Lommel,3,1,2,W
131849,1,BEL1,2001-11-04,Genk,Standard,1,1,0,D
131850,1,BEL1,2001-11-04,Louvieroise,St Truiden,1,0,1,W
131851,1,BEL1,2001-11-11,Germinal,Antwerp,2,0,2,W
131852,1,BEL1,2001-11-24,Germinal,Gent,3,2,1,W
131853,1,BEL1,2001-11-24,Lokeren,Beveren,1,0,1,W
131854,1,BEL1,2001-11-24,Lommel,Aalst,1,1,0,D
131855,1,BEL1,2001-11-24,Mouscron,Louvieroise,2,0,2,W
131856,1,BEL1,2001-11-24,St Truiden,Anderlecht,0,2,-2,L
131857,1,BEL1,2001-11-24,Standard,Lierse,2,1,1,W
131858,1,BEL1,2001-11-24,Westerlo,Antwerp,2,1,1,W
131859,1,BEL1,2001-11-25,Charleroi,Club Brugge,0,4,-4,L
131860,1,BEL1,2001-11-25,Molenbeek,Genk,2,5,-3,L
131861,1,BEL1,2001-11-28,Gent,Standard,2,5,-3,L
131862,1,BEL1,2001-11-28,Aalst,Molenbeek,2,4,-2,L
131863,1,BEL1,2001-11-28,Anderlecht,Lokeren,0,0,0,D
131864,1,BEL1,2001-11-28,Club Brugge,St Truiden,2,0,2,W
131865,1,BEL1,2001-11-28,Genk,Westerlo,2,0,2,W
131866,1,BEL1,2001-11-28,Louvieroise,Beveren,3,2,1,W
131867,1,BEL1,2001-11-28,Lierse,Mouscron,3,3,0,D
131868,1,BEL1,2001-11-28,Lommel,Charleroi,5,1,4,W
131869,1,BEL1,2001-12-01,Gent,Lommel,0,0,0,D
131870,1,BEL1,2001-12-01,Anderlecht,Mouscron,4,2,2,W
131871,1,BEL1,2001-12-01,Antwerp,Lokeren,1,1,0,D
131872,1,BEL1,2001-12-01,Beveren,Germinal,1,1,0,D
131873,1,BEL1,2001-12-01,Genk,St Truiden,2,2,0,D
131874,1,BEL1,2001-12-01,Louvieroise,Westerlo,3,3,0,D
131875,1,BEL1,2001-12-01,Lierse,Molenbeek,1,2,-1,L
131876,1,BEL1,2001-12-02,Aalst,Charleroi,1,1,0,D
131877,1,BEL1,2001-12-02,Club Brugge,Standard,1,3,-2,L
131878,1,BEL1,2001-12-08,Beveren,Antwerp,2,3,-1,L
131879,1,BEL1,2001-12-08,Charleroi,Gent,0,3,-3,L
131880,1,BEL1,2001-12-08,Germinal,Lommel,3,0,3,W
131881,1,BEL1,2001-12-08,Lokeren,Louvieroise,2,2,0,D
131882,1,BEL1,2001-12-08,Mouscron,Genk,2,4,-2,L
131883,1,BEL1,2001-12-08,St Truiden,Lierse,0,2,-2,L
131884,1,BEL1,2001-12-08,Standard,Aalst,2,0,2,W
131885,1,BEL1,2001-12-08,Westerlo,Anderlecht,1,2,-1,L
131886,1,BEL1,2001-12-09,Molenbeek,Club Brugge,2,3,-1,L
131887,1,BEL1,2001-12-18,Beveren,Anderlecht,1,4,-3,L
131888,1,BEL1,2001-12-18,Mouscron,Club Brugge,2,0,2,W
131889,1,BEL1,2001-12-19,Antwerp,Louvieroise,0,0,0,D
131890,1,BEL1,2001-12-19,Charleroi,Germinal,1,0,1,W
131891,1,BEL1,2001-12-19,Lokeren,Genk,2,2,0,D
131892,1,BEL1,2001-12-19,Molenbeek,Gent,0,1,-1,L
131893,1,BEL1,2001-12-19,St Truiden,Aalst,3,1,2,W
131894,1,BEL1,2001-12-19,Standard,Lommel,2,1,1,W
131895,1,BEL1,2001-12-19,Westerlo,Lierse,5,4,1,W
131896,1,BEL1,2001-12-21,Anderlecht,Club Brugge,1,0,1,W
131897,1,BEL1,2001-12-22,Westerlo,Standard,1,2,-1,L
131898,1,BEL1,2002-01-11,Louvieroise,Germinal,1,1,0,D
131899,1,BEL1,2002-01-12,Beveren,Genk,1,6,-5,L
131900,1,BEL1,2002-01-12,Lokeren,Lierse,2,1,1,W
131901,1,BEL1,2002-01-12,Molenbeek,Lommel,0,1,-1,L
131902,1,BEL1,2002-01-12,Mouscron,Aalst,6,1,5,W
131903,1,BEL1,2002-01-12,St Truiden,Gent,0,1,-1,L
131904,1,BEL1,2002-01-12,Westerlo,Club Brugge,1,4,-3,L
131905,1,BEL1,2002-01-13,Antwerp,Anderlecht,2,2,0,D
131906,1,BEL1,2002-01-13,Standard,Charleroi,6,0,6,W
131907,1,BEL1,2002-01-19,Gent,Mouscron,1,1,0,D
131908,1,BEL1,2002-01-19,Anderlecht,Louvieroise,5,2,3,W
131909,1,BEL1,2002-01-19,Charleroi,Molenbeek,3,1,2,W
131910,1,BEL1,2002-01-19,Genk,Antwerp,2,1,1,W
131911,1,BEL1,2002-01-19,Lommel,St Truiden,0,1,-1,L
131912,1,BEL1,2002-01-20,Aalst,Westerlo,0,1,-1,L
131913,1,BEL1,2002-01-20,Club Brugge,Lokeren,2,4,-2,L
131914,1,BEL1,2002-01-20,Lierse,Beveren,3,3,0,D
131915,1,BEL1,2002-01-25,Anderlecht,Germinal,1,0,1,W
131916,1,BEL1,2002-01-26,Antwerp,Lierse,1,4,-3,L
131917,1,BEL1,2002-01-26,Beveren,Club Brugge,0,4,-4,L
131918,1,BEL1,2002-01-26,Louvieroise,Genk,0,0,0,D
131919,1,BEL1,2002-01-26,Lokeren,Aalst,1,0,1,W
131920,1,BEL1,2002-01-26,St Truiden,Charleroi,2,1,1,W
131921,1,BEL1,2002-01-26,Westerlo,Gent,3,1,2,W
131922,1,BEL1,2002-01-27,Molenbeek,Standard,2,1,1,W
131923,1,BEL1,2002-01-27,Mouscron,Lommel,1,0,1,W
131924,1,BEL1,2002-02-02,Gent,Lokeren,1,1,0,D
131925,1,BEL1,2002-02-02,Charleroi,Mouscron,0,2,-2,L
131926,1,BEL1,2002-02-02,Germinal,Molenbeek,2,2,0,D
131927,1,BEL1,2002-02-02,Lommel,Westerlo,3,0,3,W
131928,1,BEL1,2002-02-02,Standard,St Truiden,1,3,-2,L
131929,1,BEL1,2002-02-03,Aalst,Beveren,0,1,-1,L
131930,1,BEL1,2002-02-03,Club Brugge,Antwerp,4,1,3,W
131931,1,BEL1,2002-02-03,Lierse,Louvieroise,0,1,-1,L
131932,1,BEL1,2002-02-09,Anderlecht,Lierse,7,1,6,W
131933,1,BEL1,2002-02-09,Antwerp,Aalst,2,0,2,W
131934,1,BEL1,2002-02-09,Beveren,Gent,2,2,0,D
131935,1,BEL1,2002-02-09,Genk,Germinal,4,4,0,D
131936,1,BEL1,2002-02-09,Louvieroise,Club Brugge,1,2,-1,L
131937,1,BEL1,2002-02-09,Lokeren,Lommel,1,0,1,W
131938,1,BEL1,2002-02-10,Mouscron,Standard,2,0,2,W
131939,1,BEL1,2002-02-10,St Truiden,Molenbeek,1,2,-1,L
131940,1,BEL1,2002-02-10,Westerlo,Charleroi,3,3,0,D
131941,1,BEL1,2002-02-16,Charleroi,Lokeren,1,0,1,W
131942,1,BEL1,2002-02-16,Germinal,St Truiden,1,0,1,W
131943,1,BEL1,2002-02-16,Lierse,Genk,1,2,-1,L
131944,1,BEL1,2002-02-16,Lommel,Beveren,3,1,2,W
131945,1,BEL1,2002-02-16,Molenbeek,Mouscron,1,1,0,D
131946,1,BEL1,2002-02-17,Gent,Antwerp,3,3,0,D
131947,1,BEL1,2002-02-17,Aalst,Louvieroise,0,0,0,D
131948,1,BEL1,2002-02-17,Club Brugge,Anderlecht,1,0,1,W
131949,1,BEL1,2002-02-17,Standard,Westerlo,2,2,0,D
131950,1,BEL1,2002-02-22,Louvieroise,Gent,3,1,2,W
131951,1,BEL1,2002-02-23,Anderlecht,Aalst,3,1,2,W
131952,1,BEL1,2002-02-23,Antwerp,Lommel,3,3,0,D
131953,1,BEL1,2002-02-23,Beveren,Charleroi,1,1,0,D
131954,1,BEL1,2002-02-23,Lierse,Germinal,1,1,0,D
131955,1,BEL1,2002-02-23,Lokeren,Standard,1,1,0,D
131956,1,BEL1,2002-02-23,Mouscron,St Truiden,3,0,3,W
131957,1,BEL1,2002-02-24,Genk,Club Brugge,3,2,1,W
131958,1,BEL1,2002-02-24,Westerlo,Molenbeek,4,0,4,W
131959,1,BEL1,2002-03-02,Charleroi,Antwerp,5,0,5,W
131960,1,BEL1,2002-03-02,Germinal,Mouscron,2,2,0,D
131961,1,BEL1,2002-03-02,Lommel,Louvieroise,3,0,3,W
131962,1,BEL1,2002-03-02,Molenbeek,Lokeren,1,0,1,W
131963,1,BEL1,2002-03-02,St Truiden,Westerlo,2,0,2,W
131964,1,BEL1,2002-03-02,Standard,Beveren,4,1,3,W
131965,1,BEL1,2002-03-03,Gent,Anderlecht,2,2,0,D
131966,1,BEL1,2002-03-03,Aalst,Genk,0,0,0,D
131967,1,BEL1,2002-03-03,Club Brugge,Lierse,3,1,2,W
131968,1,BEL1,2002-03-08,Genk,Gent,2,1,1,W
131969,1,BEL1,2002-03-08,Louvieroise,Charleroi,2,1,1,W
131970,1,BEL1,2002-03-09,Anderlecht,Lommel,2,0,2,W
131971,1,BEL1,2002-03-09,Beveren,Molenbeek,1,3,-2,L
131972,1,BEL1,2002-03-09,Lierse,Aalst,3,1,2,W
131973,1,BEL1,2002-03-09,Lokeren,St Truiden,0,1,-1,L
131974,1,BEL1,2002-03-09,Westerlo,Mouscron,0,2,-2,L
131975,1,BEL1,2002-03-10,Antwerp,Standard,0,0,0,D
131976,1,BEL1,2002-03-10,Club Brugge,Germinal,3,2,1,W
131977,1,BEL1,2002-03-13,Genk,Anderlecht,1,1,0,D
131978,1,BEL1,2002-03-16,Gent,Lierse,2,3,-1,L
131979,1,BEL1,2002-03-16,Charleroi,Anderlecht,1,1,0,D
131980,1,BEL1,2002-03-16,Germinal,Westerlo,1,1,0,D
131981,1,BEL1,2002-03-16,Lommel,Genk,1,5,-4,L
131982,1,BEL1,2002-03-16,Mouscron,Lokeren,4,0,4,W
131983,1,BEL1,2002-03-16,Standard,Louvieroise,1,2,-1,L
131984,1,BEL1,2002-03-17,Aalst,Club Brugge,1,1,0,D
131985,1,BEL1,2002-03-17,Molenbeek,Antwerp,2,0,2,W
131986,1,BEL1,2002-03-17,St Truiden,Beveren,4,2,2,W
131987,1,BEL1,2002-03-22,Anderlecht,Standard,0,0,0,D
131988,1,BEL1,2002-03-23,Antwerp,St Truiden,4,1,3,W
131989,1,BEL1,2002-03-23,Beveren,Mouscron,0,1,-1,L
131990,1,BEL1,2002-03-23,Genk,Charleroi,3,2,1,W
131991,1,BEL1,2002-03-23,Lierse,Lommel,6,3,3,W
131992,1,BEL1,2002-03-23,Lokeren,Westerlo,2,0,2,W
131993,1,BEL1,2002-03-24,Aalst,Germinal,3,3,0,D
131994,1,BEL1,2002-03-24,Club Brugge,Gent,0,1,-1,L
131995,1,BEL1,2002-03-24,Louvieroise,Molenbeek,1,0,1,W
131996,1,BEL1,2002-03-30,Gent,Aalst,2,2,0,D
131997,1,BEL1,2002-03-30,Charleroi,Lierse,3,1,2,W
131998,1,BEL1,2002-03-30,Germinal,Lokeren,0,0,0,D
131999,1,BEL1,2002-03-30,Lommel,Club Brugge,0,2,-2,L
132000,1,BEL1,2002-03-30,Mouscron,Antwerp,5,1,4,W
132001,1,BEL1,2002-03-30,St Truiden,Louvieroise,1,0,1,W
132002,1,BEL1,2002-03-30,Standard,Genk,2,0,2,W
132003,1,BEL1,2002-03-30,Westerlo,Beveren,1,0,1,W
132004,1,BEL1,2002-04-01,Molenbeek,Anderlecht,2,3,-1,L
132005,1,BEL1,2002-04-05,Club Brugge,Charleroi,1,0,1,W
132006,1,BEL1,2002-04-06,Gent,Germinal,1,1,0,D
132007,1,BEL1,2002-04-06,Anderlecht,St Truiden,0,2,-2,L
132008,1,BEL1,2002-04-06,Antwerp,Westerlo,1,1,0,D
132009,1,BEL1,2002-04-06,Beveren,Lokeren,0,2,-2,L
132010,1,BEL1,2002-04-06,Genk,Molenbeek,2,0,2,W
132011,1,BEL1,2002-04-06,Louvieroise,Mouscron,1,0,1,W
132012,1,BEL1,2002-04-06,Lierse,Standard,1,1,0,D
132013,1,BEL1,2002-04-07,Aalst,Lommel,0,1,-1,L
132014,1,BEL1,2002-04-12,Standard,Club Brugge,1,1,0,D
132015,1,BEL1,2002-04-13,Charleroi,Aalst,2,1,1,W
132016,1,BEL1,2002-04-13,Germinal,Beveren,4,1,3,W
132017,1,BEL1,2002-04-13,Lommel,Gent,2,4,-2,L
132018,1,BEL1,2002-04-13,Molenbeek,Lierse,1,0,1,W
132019,1,BEL1,2002-04-13,St Truiden,Genk,0,1,-1,L
132020,1,BEL1,2002-04-13,Westerlo,Louvieroise,0,1,-1,L
132021,1,BEL1,2002-04-14,Lokeren,Antwerp,0,0,0,D
132022,1,BEL1,2002-04-14,Mouscron,Anderlecht,1,1,0,D
132023,1,BEL1,2002-04-16,Germinal,Standard,2,2,0,D
132024,1,BEL1,2002-04-20,Gent,Charleroi,3,0,3,W
132025,1,BEL1,2002-04-20,Anderlecht,Westerlo,3,3,0,D
132026,1,BEL1,2002-04-20,Antwerp,Beveren,4,0,4,W
132027,1,BEL1,2002-04-20,Louvieroise,Lokeren,0,1,-1,L
132028,1,BEL1,2002-04-20,Lierse,St Truiden,0,2,-2,L
132029,1,BEL1,2002-04-20,Lommel,Germinal,2,2,0,D
132030,1,BEL1,2002-04-21,Aalst,Standard,1,2,-1,L
132031,1,BEL1,2002-04-21,Club Brugge,Molenbeek,1,1,0,D
132032,1,BEL1,2002-04-21,Genk,Mouscron,3,1,2,W
132033,1,BEL1,2002-04-27,Charleroi,Lommel,1,3,-2,L
132034,1,BEL1,2002-04-28,Antwerp,Germinal,2,3,-1,L
132035,1,BEL1,2002-04-28,Beveren,Louvieroise,0,3,-3,L
132036,1,BEL1,2002-04-28,Lokeren,Anderlecht,0,1,-1,L
132037,1,BEL1,2002-04-28,Molenbeek,Aalst,4,3,1,W
132038,1,BEL1,2002-04-28,Mouscron,Lierse,2,0,2,W
132039,1,BEL1,2002-04-28,St Truiden,Club Brugge,5,3,2,W
132040,1,BEL1,2002-04-28,Standard,Gent,0,1,-1,L
132041,1,BEL1,2002-04-28,Westerlo,Genk,0,0,0,D
132042,1,BEL1,2002-05-04,Germinal,Charleroi,4,1,3,W
132043,1,BEL1,2002-05-04,Louvieroise,Antwerp,3,0,3,W
132044,1,BEL1,2002-05-05,Gent,Molenbeek,3,5,-2,L
132045,1,BEL1,2002-05-05,Aalst,St Truiden,1,1,0,D
132046,1,BEL1,2002-05-05,Anderlecht,Beveren,3,0,3,W
132047,1,BEL1,2002-05-05,Club Brugge,Mouscron,2,0,2,W
132048,1,BEL1,2002-05-05,Genk,Lokeren,3,3,0,D
132049,1,BEL1,2002-05-05,Lierse,Westerlo,4,1,3,W
132050,1,BEL1,2002-05-05,Lommel,Standard,1,1,0,D
132051,2,BEL1,2002-08-09,Genk,Lokeren,2,3,-1,L
132052,2,BEL1,2002-08-09,Standard,Mouscron,0,3,-3,L
132053,2,BEL1,2002-08-10,Beveren,Bergen,3,0,3,W
132054,2,BEL1,2002-08-10,Gent,Antwerp,0,0,0,D
132055,2,BEL1,2002-08-10,Germinal,St Truiden,3,2,1,W
132056,2,BEL1,2002-08-10,Mechelen,Charleroi,1,0,1,W
132057,2,BEL1,2002-08-10,Westerlo,Anderlecht,0,2,-2,L
132058,2,BEL1,2002-08-11,Louvieroise,Club Brugge,1,2,-1,L
132059,2,BEL1,2002-08-17,Anderlecht,Mechelen,4,1,3,W
132060,2,BEL1,2002-08-17,Antwerp,Genk,2,4,-2,L
132061,2,BEL1,2002-08-17,Bergen,Westerlo,2,1,1,W
132062,2,BEL1,2002-08-17,Club Brugge,Beveren,3,0,3,W
132063,2,BEL1,2002-08-17,Lierse,Louvieroise,1,1,0,D
132064,2,BEL1,2002-08-17,Lokeren,Germinal,3,1,2,W
132065,2,BEL1,2002-08-18,Charleroi,Standard,3,3,0,D
132066,2,BEL1,2002-08-18,Mouscron,Gent,2,1,1,W
132067,2,BEL1,2002-08-24,Antwerp,Mouscron,3,1,2,W
132068,2,BEL1,2002-08-24,Gent,Charleroi,2,1,1,W
132069,2,BEL1,2002-08-24,Lierse,Beveren,5,0,5,W
132070,2,BEL1,2002-08-24,Mechelen,Bergen,0,0,0,D
132071,2,BEL1,2002-08-24,Standard,Anderlecht,0,2,-2,L
132072,2,BEL1,2002-08-24,Westerlo,Club Brugge,0,2,-2,L
132073,2,BEL1,2002-08-25,Louvieroise,St Truiden,1,2,-1,L
132074,2,BEL1,2002-08-31,Anderlecht,Gent,2,2,0,D
132075,2,BEL1,2002-08-31,Bergen,Standard,1,0,1,W
132076,2,BEL1,2002-08-31,Charleroi,Antwerp,1,1,0,D
132077,2,BEL1,2002-08-31,Club Brugge,Mechelen,4,0,4,W
132078,2,BEL1,2002-08-31,Lierse,Westerlo,0,1,-1,L
132079,2,BEL1,2002-08-31,Lokeren,Louvieroise,1,1,0,D
132080,2,BEL1,2002-08-31,St Truiden,Beveren,6,1,5,W
132081,2,BEL1,2002-09-01,Mouscron,Genk,3,3,0,D
132082,2,BEL1,2002-09-11,Genk,Germinal,5,2,3,W
132083,2,BEL1,2002-09-13,Standard,Club Brugge,1,2,-1,L
132084,2,BEL1,2002-09-14,Beveren,Lokeren,0,1,-1,L
132085,2,BEL1,2002-09-14,Gent,Bergen,2,1,1,W
132086,2,BEL1,2002-09-14,Mechelen,Lierse,0,2,-2,L
132087,2,BEL1,2002-09-14,Mouscron,Charleroi,6,0,6,W
132088,2,BEL1,2002-09-14,Westerlo,St Truiden,0,3,-3,L
132089,2,BEL1,2002-09-15,Antwerp,Anderlecht,2,1,1,W
132090,2,BEL1,2002-09-15,Louvieroise,Germinal,1,1,0,D
132091,2,BEL1,2002-09-21,Bergen,Antwerp,3,0,3,W
132092,2,BEL1,2002-09-21,Charleroi,Genk,0,0,0,D
132093,2,BEL1,2002-09-21,Club Brugge,Gent,1,0,1,W
132094,2,BEL1,2002-09-21,Germinal,Beveren,2,1,1,W
132095,2,BEL1,2002-09-21,Lierse,Standard,2,0,2,W
132096,2,BEL1,2002-09-21,St Truiden,Mechelen,5,1,4,W
132097,2,BEL1,2002-09-22,Lokeren,Westerlo,4,0,4,W
132098,2,BEL1,2002-09-23,Anderlecht,Mouscron,6,3,3,W
132099,2,BEL1,2002-09-27,Charleroi,Anderlecht,1,3,-2,L
132100,2,BEL1,2002-09-28,Antwerp,Club Brugge,2,2,0,D
132101,2,BEL1,2002-09-28,Genk,Louvieroise,1,0,1,W
132102,2,BEL1,2002-09-28,Gent,Lierse,1,3,-2,L
132103,2,BEL1,2002-09-28,Mouscron,Bergen,3,2,1,W
132104,2,BEL1,2002-09-28,Standard,St Truiden,2,2,0,D
132105,2,BEL1,2002-09-28,Westerlo,Germinal,2,1,1,W
132106,2,BEL1,2002-09-29,Mechelen,Lokeren,2,3,-1,L
132107,2,BEL1,2002-10-04,Louvieroise,Beveren,2,1,1,W
132108,2,BEL1,2002-10-05,Bergen,Charleroi,4,1,3,W
132109,2,BEL1,2002-10-05,Germinal,Mechelen,2,2,0,D
132110,2,BEL1,2002-10-05,Lierse,Antwerp,3,1,2,W
132111,2,BEL1,2002-10-05,Lokeren,Standard,3,3,0,D
132112,2,BEL1,2002-10-05,St Truiden,Gent,6,4,2,W
132113,2,BEL1,2002-10-06,Anderlecht,Genk,1,1,0,D
132114,2,BEL1,2002-10-06,Club Brugge,Mouscron,5,0,5,W
132115,2,BEL1,2002-10-19,Anderlecht,Bergen,2,1,1,W
132116,2,BEL1,2002-10-19,Antwerp,St Truiden,1,3,-2,L
132117,2,BEL1,2002-10-19,Charleroi,Club Brugge,2,3,-1,L
132118,2,BEL1,2002-10-19,Genk,Beveren,4,0,4,W
132119,2,BEL1,2002-10-19,Gent,Lokeren,2,3,-1,L
132120,2,BEL1,2002-10-19,Standard,Germinal,2,1,1,W
132121,2,BEL1,2002-10-20,Mouscron,Lierse,1,1,0,D
132122,2,BEL1,2002-10-20,Westerlo,Louvieroise,0,3,-3,L
132123,2,BEL1,2002-10-26,Bergen,Genk,1,2,-1,L
132124,2,BEL1,2002-10-26,Beveren,Westerlo,2,1,1,W
132125,2,BEL1,2002-10-26,Germinal,Gent,2,1,1,W
132126,2,BEL1,2002-10-26,Lierse,Charleroi,2,1,1,W
132127,2,BEL1,2002-10-28,Lokeren,Antwerp,2,1,1,W
132128,2,BEL1,2002-10-28,Louvieroise,Mechelen,1,1,0,D
132129,2,BEL1,2002-11-02,Bergen,Club Brugge,1,2,-1,L
132130,2,BEL1,2002-11-02,Charleroi,St Truiden,2,2,0,D
132131,2,BEL1,2002-11-02,Mouscron,Lokeren,1,1,0,D
132132,2,BEL1,2002-11-02,Standard,Louvieroise,1,0,1,W
132133,2,BEL1,2002-11-03,Antwerp,Germinal,5,3,2,W
132134,2,BEL1,2002-11-03,Genk,Westerlo,1,1,0,D
132135,2,BEL1,2002-11-03,Mechelen,Beveren,0,2,-2,L
132136,2,BEL1,2002-11-04,Anderlecht,Lierse,1,2,-1,L
132137,2,BEL1,2002-11-08,St Truiden,Anderlecht,3,1,2,W
132138,2,BEL1,2002-11-09,Club Brugge,Genk,4,0,4,W
132139,2,BEL1,2002-11-09,Germinal,Mouscron,0,2,-2,L
132140,2,BEL1,2002-11-09,Lokeren,Charleroi,4,1,3,W
132141,2,BEL1,2002-11-09,Louvieroise,Gent,0,1,-1,L
132142,2,BEL1,2002-11-09,Westerlo,Mechelen,2,0,2,W
132143,2,BEL1,2002-11-10,Beveren,Standard,1,3,-2,L
132144,2,BEL1,2002-11-10,Lierse,Bergen,1,1,0,D
132145,2,BEL1,2002-11-20,St Truiden,Mouscron,2,2,0,D
132146,2,BEL1,2002-11-22,Anderlecht,Lokeren,2,0,2,W
132147,2,BEL1,2002-11-23,Antwerp,Louvieroise,2,1,1,W
132148,2,BEL1,2002-11-23,Bergen,St Truiden,3,0,3,W
132149,2,BEL1,2002-11-23,Charleroi,Germinal,1,6,-5,L
132150,2,BEL1,2002-11-23,Club Brugge,Lierse,3,0,3,W
132151,2,BEL1,2002-11-23,Genk,Mechelen,9,0,9,W
132152,2,BEL1,2002-11-23,Standard,Westerlo,3,0,3,W
132153,2,BEL1,2002-11-24,Gent,Beveren,2,1,1,W
132154,2,BEL1,2002-11-30,Beveren,Antwerp,3,1,2,W
132155,2,BEL1,2002-11-30,Lokeren,Bergen,4,0,4,W
132156,2,BEL1,2002-11-30,Louvieroise,Mouscron,2,0,2,W
132157,2,BEL1,2002-11-30,Mechelen,Standard,1,1,0,D
132158,2,BEL1,2002-11-30,Westerlo,Gent,1,0,1,W
132159,2,BEL1,2002-12-01,Germinal,Anderlecht,1,2,-1,L
132160,2,BEL1,2002-12-01,Lierse,Genk,1,1,0,D
132161,2,BEL1,2002-12-01,St Truiden,Club Brugge,5,2,3,W
132162,2,BEL1,2002-12-04,Club Brugge,Lokeren,5,0,5,W
132163,2,BEL1,2002-12-07,Antwerp,Westerlo,1,2,-1,L
132164,2,BEL1,2002-12-07,Charleroi,Louvieroise,1,1,0,D
132165,2,BEL1,2002-12-07,Club Brugge,Anderlecht,2,1,1,W
132166,2,BEL1,2002-12-07,Mouscron,Beveren,0,0,0,D
132167,2,BEL1,2002-12-08,Bergen,Germinal,2,1,1,W
132168,2,BEL1,2002-12-08,Genk,Standard,1,5,-4,L
132169,2,BEL1,2002-12-08,Gent,Mechelen,2,0,2,W
132170,2,BEL1,2002-12-08,Lierse,St Truiden,0,2,-2,L
132171,2,BEL1,2002-12-13,St Truiden,Genk,0,1,-1,L
132172,2,BEL1,2002-12-14,Lokeren,Lierse,1,1,0,D
132173,2,BEL1,2002-12-14,Mechelen,Antwerp,0,2,-2,L
132174,2,BEL1,2002-12-15,Beveren,Charleroi,3,0,3,W
132175,2,BEL1,2002-12-15,Germinal,Club Brugge,1,3,-2,L
132176,2,BEL1,2002-12-15,Louvieroise,Anderlecht,1,2,-1,L
132177,2,BEL1,2002-12-15,Standard,Gent,4,1,3,W
132178,2,BEL1,2002-12-15,Westerlo,Mouscron,1,2,-1,L
132179,2,BEL1,2002-12-21,Anderlecht,Beveren,7,1,6,W
132180,2,BEL1,2002-12-21,Bergen,Louvieroise,1,3,-2,L
132181,2,BEL1,2002-12-21,Charleroi,Westerlo,1,0,1,W
132182,2,BEL1,2002-12-21,Gent,Genk,2,0,2,W
132183,2,BEL1,2002-12-21,Lierse,Germinal,2,1,1,W
132184,2,BEL1,2002-12-21,Mouscron,Mechelen,3,1,2,W
132185,2,BEL1,2002-12-21,St Truiden,Lokeren,2,0,2,W
132186,2,BEL1,2002-12-22,Antwerp,Standard,1,1,0,D
132187,2,BEL1,2003-01-17,Mouscron,Standard,0,1,-1,L
132188,2,BEL1,2003-01-18,Antwerp,Gent,1,4,-3,L
132189,2,BEL1,2003-01-18,Club Brugge,Louvieroise,3,0,3,W
132190,2,BEL1,2003-01-18,St Truiden,Germinal,1,1,0,D
132191,2,BEL1,2003-01-19,Anderlecht,Westerlo,0,2,-2,L
132192,2,BEL1,2003-01-19,Bergen,Beveren,4,1,3,W
132193,2,BEL1,2003-01-19,Charleroi,Mechelen,3,0,3,W
132194,2,BEL1,2003-01-19,Lokeren,Genk,4,1,3,W
132195,2,BEL1,2003-01-25,Beveren,Club Brugge,2,7,-5,L
132196,2,BEL1,2003-01-25,Gent,Mouscron,2,0,2,W
132197,2,BEL1,2003-01-25,Louvieroise,Lierse,0,3,-3,L
132198,2,BEL1,2003-01-25,Mechelen,Anderlecht,0,2,-2,L
132199,2,BEL1,2003-01-25,Westerlo,Bergen,2,0,2,W
132200,2,BEL1,2003-01-26,Genk,Antwerp,2,0,2,W
132201,2,BEL1,2003-01-26,Germinal,Lokeren,0,1,-1,L
132202,2,BEL1,2003-01-26,Standard,Charleroi,3,0,3,W
132203,2,BEL1,2003-02-07,Genk,Mouscron,5,4,1,W
132204,2,BEL1,2003-02-08,Antwerp,Charleroi,3,1,2,W
132205,2,BEL1,2003-02-08,Louvieroise,Lokeren,2,4,-2,L
132206,2,BEL1,2003-02-08,Mechelen,Club Brugge,0,8,-8,L
132207,2,BEL1,2003-02-08,Westerlo,Lierse,1,2,-1,L
132208,2,BEL1,2003-02-09,Beveren,St Truiden,2,1,1,W
132209,2,BEL1,2003-02-09,Gent,Anderlecht,0,2,-2,L
132210,2,BEL1,2003-02-09,Standard,Bergen,0,0,0,D
132211,2,BEL1,2003-02-15,Bergen,Gent,0,1,-1,L
132212,2,BEL1,2003-02-15,Club Brugge,Standard,4,2,2,W
132213,2,BEL1,2003-02-15,Germinal,Louvieroise,2,0,2,W
132214,2,BEL1,2003-02-15,Lierse,Mechelen,3,0,3,W
132215,2,BEL1,2003-02-15,Lokeren,Beveren,1,2,-1,L
132216,2,BEL1,2003-02-15,St Truiden,Westerlo,1,0,1,W
132217,2,BEL1,2003-02-16,Anderlecht,Antwerp,4,1,3,W
132218,2,BEL1,2003-02-16,Charleroi,Mouscron,5,0,5,W
132219,2,BEL1,2003-02-22,Antwerp,Bergen,0,1,-1,L
132220,2,BEL1,2003-02-22,Beveren,Germinal,3,1,2,W
132221,2,BEL1,2003-02-22,Genk,Charleroi,3,0,3,W
132222,2,BEL1,2003-02-22,Mechelen,St Truiden,0,0,0,D
132223,2,BEL1,2003-02-22,Standard,Lierse,1,1,0,D
132224,2,BEL1,2003-02-22,Westerlo,Lokeren,1,3,-2,L
132225,2,BEL1,2003-02-23,Gent,Club Brugge,1,4,-3,L
132226,2,BEL1,2003-02-23,Mouscron,Anderlecht,1,0,1,W
132227,2,BEL1,2003-02-28,Louvieroise,Genk,2,2,0,D
132228,2,BEL1,2003-02-28,St Truiden,Standard,0,1,-1,L
132229,2,BEL1,2003-03-01,Bergen,Mouscron,2,0,2,W
132230,2,BEL1,2003-03-01,Germinal,Westerlo,1,1,0,D
132231,2,BEL1,2003-03-01,Lierse,Gent,2,1,1,W
132232,2,BEL1,2003-03-02,Anderlecht,Charleroi,2,0,2,W
132233,2,BEL1,2003-03-02,Club Brugge,Antwerp,1,0,1,W
132234,2,BEL1,2003-03-02,Lokeren,Mechelen,5,0,5,W
132235,2,BEL1,2003-03-07,Standard,Lokeren,1,2,-1,L
132236,2,BEL1,2003-03-08,Antwerp,Lierse,2,2,0,D
132237,2,BEL1,2003-03-08,Charleroi,Bergen,2,1,1,W
132238,2,BEL1,2003-03-08,Gent,St Truiden,3,0,3,W
132239,2,BEL1,2003-03-08,Mechelen,Germinal,2,0,2,W
132240,2,BEL1,2003-03-08,Mouscron,Club Brugge,0,4,-4,L
132241,2,BEL1,2003-03-09,Beveren,Louvieroise,0,3,-3,L
132242,2,BEL1,2003-03-09,Genk,Anderlecht,0,1,-1,L
132243,2,BEL1,2003-03-15,Beveren,Genk,1,4,-3,L
132244,2,BEL1,2003-03-15,Club Brugge,Charleroi,1,2,-1,L
132245,2,BEL1,2003-03-15,Lokeren,Gent,5,1,4,W
132246,2,BEL1,2003-03-15,St Truiden,Antwerp,1,0,1,W
132247,2,BEL1,2003-03-16,Bergen,Anderlecht,1,2,-1,L
132248,2,BEL1,2003-03-16,Germinal,Standard,0,1,-1,L
132249,2,BEL1,2003-03-16,Lierse,Mouscron,1,0,1,W
132250,2,BEL1,2003-03-16,Louvieroise,Westerlo,0,0,0,D
132251,2,BEL1,2003-03-22,Antwerp,Lokeren,1,2,-1,L
132252,2,BEL1,2003-03-22,Charleroi,Lierse,0,1,-1,L
132253,2,BEL1,2003-03-22,Genk,Bergen,2,0,2,W
132254,2,BEL1,2003-03-22,Gent,Germinal,1,0,1,W
132255,2,BEL1,2003-03-22,Mouscron,St Truiden,1,2,-1,L
132256,2,BEL1,2003-03-23,Anderlecht,Club Brugge,5,1,4,W
132257,2,BEL1,2003-03-23,Mechelen,Louvieroise,0,1,-1,L
132258,2,BEL1,2003-03-23,Westerlo,Beveren,2,0,2,W
132259,2,BEL1,2003-04-05,Beveren,Mechelen,6,0,6,W
132260,2,BEL1,2003-04-05,Club Brugge,Bergen,4,2,2,W
132261,2,BEL1,2003-04-05,Lokeren,Mouscron,3,2,1,W
132262,2,BEL1,2003-04-05,Louvieroise,Standard,0,2,-2,L
132263,2,BEL1,2003-04-05,Westerlo,Genk,3,1,2,W
132264,2,BEL1,2003-04-06,Germinal,Antwerp,1,1,0,D
132265,2,BEL1,2003-04-06,Lierse,Anderlecht,0,1,-1,L
132266,2,BEL1,2003-04-06,St Truiden,Charleroi,2,1,1,W
132267,2,BEL1,2003-04-11,Club Brugge,Westerlo,3,0,3,W
132268,2,BEL1,2003-04-11,Germinal,Genk,2,1,1,W
132269,2,BEL1,2003-04-11,St Truiden,Louvieroise,2,1,1,W
132270,2,BEL1,2003-04-12,Beveren,Lierse,7,1,6,W
132271,2,BEL1,2003-04-13,Anderlecht,Standard,2,1,1,W
132272,2,BEL1,2003-04-13,Bergen,Mechelen,2,0,2,W
132273,2,BEL1,2003-04-13,Charleroi,Gent,1,2,-1,L
132274,2,BEL1,2003-04-13,Mouscron,Antwerp,1,0,1,W
132275,2,BEL1,2003-04-18,Genk,Club Brugge,0,3,-3,L
132276,2,BEL1,2003-04-19,Anderlecht,St Truiden,2,0,2,W
132277,2,BEL1,2003-04-19,Bergen,Lierse,2,1,1,W
132278,2,BEL1,2003-04-19,Gent,Louvieroise,3,2,1,W
132279,2,BEL1,2003-04-19,Mechelen,Westerlo,0,4,-4,L
132280,2,BEL1,2003-04-20,Mouscron,Germinal,1,6,-5,L
132281,2,BEL1,2003-04-20,Standard,Beveren,2,0,2,W
132282,2,BEL1,2003-04-21,Charleroi,Lokeren,4,3,1,W
132283,2,BEL1,2003-04-25,Lierse,Club Brugge,1,1,0,D
132284,2,BEL1,2003-04-26,Germinal,Charleroi,1,1,0,D
132285,2,BEL1,2003-04-26,Louvieroise,Antwerp,1,1,0,D
132286,2,BEL1,2003-04-26,Mechelen,Genk,2,6,-4,L
132287,2,BEL1,2003-04-26,Westerlo,Standard,2,3,-1,L
132288,2,BEL1,2003-04-27,Beveren,Gent,0,3,-3,L
132289,2,BEL1,2003-04-27,Lokeren,Anderlecht,0,5,-5,L
132290,2,BEL1,2003-04-27,St Truiden,Bergen,3,4,-1,L
132291,2,BEL1,2003-05-03,Antwerp,Beveren,3,1,2,W
132292,2,BEL1,2003-05-03,Club Brugge,St Truiden,1,1,0,D
132293,2,BEL1,2003-05-03,Genk,Lierse,5,2,3,W
132294,2,BEL1,2003-05-03,Gent,Westerlo,3,2,1,W
132295,2,BEL1,2003-05-03,Mouscron,Louvieroise,1,0,1,W
132296,2,BEL1,2003-05-03,Standard,Mechelen,0,0,0,D
132297,2,BEL1,2003-05-04,Anderlecht,Germinal,4,0,4,W
132298,2,BEL1,2003-05-04,Bergen,Lokeren,0,0,0,D
132299,2,BEL1,2003-05-10,Louvieroise,Charleroi,2,2,0,D
132300,2,BEL1,2003-05-10,Mechelen,Gent,1,0,1,W
132301,2,BEL1,2003-05-10,St Truiden,Lierse,2,1,1,W
132302,2,BEL1,2003-05-10,Standard,Genk,0,1,-1,L
132303,2,BEL1,2003-05-10,Westerlo,Antwerp,2,1,1,W
132304,2,BEL1,2003-05-11,Beveren,Mouscron,3,0,3,W
132305,2,BEL1,2003-05-11,Germinal,Bergen,4,0,4,W
132306,2,BEL1,2003-05-11,Lokeren,Club Brugge,2,5,-3,L
132307,2,BEL1,2003-05-16,Antwerp,Mechelen,2,0,2,W
132308,2,BEL1,2003-05-17,Anderlecht,Louvieroise,1,0,1,W
132309,2,BEL1,2003-05-17,Charleroi,Beveren,0,0,0,D
132310,2,BEL1,2003-05-17,Genk,St Truiden,2,2,0,D
132311,2,BEL1,2003-05-17,Lierse,Lokeren,2,1,1,W
132312,2,BEL1,2003-05-17,Mouscron,Westerlo,0,4,-4,L
132313,2,BEL1,2003-05-18,Club Brugge,Germinal,1,1,0,D
132314,2,BEL1,2003-05-18,Gent,Standard,0,5,-5,L
132315,2,BEL1,2003-05-24,Genk,Gent,3,1,2,W
132316,2,BEL1,2003-05-24,Louvieroise,Bergen,1,0,1,W
132317,2,BEL1,2003-05-24,Mechelen,Mouscron,3,2,1,W
132318,2,BEL1,2003-05-24,Westerlo,Charleroi,1,1,0,D
132319,2,BEL1,2003-05-25,Beveren,Anderlecht,3,0,3,W
132320,2,BEL1,2003-05-25,Germinal,Lierse,1,2,-1,L
132321,2,BEL1,2003-05-25,Lokeren,St Truiden,0,0,0,D
132322,2,BEL1,2003-05-25,Standard,Antwerp,1,3,-2,L
132323,3,BEL1,2003-08-08,Club Brugge,Genk,1,0,1,W
132324,3,BEL1,2003-08-09,Anderlecht,Antwerp,3,1,2,W
132325,3,BEL1,2003-08-09,Charleroi,Lierse,0,1,-1,L
132326,3,BEL1,2003-08-09,Germinal,Bergen,1,0,1,W
132327,3,BEL1,2003-08-09,Lokeren,St Truiden,0,0,0,D
132328,3,BEL1,2003-08-09,Westerlo,Louvieroise,0,0,0,D
132329,3,BEL1,2003-08-10,Beveren,Gent,2,4,-2,L
132330,3,BEL1,2003-08-10,Heusden Zolder,Cercle Brugge,0,0,0,D
132331,3,BEL1,2003-08-10,Mouscron,Standard,2,2,0,D
132332,3,BEL1,2003-08-16,Antwerp,Westerlo,2,1,1,W
132333,3,BEL1,2003-08-16,Beveren,St Truiden,1,4,-3,L
132334,3,BEL1,2003-08-16,Genk,Charleroi,2,0,2,W
132335,3,BEL1,2003-08-16,Gent,Anderlecht,1,3,-2,L
132336,3,BEL1,2003-08-16,Louvieroise,Heusden Zolder,2,0,2,W
132337,3,BEL1,2003-08-17,Bergen,Mouscron,3,3,0,D
132338,3,BEL1,2003-08-17,Cercle Brugge,Club Brugge,0,2,-2,L
132339,3,BEL1,2003-08-17,Standard,Lokeren,1,0,1,W
132340,3,BEL1,2003-08-18,Lierse,Germinal,0,0,0,D
132341,3,BEL1,2003-08-22,Heusden Zolder,Antwerp,0,0,0,D
132342,3,BEL1,2003-08-23,Anderlecht,St Truiden,3,0,3,W
132343,3,BEL1,2003-08-23,Club Brugge,Louvieroise,3,3,0,D
132344,3,BEL1,2003-08-23,Lokeren,Beveren,1,2,-1,L
132345,3,BEL1,2003-08-23,Mouscron,Lierse,1,1,0,D
132346,3,BEL1,2003-08-23,Standard,Bergen,4,0,4,W
132347,3,BEL1,2003-08-23,Westerlo,Gent,2,2,0,D
132348,3,BEL1,2003-08-24,Charleroi,Cercle Brugge,0,0,0,D
132349,3,BEL1,2003-08-24,Germinal,Genk,2,2,0,D
132350,3,BEL1,2003-08-29,Lierse,Standard,0,1,-1,L
132351,3,BEL1,2003-08-30,Anderlecht,Beveren,1,0,1,W
132352,3,BEL1,2003-08-30,Antwerp,Club Brugge,0,4,-4,L
132353,3,BEL1,2003-08-30,Cercle Brugge,Germinal,1,0,1,W
132354,3,BEL1,2003-08-30,Louvieroise,Charleroi,0,0,0,D
132355,3,BEL1,2003-08-30,St Truiden,Westerlo,0,0,0,D
132356,3,BEL1,2003-08-31,Bergen,Lokeren,1,1,0,D
132357,3,BEL1,2003-08-31,Genk,Mouscron,2,0,2,W
132358,3,BEL1,2003-08-31,Gent,Heusden Zolder,2,0,2,W
132359,3,BEL1,2003-09-12,Heusden Zolder,St Truiden,0,1,-1,L
132360,3,BEL1,2003-09-13,Charleroi,Antwerp,0,1,-1,L
132361,3,BEL1,2003-09-13,Club Brugge,Gent,1,1,0,D
132362,3,BEL1,2003-09-13,Germinal,Louvieroise,0,0,0,D
132363,3,BEL1,2003-09-13,Lokeren,Anderlecht,0,6,-6,L
132364,3,BEL1,2003-09-13,Westerlo,Beveren,3,2,1,W
132365,3,BEL1,2003-09-14,Bergen,Lierse,1,3,-2,L
132366,3,BEL1,2003-09-14,Mouscron,Cercle Brugge,4,0,4,W
132367,3,BEL1,2003-09-14,Standard,Genk,0,2,-2,L
132368,3,BEL1,2003-09-20,Anderlecht,Westerlo,5,1,4,W
132369,3,BEL1,2003-09-20,Beveren,Heusden Zolder,2,0,2,W
132370,3,BEL1,2003-09-20,Cercle Brugge,Standard,2,0,2,W
132371,3,BEL1,2003-09-20,Genk,Bergen,0,0,0,D
132372,3,BEL1,2003-09-20,Gent,Charleroi,1,1,0,D
132373,3,BEL1,2003-09-20,Louvieroise,Mouscron,1,2,-1,L
132374,3,BEL1,2003-09-21,Antwerp,Germinal,0,4,-4,L
132375,3,BEL1,2003-09-21,Lierse,Lokeren,2,1,1,W
132376,3,BEL1,2003-09-21,St Truiden,Club Brugge,3,2,1,W
132377,3,BEL1,2003-09-26,Germinal,Gent,0,2,-2,L
132378,3,BEL1,2003-09-26,Heusden Zolder,Anderlecht,2,4,-2,L
132379,3,BEL1,2003-09-27,Bergen,Cercle Brugge,0,0,0,D
132380,3,BEL1,2003-09-27,Charleroi,St Truiden,1,1,0,D
132381,3,BEL1,2003-09-27,Club Brugge,Beveren,3,0,3,W
132382,3,BEL1,2003-09-27,Lierse,Genk,3,5,-2,L
132383,3,BEL1,2003-09-27,Mouscron,Antwerp,2,0,2,W
132384,3,BEL1,2003-09-27,Standard,Louvieroise,0,2,-2,L
132385,3,BEL1,2003-09-28,Lokeren,Westerlo,1,3,-2,L
132386,3,BEL1,2003-10-04,Beveren,Charleroi,1,0,1,W
132387,3,BEL1,2003-10-04,Genk,Lokeren,3,1,2,W
132388,3,BEL1,2003-10-04,Gent,Mouscron,0,0,0,D
132389,3,BEL1,2003-10-04,Louvieroise,Bergen,1,1,0,D
132390,3,BEL1,2003-10-04,Westerlo,Heusden Zolder,2,0,2,W
132391,3,BEL1,2003-10-05,Anderlecht,Club Brugge,1,1,0,D
132392,3,BEL1,2003-10-05,Antwerp,Standard,0,4,-4,L
132393,3,BEL1,2003-10-05,Cercle Brugge,Lierse,0,0,0,D
132394,3,BEL1,2003-10-05,St Truiden,Germinal,0,0,0,D
132395,3,BEL1,2003-10-17,Charleroi,Anderlecht,0,1,-1,L
132396,3,BEL1,2003-10-18,Bergen,Antwerp,1,0,1,W
132397,3,BEL1,2003-10-18,Club Brugge,Westerlo,4,0,4,W
132398,3,BEL1,2003-10-18,Germinal,Beveren,2,1,1,W
132399,3,BEL1,2003-10-18,Lokeren,Heusden Zolder,3,0,3,W
132400,3,BEL1,2003-10-18,Mouscron,St Truiden,2,1,1,W
132401,3,BEL1,2003-10-18,Standard,Gent,2,0,2,W
132402,3,BEL1,2003-10-19,Genk,Cercle Brugge,3,1,2,W
132403,3,BEL1,2003-10-19,Lierse,Louvieroise,1,1,0,D
132404,3,BEL1,2003-10-25,Anderlecht,Germinal,4,0,4,W
132405,3,BEL1,2003-10-25,Antwerp,Lierse,3,1,2,W
132406,3,BEL1,2003-10-25,Beveren,Mouscron,0,3,-3,L
132407,3,BEL1,2003-10-25,Gent,Bergen,0,0,0,D
132408,3,BEL1,2003-10-25,Louvieroise,Genk,5,2,3,W
132409,3,BEL1,2003-10-26,Cercle Brugge,Lokeren,2,2,0,D
132410,3,BEL1,2003-10-26,Heusden Zolder,Club Brugge,4,2,2,W
132411,3,BEL1,2003-10-26,St Truiden,Standard,1,2,-1,L
132412,3,BEL1,2003-10-26,Westerlo,Charleroi,2,1,1,W
132413,3,BEL1,2003-10-31,Lierse,Gent,0,0,0,D
132414,3,BEL1,2003-10-31,Mouscron,Anderlecht,0,1,-1,L
132415,3,BEL1,2003-11-01,Bergen,St Truiden,3,4,-1,L
132416,3,BEL1,2003-11-01,Genk,Antwerp,3,1,2,W
132417,3,BEL1,2003-11-01,Germinal,Westerlo,0,2,-2,L
132418,3,BEL1,2003-11-01,Lokeren,Club Brugge,2,0,2,W
132419,3,BEL1,2003-11-01,Standard,Beveren,4,0,4,W
132420,3,BEL1,2003-11-02,Cercle Brugge,Louvieroise,2,1,1,W
132421,3,BEL1,2003-11-02,Charleroi,Heusden Zolder,2,1,1,W
132422,3,BEL1,2003-11-07,Gent,Genk,1,1,0,D
132423,3,BEL1,2003-11-08,Antwerp,Cercle Brugge,2,2,0,D
132424,3,BEL1,2003-11-08,Heusden Zolder,Germinal,2,0,2,W
132425,3,BEL1,2003-11-08,Louvieroise,Lokeren,3,2,1,W
132426,3,BEL1,2003-11-08,St Truiden,Lierse,3,2,1,W
132427,3,BEL1,2003-11-08,Westerlo,Mouscron,1,1,0,D
132428,3,BEL1,2003-11-09,Anderlecht,Standard,1,4,-3,L
132429,3,BEL1,2003-11-09,Beveren,Bergen,2,0,2,W
132430,3,BEL1,2003-11-09,Club Brugge,Charleroi,1,0,1,W
132431,3,BEL1,2003-11-21,Bergen,Anderlecht,0,2,-2,L
132432,3,BEL1,2003-11-21,Germinal,Club Brugge,2,0,2,W
132433,3,BEL1,2003-11-22,Genk,St Truiden,4,0,4,W
132434,3,BEL1,2003-11-22,Lierse,Beveren,1,0,1,W
132435,3,BEL1,2003-11-22,Lokeren,Charleroi,0,2,-2,L
132436,3,BEL1,2003-11-22,Mouscron,Heusden Zolder,2,1,1,W
132437,3,BEL1,2003-11-22,Standard,Westerlo,3,0,3,W
132438,3,BEL1,2003-11-23,Cercle Brugge,Gent,1,0,1,W
132439,3,BEL1,2003-11-23,Louvieroise,Antwerp,1,1,0,D
132440,3,BEL1,2003-11-29,Anderlecht,Lierse,2,1,1,W
132441,3,BEL1,2003-11-29,Antwerp,Lokeren,0,3,-3,L
132442,3,BEL1,2003-11-29,Beveren,Genk,3,1,2,W
132443,3,BEL1,2003-11-29,Charleroi,Germinal,0,1,-1,L
132444,3,BEL1,2003-11-29,Gent,Louvieroise,3,0,3,W
132445,3,BEL1,2003-11-29,Westerlo,Bergen,0,1,-1,L
132446,3,BEL1,2003-11-30,Club Brugge,Mouscron,4,2,2,W
132447,3,BEL1,2003-11-30,Heusden Zolder,Standard,1,1,0,D
132448,3,BEL1,2003-11-30,St Truiden,Cercle Brugge,0,0,0,D
132449,3,BEL1,2003-12-05,Standard,Club Brugge,3,1,2,W
132450,3,BEL1,2003-12-06,Antwerp,Gent,0,1,-1,L
132451,3,BEL1,2003-12-06,Genk,Anderlecht,0,1,-1,L
132452,3,BEL1,2003-12-06,Lierse,Westerlo,0,1,-1,L
132453,3,BEL1,2003-12-06,Lokeren,Germinal,0,1,-1,L
132454,3,BEL1,2003-12-06,Louvieroise,St Truiden,0,0,0,D
132455,3,BEL1,2003-12-06,Mouscron,Charleroi,3,0,3,W
132456,3,BEL1,2003-12-07,Bergen,Heusden Zolder,1,2,-1,L
132457,3,BEL1,2003-12-07,Cercle Brugge,Beveren,0,4,-4,L
132458,3,BEL1,2003-12-12,Charleroi,Standard,0,1,-1,L
132459,3,BEL1,2003-12-12,Heusden Zolder,Lierse,0,0,0,D
132460,3,BEL1,2003-12-13,Beveren,Louvieroise,1,0,1,W
132461,3,BEL1,2003-12-13,Club Brugge,Bergen,2,0,2,W
132462,3,BEL1,2003-12-13,Germinal,Mouscron,2,2,0,D
132463,3,BEL1,2003-12-13,St Truiden,Antwerp,2,1,1,W
132464,3,BEL1,2003-12-14,Anderlecht,Cercle Brugge,3,2,1,W
132465,3,BEL1,2003-12-14,Lokeren,Gent,1,1,0,D
132466,3,BEL1,2003-12-14,Westerlo,Genk,1,1,0,D
132467,3,BEL1,2003-12-20,Antwerp,Beveren,0,3,-3,L
132468,3,BEL1,2003-12-20,Bergen,Charleroi,2,2,0,D
132469,3,BEL1,2003-12-20,Genk,Heusden Zolder,4,1,3,W
132470,3,BEL1,2003-12-20,Gent,St Truiden,0,1,-1,L
132471,3,BEL1,2003-12-20,Lierse,Club Brugge,1,1,0,D
132472,3,BEL1,2003-12-20,Mouscron,Lokeren,3,0,3,W
132473,3,BEL1,2003-12-21,Cercle Brugge,Westerlo,0,0,0,D
132474,3,BEL1,2003-12-21,Louvieroise,Anderlecht,1,4,-3,L
132475,3,BEL1,2003-12-21,Standard,Germinal,2,1,1,W
132476,3,BEL1,2004-01-16,Genk,Club Brugge,1,0,1,W
132477,3,BEL1,2004-01-17,Bergen,Germinal,3,0,3,W
132478,3,BEL1,2004-01-17,Gent,Beveren,2,1,1,W
132479,3,BEL1,2004-01-17,Lierse,Charleroi,1,1,0,D
132480,3,BEL1,2004-01-17,St Truiden,Lokeren,1,2,-1,L
132481,3,BEL1,2004-01-17,Standard,Mouscron,3,3,0,D
132482,3,BEL1,2004-01-18,Antwerp,Anderlecht,0,2,-2,L
132483,3,BEL1,2004-01-18,Cercle Brugge,Heusden Zolder,2,3,-1,L
132484,3,BEL1,2004-01-18,Louvieroise,Westerlo,1,1,0,D
132485,3,BEL1,2004-01-24,Anderlecht,Gent,2,0,2,W
132486,3,BEL1,2004-01-24,Charleroi,Genk,4,3,1,W
132487,3,BEL1,2004-01-24,Germinal,Lierse,1,1,0,D
132488,3,BEL1,2004-01-24,Heusden Zolder,Louvieroise,1,3,-2,L
132489,3,BEL1,2004-01-24,Lokeren,Standard,1,1,0,D
132490,3,BEL1,2004-01-24,Mouscron,Bergen,3,2,1,W
132491,3,BEL1,2004-01-24,St Truiden,Beveren,1,1,0,D
132492,3,BEL1,2004-01-25,Club Brugge,Cercle Brugge,5,0,5,W
132493,3,BEL1,2004-01-25,Westerlo,Antwerp,2,1,1,W
132494,3,BEL1,2004-01-31,Antwerp,Heusden Zolder,1,1,0,D
132495,3,BEL1,2004-01-31,Bergen,Standard,1,1,0,D
132496,3,BEL1,2004-01-31,Beveren,Lokeren,1,1,0,D
132497,3,BEL1,2004-01-31,Genk,Germinal,1,1,0,D
132498,3,BEL1,2004-01-31,Gent,Westerlo,0,2,-2,L
132499,3,BEL1,2004-02-01,Cercle Brugge,Charleroi,3,2,1,W
132500,3,BEL1,2004-02-01,Lierse,Mouscron,2,2,0,D
132501,3,BEL1,2004-02-01,St Truiden,Anderlecht,1,3,-2,L
132502,3,BEL1,2004-02-07,Beveren,Anderlecht,2,3,-1,L
132503,3,BEL1,2004-02-07,Charleroi,Louvieroise,2,2,0,D
132504,3,BEL1,2004-02-07,Germinal,Cercle Brugge,2,1,1,W
132505,3,BEL1,2004-02-07,Heusden Zolder,Gent,1,1,0,D
132506,3,BEL1,2004-02-07,Lokeren,Bergen,0,0,0,D
132507,3,BEL1,2004-02-07,Standard,Lierse,1,1,0,D
132508,3,BEL1,2004-02-07,Westerlo,St Truiden,3,0,3,W
132509,3,BEL1,2004-02-08,Club Brugge,Antwerp,4,0,4,W
132510,3,BEL1,2004-02-08,Mouscron,Genk,3,1,2,W
132511,3,BEL1,2004-02-11,Louvieroise,Club Brugge,0,4,-4,L
132512,3,BEL1,2004-02-13,Genk,Standard,1,1,0,D
132513,3,BEL1,2004-02-14,Anderlecht,Lokeren,2,1,1,W
132514,3,BEL1,2004-02-14,Antwerp,Charleroi,3,1,2,W
132515,3,BEL1,2004-02-14,Beveren,Westerlo,0,3,-3,L
132516,3,BEL1,2004-02-14,Lierse,Bergen,0,2,-2,L
132517,3,BEL1,2004-02-14,St Truiden,Heusden Zolder,2,1,1,W
132518,3,BEL1,2004-02-15,Cercle Brugge,Mouscron,1,1,0,D
132519,3,BEL1,2004-02-15,Gent,Club Brugge,0,1,-1,L
132520,3,BEL1,2004-02-16,Louvieroise,Germinal,0,0,0,D
132521,3,BEL1,2004-02-20,Bergen,Genk,0,1,-1,L
132522,3,BEL1,2004-02-21,Charleroi,Gent,2,0,2,W
132523,3,BEL1,2004-02-21,Club Brugge,St Truiden,2,1,1,W
132524,3,BEL1,2004-02-21,Lokeren,Lierse,3,0,3,W
132525,3,BEL1,2004-02-21,Mouscron,Louvieroise,2,1,1,W
132526,3,BEL1,2004-02-21,Standard,Cercle Brugge,7,0,7,W
132527,3,BEL1,2004-02-22,Germinal,Antwerp,1,0,1,W
132528,3,BEL1,2004-02-22,Heusden Zolder,Beveren,1,4,-3,L
132529,3,BEL1,2004-02-22,Westerlo,Anderlecht,0,0,0,D
132530,3,BEL1,2004-02-27,Louvieroise,Standard,3,2,1,W
132531,3,BEL1,2004-02-28,Genk,Lierse,2,0,2,W
132532,3,BEL1,2004-02-28,Gent,Germinal,1,1,0,D
132533,3,BEL1,2004-02-28,St Truiden,Charleroi,1,2,-1,L
132534,3,BEL1,2004-02-29,Beveren,Club Brugge,1,3,-2,L
132535,3,BEL1,2004-02-29,Cercle Brugge,Bergen,0,1,-1,L
132536,3,BEL1,2004-02-29,Westerlo,Lokeren,7,3,4,W
132537,3,BEL1,2004-03-05,Heusden Zolder,Westerlo,0,1,-1,L
132538,3,BEL1,2004-03-06,Bergen,Louvieroise,1,0,1,W
132539,3,BEL1,2004-03-06,Charleroi,Beveren,0,1,-1,L
132540,3,BEL1,2004-03-06,Lierse,Cercle Brugge,0,0,0,D
132541,3,BEL1,2004-03-06,Lokeren,Genk,2,1,1,W
132542,3,BEL1,2004-03-06,Mouscron,Gent,2,1,1,W
132543,3,BEL1,2004-03-07,Club Brugge,Anderlecht,1,0,1,W
132544,3,BEL1,2004-03-07,Germinal,St Truiden,0,0,0,D
132545,3,BEL1,2004-03-07,Standard,Antwerp,3,0,3,W
132546,3,BEL1,2004-03-12,Heusden Zolder,Lokeren,2,3,-1,L
132547,3,BEL1,2004-03-13,Anderlecht,Charleroi,3,2,1,W
132548,3,BEL1,2004-03-13,Antwerp,Bergen,0,0,0,D
132549,3,BEL1,2004-03-13,Beveren,Germinal,0,0,0,D
132550,3,BEL1,2004-03-13,Louvieroise,Lierse,0,1,-1,L
132551,3,BEL1,2004-03-13,St Truiden,Mouscron,1,1,0,D
132552,3,BEL1,2004-03-14,Cercle Brugge,Genk,0,0,0,D
132553,3,BEL1,2004-03-14,Gent,Standard,0,0,0,D
132554,3,BEL1,2004-03-14,Westerlo,Club Brugge,2,3,-1,L
132555,3,BEL1,2004-03-20,Bergen,Gent,0,1,-1,L
132556,3,BEL1,2004-03-20,Charleroi,Westerlo,3,1,2,W
132557,3,BEL1,2004-03-20,Club Brugge,Heusden Zolder,3,0,3,W
132558,3,BEL1,2004-03-20,Genk,Louvieroise,1,1,0,D
132559,3,BEL1,2004-03-20,Germinal,Anderlecht,1,0,1,W
132560,3,BEL1,2004-03-20,Standard,St Truiden,1,1,0,D
132561,3,BEL1,2004-03-21,Lierse,Antwerp,1,0,1,W
132562,3,BEL1,2004-03-21,Lokeren,Cercle Brugge,0,2,-2,L
132563,3,BEL1,2004-03-21,Mouscron,Beveren,5,0,5,W
132564,3,BEL1,2004-03-23,Anderlecht,Heusden Zolder,6,0,6,W
132565,3,BEL1,2004-03-24,Antwerp,Mouscron,3,1,2,W
132566,3,BEL1,2004-04-03,Anderlecht,Mouscron,0,0,0,D
132567,3,BEL1,2004-04-03,Antwerp,Genk,3,1,2,W
132568,3,BEL1,2004-04-03,Beveren,Standard,0,2,-2,L
132569,3,BEL1,2004-04-03,Club Brugge,Lokeren,2,1,1,W
132570,3,BEL1,2004-04-03,Gent,Lierse,1,1,0,D
132571,3,BEL1,2004-04-03,St Truiden,Bergen,1,2,-1,L
132572,3,BEL1,2004-04-03,Westerlo,Germinal,3,1,2,W
132573,3,BEL1,2004-04-04,Heusden Zolder,Charleroi,3,1,2,W
132574,3,BEL1,2004-04-04,Louvieroise,Cercle Brugge,2,0,2,W
132575,3,BEL1,2004-04-09,Genk,Gent,1,0,1,W
132576,3,BEL1,2004-04-09,Standard,Anderlecht,1,1,0,D
132577,3,BEL1,2004-04-10,Bergen,Beveren,2,2,0,D
132578,3,BEL1,2004-04-10,Germinal,Heusden Zolder,1,3,-2,L
132579,3,BEL1,2004-04-10,Lierse,St Truiden,1,1,0,D
132580,3,BEL1,2004-04-10,Lokeren,Louvieroise,2,0,2,W
132581,3,BEL1,2004-04-11,Cercle Brugge,Antwerp,1,2,-1,L
132582,3,BEL1,2004-04-11,Mouscron,Westerlo,3,2,1,W
132583,3,BEL1,2004-04-12,Charleroi,Club Brugge,1,1,0,D
132584,3,BEL1,2004-04-16,Anderlecht,Bergen,4,1,3,W
132585,3,BEL1,2004-04-17,Antwerp,Louvieroise,1,3,-2,L
132586,3,BEL1,2004-04-17,Beveren,Lierse,0,1,-1,L
132587,3,BEL1,2004-04-17,Charleroi,Lokeren,1,2,-1,L
132588,3,BEL1,2004-04-17,Gent,Cercle Brugge,1,1,0,D
132589,3,BEL1,2004-04-17,St Truiden,Genk,0,3,-3,L
132590,3,BEL1,2004-04-18,Club Brugge,Germinal,2,1,1,W
132591,3,BEL1,2004-04-18,Heusden Zolder,Mouscron,1,1,0,D
132592,3,BEL1,2004-04-18,Westerlo,Standard,2,4,-2,L
132593,3,BEL1,2004-04-23,Mouscron,Club Brugge,1,1,0,D
132594,3,BEL1,2004-04-24,Bergen,Westerlo,0,0,0,D
132595,3,BEL1,2004-04-24,Cercle Brugge,St Truiden,2,1,1,W
132596,3,BEL1,2004-04-24,Genk,Beveren,1,0,1,W
132597,3,BEL1,2004-04-24,Germinal,Charleroi,3,1,2,W
132598,3,BEL1,2004-04-24,Lierse,Anderlecht,1,1,0,D
132599,3,BEL1,2004-04-24,Standard,Heusden Zolder,4,1,3,W
132600,3,BEL1,2004-04-25,Lokeren,Antwerp,3,0,3,W
132601,3,BEL1,2004-04-25,Louvieroise,Gent,2,2,0,D
132602,3,BEL1,2004-04-30,Germinal,Lokeren,2,1,1,W
132603,3,BEL1,2004-05-01,Charleroi,Mouscron,1,0,1,W
132604,3,BEL1,2004-05-01,Club Brugge,Standard,1,0,1,W
132605,3,BEL1,2004-05-01,Gent,Antwerp,1,1,0,D
132606,3,BEL1,2004-05-01,Westerlo,Lierse,2,1,1,W
132607,3,BEL1,2004-05-02,Anderlecht,Genk,2,1,1,W
132608,3,BEL1,2004-05-02,Beveren,Cercle Brugge,1,1,0,D
132609,3,BEL1,2004-05-02,Heusden Zolder,Bergen,2,0,2,W
132610,3,BEL1,2004-05-02,St Truiden,Louvieroise,1,2,-1,L
132611,3,BEL1,2004-05-08,Antwerp,St Truiden,1,2,-1,L
132612,3,BEL1,2004-05-08,Bergen,Club Brugge,0,9,-9,L
132613,3,BEL1,2004-05-08,Cercle Brugge,Anderlecht,0,2,-2,L
132614,3,BEL1,2004-05-08,Genk,Westerlo,1,0,1,W
132615,3,BEL1,2004-05-08,Gent,Lokeren,1,1,0,D
132616,3,BEL1,2004-05-08,Lierse,Heusden Zolder,4,0,4,W
132617,3,BEL1,2004-05-08,Louvieroise,Beveren,3,2,1,W
132618,3,BEL1,2004-05-08,Mouscron,Germinal,3,2,1,W
132619,3,BEL1,2004-05-08,Standard,Charleroi,1,1,0,D
132620,3,BEL1,2004-05-14,Germinal,Standard,1,2,-1,L
132621,3,BEL1,2004-05-15,Anderlecht,Louvieroise,1,1,0,D
132622,3,BEL1,2004-05-15,Beveren,Antwerp,5,2,3,W
132623,3,BEL1,2004-05-15,Charleroi,Bergen,1,0,1,W
132624,3,BEL1,2004-05-15,Club Brugge,Lierse,3,0,3,W
132625,3,BEL1,2004-05-15,Heusden Zolder,Genk,2,3,-1,L
132626,3,BEL1,2004-05-15,Lokeren,Mouscron,1,1,0,D
132627,3,BEL1,2004-05-15,St Truiden,Gent,0,2,-2,L
132628,3,BEL1,2004-05-15,Westerlo,Cercle Brugge,1,1,0,D
132629,4,BEL1,2004-08-06,Mouscron,Anderlecht,2,0,2,W
132630,4,BEL1,2004-08-07,Beveren,Club Brugge,1,1,0,D
132631,4,BEL1,2004-08-07,Cercle Brugge,Lokeren,2,2,0,D
132632,4,BEL1,2004-08-07,FC Brussels,Genk,0,1,-1,L
132633,4,BEL1,2004-08-07,Gent,Germinal,0,1,-1,L
132634,4,BEL1,2004-08-07,Lierse,Standard,1,1,0,D
132635,4,BEL1,2004-08-07,St Truiden,Bergen,0,0,0,D
132636,4,BEL1,2004-08-08,Charleroi,Louvieroise,2,5,-3,L
132637,4,BEL1,2004-08-08,Oostende,Westerlo,3,3,0,D
132638,4,BEL1,2004-08-13,Standard,Charleroi,1,2,-1,L
132639,4,BEL1,2004-08-14,Anderlecht,St Truiden,2,1,1,W
132640,4,BEL1,2004-08-14,Genk,Mouscron,0,0,0,D
132641,4,BEL1,2004-08-14,Lokeren,FC Brussels,1,0,1,W
132642,4,BEL1,2004-08-14,Louvieroise,Cercle Brugge,2,1,1,W
132643,4,BEL1,2004-08-14,Westerlo,Lierse,2,1,1,W
132644,4,BEL1,2004-08-15,Bergen,Beveren,2,2,0,D
132645,4,BEL1,2004-08-15,Club Brugge,Gent,5,0,5,W
132646,4,BEL1,2004-08-15,Germinal,Oostende,4,0,4,W
132647,4,BEL1,2004-08-21,Beveren,Anderlecht,0,1,-1,L
132648,4,BEL1,2004-08-21,Charleroi,Westerlo,0,1,-1,L
132649,4,BEL1,2004-08-21,Gent,Bergen,2,1,1,W
132650,4,BEL1,2004-08-21,Lierse,Germinal,2,0,2,W
132651,4,BEL1,2004-08-21,Mouscron,St Truiden,4,0,4,W
132652,4,BEL1,2004-08-21,Oostende,Club Brugge,1,2,-1,L
132653,4,BEL1,2004-08-22,Cercle Brugge,Standard,1,3,-2,L
132654,4,BEL1,2004-08-22,FC Brussels,Louvieroise,1,1,0,D
132655,4,BEL1,2004-08-22,Genk,Lokeren,2,1,1,W
132656,4,BEL1,2004-08-27,Louvieroise,Genk,2,0,2,W
132657,4,BEL1,2004-08-28,Anderlecht,Gent,2,0,2,W
132658,4,BEL1,2004-08-28,Bergen,Oostende,2,0,2,W
132659,4,BEL1,2004-08-28,Club Brugge,Lierse,1,0,1,W
132660,4,BEL1,2004-08-28,Lokeren,Mouscron,1,1,0,D
132661,4,BEL1,2004-08-28,Standard,FC Brussels,1,3,-2,L
132662,4,BEL1,2004-08-28,Westerlo,Cercle Brugge,1,2,-1,L
132663,4,BEL1,2004-08-29,Germinal,Charleroi,0,1,-1,L
132664,4,BEL1,2004-08-29,St Truiden,Beveren,0,1,-1,L
132665,4,BEL1,2004-09-11,Charleroi,Club Brugge,0,1,-1,L
132666,4,BEL1,2004-09-11,FC Brussels,Westerlo,0,1,-1,L
132667,4,BEL1,2004-09-11,Gent,St Truiden,2,1,1,W
132668,4,BEL1,2004-09-11,Lierse,Bergen,4,1,3,W
132669,4,BEL1,2004-09-11,Oostende,Anderlecht,1,3,-2,L
132670,4,BEL1,2004-09-12,Cercle Brugge,Germinal,2,1,1,W
132671,4,BEL1,2004-09-12,Genk,Standard,1,1,0,D
132672,4,BEL1,2004-09-12,Lokeren,Louvieroise,1,0,1,W
132673,4,BEL1,2004-09-12,Mouscron,Beveren,1,0,1,W
132674,4,BEL1,2004-09-17,Louvieroise,Mouscron,3,1,2,W
132675,4,BEL1,2004-09-18,Anderlecht,Lierse,5,1,4,W
132676,4,BEL1,2004-09-18,Bergen,Charleroi,0,1,-1,L
132677,4,BEL1,2004-09-18,Germinal,FC Brussels,2,0,2,W
132678,4,BEL1,2004-09-18,St Truiden,Oostende,0,0,0,D
132679,4,BEL1,2004-09-18,Westerlo,Genk,0,0,0,D
132680,4,BEL1,2004-09-19,Beveren,Gent,1,2,-1,L
132681,4,BEL1,2004-09-19,Club Brugge,Cercle Brugge,5,0,5,W
132682,4,BEL1,2004-09-19,Standard,Lokeren,1,0,1,W
132683,4,BEL1,2004-09-24,Charleroi,Anderlecht,2,1,1,W
132684,4,BEL1,2004-09-24,FC Brussels,Club Brugge,1,6,-5,L
132685,4,BEL1,2004-09-25,Cercle Brugge,Bergen,2,0,2,W
132686,4,BEL1,2004-09-25,Lokeren,Westerlo,3,1,2,W
132687,4,BEL1,2004-09-25,Louvieroise,Standard,0,1,-1,L
132688,4,BEL1,2004-09-25,Mouscron,Gent,0,2,-2,L
132689,4,BEL1,2004-09-25,Oostende,Beveren,1,1,0,D
132690,4,BEL1,2004-09-26,Genk,Germinal,2,1,1,W
132691,4,BEL1,2004-09-26,Lierse,St Truiden,0,1,-1,L
132692,4,BEL1,2004-10-02,Anderlecht,Cercle Brugge,5,2,3,W
132693,4,BEL1,2004-10-02,Bergen,FC Brussels,1,2,-1,L
132694,4,BEL1,2004-10-02,Gent,Oostende,2,1,1,W
132695,4,BEL1,2004-10-02,Germinal,Lokeren,1,2,-1,L
132696,4,BEL1,2004-10-02,St Truiden,Charleroi,2,2,0,D
132697,4,BEL1,2004-10-03,Beveren,Lierse,2,1,1,W
132698,4,BEL1,2004-10-03,Club Brugge,Genk,1,1,0,D
132699,4,BEL1,2004-10-03,Standard,Mouscron,2,0,2,W
132700,4,BEL1,2004-10-03,Westerlo,Louvieroise,0,2,-2,L
132701,4,BEL1,2004-10-15,FC Brussels,Anderlecht,0,1,-1,L
132702,4,BEL1,2004-10-16,Genk,Bergen,2,2,0,D
132703,4,BEL1,2004-10-16,Lierse,Gent,3,2,1,W
132704,4,BEL1,2004-10-16,Mouscron,Oostende,1,1,0,D
132705,4,BEL1,2004-10-16,Standard,Westerlo,2,0,2,W
132706,4,BEL1,2004-10-17,Cercle Brugge,St Truiden,5,1,4,W
132707,4,BEL1,2004-10-17,Charleroi,Beveren,2,1,1,W
132708,4,BEL1,2004-10-17,Lokeren,Club Brugge,0,2,-2,L
132709,4,BEL1,2004-10-17,Louvieroise,Germinal,1,1,0,D
132710,4,BEL1,2004-10-23,Bergen,Lokeren,0,1,-1,L
132711,4,BEL1,2004-10-23,Gent,Charleroi,3,1,2,W
132712,4,BEL1,2004-10-23,St Truiden,FC Brussels,2,0,2,W
132713,4,BEL1,2004-10-23,Westerlo,Mouscron,0,1,-1,L
132714,4,BEL1,2004-10-24,Anderlecht,Genk,4,2,2,W
132715,4,BEL1,2004-10-24,Beveren,Cercle Brugge,5,1,4,W
132716,4,BEL1,2004-10-24,Club Brugge,Louvieroise,2,0,2,W
132717,4,BEL1,2004-10-24,Germinal,Standard,1,0,1,W
132718,4,BEL1,2004-10-24,Oostende,Lierse,2,3,-1,L
132719,4,BEL1,2004-10-29,Standard,Club Brugge,1,4,-3,L
132720,4,BEL1,2004-10-30,Charleroi,Oostende,1,0,1,W
132721,4,BEL1,2004-10-30,FC Brussels,Beveren,1,3,-2,L
132722,4,BEL1,2004-10-30,Genk,St Truiden,1,0,1,W
132723,4,BEL1,2004-10-30,Lokeren,Anderlecht,2,2,0,D
132724,4,BEL1,2004-10-30,Louvieroise,Bergen,4,0,4,W
132725,4,BEL1,2004-10-30,Westerlo,Germinal,1,0,1,W
132726,4,BEL1,2004-10-31,Cercle Brugge,Gent,2,1,1,W
132727,4,BEL1,2004-10-31,Mouscron,Lierse,1,3,-2,L
132728,4,BEL1,2004-11-05,Club Brugge,Westerlo,2,0,2,W
132729,4,BEL1,2004-11-06,Anderlecht,Louvieroise,2,1,1,W
132730,4,BEL1,2004-11-06,Bergen,Standard,2,3,-1,L
132731,4,BEL1,2004-11-06,Germinal,Mouscron,3,1,2,W
132732,4,BEL1,2004-11-06,Lierse,Charleroi,1,1,0,D
132733,4,BEL1,2004-11-06,St Truiden,Lokeren,2,0,2,W
132734,4,BEL1,2004-11-07,Beveren,Genk,0,2,-2,L
132735,4,BEL1,2004-11-07,Gent,FC Brussels,3,0,3,W
132736,4,BEL1,2004-11-07,Oostende,Cercle Brugge,0,1,-1,L
132737,4,BEL1,2004-11-10,Cercle Brugge,Lierse,2,2,0,D
132738,4,BEL1,2004-11-10,FC Brussels,Oostende,2,2,0,D
132739,4,BEL1,2004-11-10,Genk,Gent,1,1,0,D
132740,4,BEL1,2004-11-10,Germinal,Club Brugge,0,1,-1,L
132741,4,BEL1,2004-11-10,Lokeren,Beveren,1,1,0,D
132742,4,BEL1,2004-11-10,Louvieroise,St Truiden,1,0,1,W
132743,4,BEL1,2004-11-10,Mouscron,Charleroi,0,1,-1,L
132744,4,BEL1,2004-11-10,Standard,Anderlecht,1,0,1,W
132745,4,BEL1,2004-11-10,Westerlo,Bergen,2,1,1,W
132746,4,BEL1,2004-11-27,Anderlecht,Westerlo,4,0,4,W
132747,4,BEL1,2004-11-27,Beveren,Louvieroise,0,2,-2,L
132748,4,BEL1,2004-11-27,Charleroi,Cercle Brugge,5,1,4,W
132749,4,BEL1,2004-11-27,Gent,Lokeren,3,1,2,W
132750,4,BEL1,2004-11-27,Oostende,Genk,1,3,-2,L
132751,4,BEL1,2004-11-28,Bergen,Germinal,0,1,-1,L
132752,4,BEL1,2004-11-28,Club Brugge,Mouscron,3,0,3,W
132753,4,BEL1,2004-11-28,Lierse,FC Brussels,5,1,4,W
132754,4,BEL1,2004-11-28,St Truiden,Standard,4,1,3,W
132755,4,BEL1,2004-12-03,Louvieroise,Gent,0,1,-1,L
132756,4,BEL1,2004-12-03,Mouscron,Cercle Brugge,6,0,6,W
132757,4,BEL1,2004-12-04,Club Brugge,Bergen,3,1,2,W
132758,4,BEL1,2004-12-04,Genk,Lierse,3,0,3,W
132759,4,BEL1,2004-12-04,Germinal,Anderlecht,0,1,-1,L
132760,4,BEL1,2004-12-04,Westerlo,St Truiden,2,1,1,W
132761,4,BEL1,2004-12-05,FC Brussels,Charleroi,1,2,-1,L
132762,4,BEL1,2004-12-05,Lokeren,Oostende,1,0,1,W
132763,4,BEL1,2004-12-05,Standard,Beveren,3,0,3,W
132764,4,BEL1,2004-12-11,Anderlecht,Club Brugge,2,1,1,W
132765,4,BEL1,2004-12-11,Beveren,Westerlo,4,1,3,W
132766,4,BEL1,2004-12-11,Charleroi,Genk,2,0,2,W
132767,4,BEL1,2004-12-11,Lierse,Lokeren,2,0,2,W
132768,4,BEL1,2004-12-11,Oostende,Louvieroise,2,1,1,W
132769,4,BEL1,2004-12-11,St Truiden,Germinal,1,1,0,D
132770,4,BEL1,2004-12-12,Cercle Brugge,FC Brussels,1,2,-1,L
132771,4,BEL1,2004-12-12,Gent,Standard,1,1,0,D
132772,4,BEL1,2004-12-12,Mouscron,Bergen,5,1,4,W
132773,4,BEL1,2004-12-18,FC Brussels,Mouscron,2,1,1,W
132774,4,BEL1,2004-12-18,Genk,Cercle Brugge,2,1,1,W
132775,4,BEL1,2004-12-18,Lokeren,Charleroi,1,1,0,D
132776,4,BEL1,2004-12-18,Louvieroise,Lierse,3,2,1,W
132777,4,BEL1,2004-12-18,Westerlo,Gent,2,1,1,W
132778,4,BEL1,2004-12-19,Beveren,Germinal,1,0,1,W
132779,4,BEL1,2004-12-19,Club Brugge,St Truiden,5,1,4,W
132780,4,BEL1,2004-12-19,Standard,Oostende,5,0,5,W
132781,4,BEL1,2005-01-15,Anderlecht,Mouscron,2,0,2,W
132782,4,BEL1,2005-01-15,Bergen,St Truiden,4,1,3,W
132783,4,BEL1,2005-01-15,Club Brugge,Beveren,3,1,2,W
132784,4,BEL1,2005-01-15,Genk,FC Brussels,3,1,2,W
132785,4,BEL1,2005-01-15,Germinal,Gent,0,0,0,D
132786,4,BEL1,2005-01-15,Lokeren,Cercle Brugge,4,0,4,W
132787,4,BEL1,2005-01-15,Louvieroise,Charleroi,0,0,0,D
132788,4,BEL1,2005-01-15,Standard,Lierse,4,1,3,W
132789,4,BEL1,2005-01-16,Westerlo,Oostende,2,0,2,W
132790,4,BEL1,2005-01-22,Beveren,Bergen,0,4,-4,L
132791,4,BEL1,2005-01-22,Charleroi,Standard,0,0,0,D
132792,4,BEL1,2005-01-22,FC Brussels,Lokeren,1,2,-1,L
132793,4,BEL1,2005-01-22,Lierse,Westerlo,3,0,3,W
132794,4,BEL1,2005-01-22,Mouscron,Genk,1,2,-1,L
132795,4,BEL1,2005-01-22,Oostende,Germinal,0,0,0,D
132796,4,BEL1,2005-01-22,St Truiden,Anderlecht,2,2,0,D
132797,4,BEL1,2005-01-23,Cercle Brugge,Louvieroise,2,2,0,D
132798,4,BEL1,2005-01-23,Gent,Club Brugge,0,1,-1,L
132799,4,BEL1,2005-01-29,Anderlecht,Beveren,5,2,3,W
132800,4,BEL1,2005-01-29,Bergen,Gent,1,0,1,W
132801,4,BEL1,2005-01-29,Club Brugge,Oostende,7,3,4,W
132802,4,BEL1,2005-01-29,Germinal,Lierse,2,2,0,D
132803,4,BEL1,2005-01-29,St Truiden,Mouscron,3,2,1,W
132804,4,BEL1,2005-01-29,Standard,Cercle Brugge,4,0,4,W
132805,4,BEL1,2005-01-29,Westerlo,Charleroi,2,1,1,W
132806,4,BEL1,2005-01-30,Lokeren,Genk,1,3,-2,L
132807,4,BEL1,2005-01-30,Louvieroise,FC Brussels,1,0,1,W
132808,4,BEL1,2005-02-05,Beveren,St Truiden,3,1,2,W
132809,4,BEL1,2005-02-05,FC Brussels,Standard,0,1,-1,L
132810,4,BEL1,2005-02-05,Genk,Louvieroise,1,0,1,W
132811,4,BEL1,2005-02-05,Lierse,Club Brugge,0,2,-2,L
132812,4,BEL1,2005-02-05,Mouscron,Lokeren,1,1,0,D
132813,4,BEL1,2005-02-05,Oostende,Bergen,1,0,1,W
132814,4,BEL1,2005-02-06,Cercle Brugge,Westerlo,0,0,0,D
132815,4,BEL1,2005-02-06,Charleroi,Germinal,1,0,1,W
132816,4,BEL1,2005-02-06,Gent,Anderlecht,0,0,0,D
132817,4,BEL1,2005-02-12,Anderlecht,Oostende,0,1,-1,L
132818,4,BEL1,2005-02-12,Beveren,Mouscron,2,2,0,D
132819,4,BEL1,2005-02-12,Louvieroise,Lokeren,0,0,0,D
132820,4,BEL1,2005-02-12,Westerlo,FC Brussels,1,0,1,W
132821,4,BEL1,2005-02-13,Bergen,Lierse,4,1,3,W
132822,4,BEL1,2005-02-13,Club Brugge,Charleroi,1,1,0,D
132823,4,BEL1,2005-02-13,Germinal,Cercle Brugge,2,3,-1,L
132824,4,BEL1,2005-02-18,Lierse,Anderlecht,1,1,0,D
132825,4,BEL1,2005-02-19,Charleroi,Bergen,1,0,1,W
132826,4,BEL1,2005-02-19,Genk,Westerlo,3,2,1,W
132827,4,BEL1,2005-02-19,Gent,Beveren,1,0,1,W
132828,4,BEL1,2005-02-19,Lokeren,Standard,0,0,0,D
132829,4,BEL1,2005-02-19,Mouscron,Louvieroise,1,1,0,D
132830,4,BEL1,2005-02-19,Oostende,St Truiden,1,0,1,W
132831,4,BEL1,2005-02-20,Cercle Brugge,Club Brugge,1,2,-1,L
132832,4,BEL1,2005-02-20,FC Brussels,Germinal,2,1,1,W
132833,4,BEL1,2005-02-25,Bergen,Anderlecht,1,2,-1,L
132834,4,BEL1,2005-02-25,Standard,Genk,1,0,1,W
132835,4,BEL1,2005-02-26,St Truiden,Gent,0,2,-2,L
132836,4,BEL1,2005-03-08,Anderlecht,Charleroi,3,0,3,W
132837,4,BEL1,2005-03-08,Gent,Mouscron,1,0,1,W
132838,4,BEL1,2005-03-09,Bergen,Cercle Brugge,1,3,-2,L
132839,4,BEL1,2005-03-09,Beveren,Oostende,2,2,0,D
132840,4,BEL1,2005-03-09,Club Brugge,FC Brussels,4,1,3,W
132841,4,BEL1,2005-03-09,Germinal,Genk,3,1,2,W
132842,4,BEL1,2005-03-09,St Truiden,Lierse,4,0,4,W
132843,4,BEL1,2005-03-09,Westerlo,Lokeren,1,1,0,D
132844,4,BEL1,2005-03-11,Mouscron,Standard,0,3,-3,L
132845,4,BEL1,2005-03-12,Charleroi,St Truiden,0,0,0,D
132846,4,BEL1,2005-03-12,FC Brussels,Bergen,2,1,1,W
132847,4,BEL1,2005-03-12,Lokeren,Germinal,0,1,-1,L
132848,4,BEL1,2005-03-12,Louvieroise,Westerlo,1,2,-1,L
132849,4,BEL1,2005-03-12,Oostende,Gent,1,2,-1,L
132850,4,BEL1,2005-03-13,Cercle Brugge,Anderlecht,1,3,-2,L
132851,4,BEL1,2005-03-13,Genk,Club Brugge,2,1,1,W
132852,4,BEL1,2005-03-13,Lierse,Beveren,1,3,-2,L
132853,4,BEL1,2005-03-16,Standard,Louvieroise,1,0,1,W
132854,4,BEL1,2005-03-18,Bergen,Genk,1,2,-1,L
132855,4,BEL1,2005-03-19,Anderlecht,FC Brussels,3,0,3,W
132856,4,BEL1,2005-03-19,Beveren,Charleroi,1,2,-1,L
132857,4,BEL1,2005-03-19,Club Brugge,Lokeren,0,0,0,D
132858,4,BEL1,2005-03-19,Gent,Lierse,1,0,1,W
132859,4,BEL1,2005-03-19,Germinal,Louvieroise,1,1,0,D
132860,4,BEL1,2005-03-19,St Truiden,Cercle Brugge,0,1,-1,L
132861,4,BEL1,2005-03-19,Westerlo,Standard,1,3,-2,L
132862,4,BEL1,2005-03-20,Oostende,Mouscron,1,0,1,W
132863,4,BEL1,2005-04-02,Cercle Brugge,Beveren,1,1,0,D
132864,4,BEL1,2005-04-02,Charleroi,Gent,3,2,1,W
132865,4,BEL1,2005-04-02,Lierse,Oostende,3,1,2,W
132866,4,BEL1,2005-04-02,Lokeren,Bergen,0,0,0,D
132867,4,BEL1,2005-04-02,Louvieroise,Club Brugge,0,2,-2,L
132868,4,BEL1,2005-04-02,Standard,Germinal,3,0,3,W
132869,4,BEL1,2005-04-03,FC Brussels,St Truiden,0,1,-1,L
132870,4,BEL1,2005-04-03,Genk,Anderlecht,2,4,-2,L
132871,4,BEL1,2005-04-03,Mouscron,Westerlo,3,0,3,W
132872,4,BEL1,2005-04-08,St Truiden,Genk,0,2,-2,L
132873,4,BEL1,2005-04-09,Anderlecht,Lokeren,2,0,2,W
132874,4,BEL1,2005-04-09,Bergen,Louvieroise,4,1,3,W
132875,4,BEL1,2005-04-09,Gent,Cercle Brugge,1,2,-1,L
132876,4,BEL1,2005-04-09,Germinal,Westerlo,1,0,1,W
132877,4,BEL1,2005-04-09,Lierse,Mouscron,0,1,-1,L
132878,4,BEL1,2005-04-09,Oostende,Charleroi,1,2,-1,L
132879,4,BEL1,2005-04-10,Beveren,FC Brussels,0,1,-1,L
132880,4,BEL1,2005-04-10,Club Brugge,Standard,1,1,0,D
132881,4,BEL1,2005-04-15,Westerlo,Club Brugge,1,3,-2,L
132882,4,BEL1,2005-04-16,Charleroi,Lierse,1,0,1,W
132883,4,BEL1,2005-04-16,FC Brussels,Gent,1,1,0,D
132884,4,BEL1,2005-04-16,Genk,Beveren,2,1,1,W
132885,4,BEL1,2005-04-16,Lokeren,St Truiden,4,3,1,W
132886,4,BEL1,2005-04-16,Mouscron,Germinal,0,1,-1,L
132887,4,BEL1,2005-04-17,Cercle Brugge,Oostende,2,0,2,W
132888,4,BEL1,2005-04-17,Louvieroise,Anderlecht,1,1,0,D
132889,4,BEL1,2005-04-17,Standard,Bergen,2,0,2,W
132890,4,BEL1,2005-04-22,Anderlecht,Standard,3,2,1,W
132891,4,BEL1,2005-04-23,Bergen,Westerlo,3,2,1,W
132892,4,BEL1,2005-04-23,Beveren,Lokeren,0,2,-2,L
132893,4,BEL1,2005-04-23,Club Brugge,Germinal,6,0,6,W
132894,4,BEL1,2005-04-23,Gent,Genk,0,1,-1,L
132895,4,BEL1,2005-04-23,Oostende,FC Brussels,1,0,1,W
132896,4,BEL1,2005-04-23,St Truiden,Louvieroise,2,1,1,W
132897,4,BEL1,2005-04-24,Charleroi,Mouscron,2,0,2,W
132898,4,BEL1,2005-04-24,Lierse,Cercle Brugge,2,0,2,W
132899,4,BEL1,2005-04-29,Westerlo,Anderlecht,2,2,0,D
132900,4,BEL1,2005-04-30,FC Brussels,Lierse,3,2,1,W
132901,4,BEL1,2005-04-30,Genk,Oostende,2,2,0,D
132902,4,BEL1,2005-04-30,Germinal,Bergen,2,0,2,W
132903,4,BEL1,2005-04-30,Lokeren,Gent,0,1,-1,L
132904,4,BEL1,2005-04-30,Louvieroise,Beveren,3,0,3,W
132905,4,BEL1,2005-04-30,Mouscron,Club Brugge,0,1,-1,L
132906,4,BEL1,2005-04-30,Standard,St Truiden,4,1,3,W
132907,4,BEL1,2005-05-01,Cercle Brugge,Charleroi,0,4,-4,L
132908,4,BEL1,2005-05-06,Bergen,Club Brugge,0,0,0,D
132909,4,BEL1,2005-05-07,Anderlecht,Germinal,3,0,3,W
132910,4,BEL1,2005-05-07,Beveren,Standard,2,3,-1,L
132911,4,BEL1,2005-05-07,Cercle Brugge,Mouscron,1,0,1,W
132912,4,BEL1,2005-05-07,Charleroi,FC Brussels,1,2,-1,L
132913,4,BEL1,2005-05-07,Gent,Louvieroise,2,1,1,W
132914,4,BEL1,2005-05-07,Lierse,Genk,1,5,-4,L
132915,4,BEL1,2005-05-08,Oostende,Lokeren,0,2,-2,L
132916,4,BEL1,2005-05-08,St Truiden,Westerlo,1,0,1,W
132917,4,BEL1,2005-05-15,Bergen,Mouscron,0,2,-2,L
132918,4,BEL1,2005-05-15,Club Brugge,Anderlecht,2,2,0,D
132919,4,BEL1,2005-05-15,FC Brussels,Cercle Brugge,2,1,1,W
132920,4,BEL1,2005-05-15,Genk,Charleroi,2,0,2,W
132921,4,BEL1,2005-05-15,Germinal,St Truiden,3,1,2,W
132922,4,BEL1,2005-05-15,Lokeren,Lierse,0,2,-2,L
132923,4,BEL1,2005-05-15,Louvieroise,Oostende,2,0,2,W
132924,4,BEL1,2005-05-15,Standard,Gent,3,0,3,W
132925,4,BEL1,2005-05-15,Westerlo,Beveren,1,1,0,D
132926,4,BEL1,2005-05-21,Anderlecht,Bergen,2,1,1,W
132927,4,BEL1,2005-05-21,Cercle Brugge,Genk,1,3,-2,L
132928,4,BEL1,2005-05-21,Charleroi,Lokeren,2,1,1,W
132929,4,BEL1,2005-05-21,Gent,Westerlo,1,0,1,W
132930,4,BEL1,2005-05-21,Germinal,Beveren,3,1,2,W
132931,4,BEL1,2005-05-21,Lierse,Louvieroise,7,0,7,W
132932,4,BEL1,2005-05-21,Mouscron,FC Brussels,2,0,2,W
132933,4,BEL1,2005-05-21,Oostende,Standard,1,1,0,D
132934,4,BEL1,2005-05-21,St Truiden,Club Brugge,3,2,1,W
132935,5,BEL1,2005-08-05,Club Brugge,Mouscron,2,0,2,W
132936,5,BEL1,2005-08-06,Anderlecht,Louvieroise,6,0,6,W
132937,5,BEL1,2005-08-06,Beveren,FC Brussels,0,2,-2,L
132938,5,BEL1,2005-08-06,Gent,Waregem,1,3,-2,L
132939,5,BEL1,2005-08-06,Lokeren,Genk,1,1,0,D
132940,5,BEL1,2005-08-06,St Truiden,Roeselare,1,0,1,W
132941,5,BEL1,2005-08-06,Standard,Lierse,3,1,2,W
132942,5,BEL1,2005-08-06,Westerlo,Cercle Brugge,2,0,2,W
132943,5,BEL1,2005-08-07,Charleroi,Germinal,2,0,2,W
132944,5,BEL1,2005-08-12,Louvieroise,Gent,1,1,0,D
132945,5,BEL1,2005-08-13,FC Brussels,Club Brugge,1,1,0,D
132946,5,BEL1,2005-08-13,Germinal,Westerlo,0,1,-1,L
132947,5,BEL1,2005-08-13,Mouscron,Lokeren,0,2,-2,L
132948,5,BEL1,2005-08-14,Cercle Brugge,Anderlecht,0,2,-2,L
132949,5,BEL1,2005-08-14,Genk,Charleroi,0,0,0,D
132950,5,BEL1,2005-08-14,Lierse,St Truiden,1,0,1,W
132951,5,BEL1,2005-08-14,Roeselare,Beveren,1,0,1,W
132952,5,BEL1,2005-08-14,Waregem,Standard,1,2,-1,L
132953,5,BEL1,2005-08-20,Anderlecht,Germinal,3,1,2,W
132954,5,BEL1,2005-08-20,Beveren,Lierse,4,1,3,W
132955,5,BEL1,2005-08-20,Charleroi,Mouscron,1,0,1,W
132956,5,BEL1,2005-08-20,Club Brugge,Roeselare,1,0,1,W
132957,5,BEL1,2005-08-20,Gent,Cercle Brugge,1,0,1,W
132958,5,BEL1,2005-08-20,Waregem,Louvieroise,0,0,0,D
132959,5,BEL1,2005-08-20,Westerlo,Genk,1,1,0,D
132960,5,BEL1,2005-08-21,Lokeren,FC Brussels,1,0,1,W
132961,5,BEL1,2005-08-21,Standard,St Truiden,2,0,2,W
132962,5,BEL1,2005-08-26,St Truiden,Beveren,1,0,1,W
132963,5,BEL1,2005-08-27,Cercle Brugge,Waregem,2,4,-2,L
132964,5,BEL1,2005-08-27,FC Brussels,Charleroi,2,2,0,D
132965,5,BEL1,2005-08-27,Germinal,Gent,2,1,1,W
132966,5,BEL1,2005-08-27,Lierse,Club Brugge,1,1,0,D
132967,5,BEL1,2005-08-27,Louvieroise,Standard,2,3,-1,L
132968,5,BEL1,2005-08-27,Mouscron,Westerlo,1,0,1,W
132969,5,BEL1,2005-08-28,Genk,Anderlecht,3,3,0,D
132970,5,BEL1,2005-08-28,Roeselare,Lokeren,4,0,4,W
132971,5,BEL1,2005-09-10,Anderlecht,Mouscron,3,1,2,W
132972,5,BEL1,2005-09-10,Charleroi,Roeselare,1,1,0,D
132973,5,BEL1,2005-09-10,Club Brugge,St Truiden,2,1,1,W
132974,5,BEL1,2005-09-10,Gent,Genk,2,0,2,W
132975,5,BEL1,2005-09-10,Louvieroise,Cercle Brugge,0,0,0,D
132976,5,BEL1,2005-09-10,Waregem,Germinal,2,1,1,W
132977,5,BEL1,2005-09-10,Westerlo,FC Brussels,3,0,3,W
132978,5,BEL1,2005-09-11,Standard,Beveren,1,3,-2,L
132979,5,BEL1,2005-09-16,Mouscron,Gent,1,2,-1,L
132980,5,BEL1,2005-09-17,Cercle Brugge,Standard,0,3,-3,L
132981,5,BEL1,2005-09-17,FC Brussels,Anderlecht,1,1,0,D
132982,5,BEL1,2005-09-17,Lierse,Charleroi,0,0,0,D
132983,5,BEL1,2005-09-17,St Truiden,Lokeren,1,2,-1,L
132984,5,BEL1,2005-09-18,Beveren,Club Brugge,0,1,-1,L
132985,5,BEL1,2005-09-18,Genk,Waregem,3,1,2,W
132986,5,BEL1,2005-09-18,Germinal,Louvieroise,1,1,0,D
132987,5,BEL1,2005-09-18,Roeselare,Westerlo,0,2,-2,L
132988,5,BEL1,2005-09-20,Charleroi,St Truiden,0,1,-1,L
132989,5,BEL1,2005-09-20,Gent,FC Brussels,2,1,1,W
132990,5,BEL1,2005-09-21,Anderlecht,Roeselare,5,1,4,W
132991,5,BEL1,2005-09-21,Cercle Brugge,Germinal,3,0,3,W
132992,5,BEL1,2005-09-21,Lokeren,Beveren,1,2,-1,L
132993,5,BEL1,2005-09-21,Louvieroise,Genk,2,3,-1,L
132994,5,BEL1,2005-09-21,Standard,Club Brugge,2,0,2,W
132995,5,BEL1,2005-09-21,Waregem,Mouscron,4,1,3,W
132996,5,BEL1,2005-09-21,Westerlo,Lierse,0,0,0,D
132997,5,BEL1,2005-09-24,Beveren,Charleroi,1,1,0,D
132998,5,BEL1,2005-09-24,Club Brugge,Lokeren,0,1,-1,L
132999,5,BEL1,2005-09-24,FC Brussels,Waregem,1,1,0,D
133000,5,BEL1,2005-09-24,Genk,Cercle Brugge,3,1,2,W
133001,5,BEL1,2005-09-24,Mouscron,Louvieroise,2,1,1,W
133002,5,BEL1,2005-09-24,St Truiden,Westerlo,0,1,-1,L
133003,5,BEL1,2005-09-25,Germinal,Standard,2,2,0,D
133004,5,BEL1,2005-09-25,Lierse,Anderlecht,0,0,0,D
133005,5,BEL1,2005-09-25,Roeselare,Gent,1,1,0,D
133006,5,BEL1,2005-09-30,Charleroi,Club Brugge,3,3,0,D
133007,5,BEL1,2005-10-01,Anderlecht,St Truiden,3,0,3,W
133008,5,BEL1,2005-10-01,Gent,Lierse,1,1,0,D
133009,5,BEL1,2005-10-01,Louvieroise,FC Brussels,0,3,-3,L
133010,5,BEL1,2005-10-01,Standard,Lokeren,2,1,1,W
133011,5,BEL1,2005-10-01,Waregem,Roeselare,2,1,1,W
133012,5,BEL1,2005-10-01,Westerlo,Beveren,4,1,3,W
133013,5,BEL1,2005-10-02,Cercle Brugge,Mouscron,1,0,1,W
133014,5,BEL1,2005-10-02,Germinal,Genk,2,2,0,D
133015,5,BEL1,2005-10-15,Beveren,Anderlecht,0,1,-1,L
133016,5,BEL1,2005-10-15,Club Brugge,Westerlo,2,1,1,W
133017,5,BEL1,2005-10-15,FC Brussels,Cercle Brugge,1,2,-1,L
133018,5,BEL1,2005-10-15,Lierse,Waregem,0,2,-2,L
133019,5,BEL1,2005-10-15,Lokeren,Charleroi,4,2,2,W
133020,5,BEL1,2005-10-15,Mouscron,Germinal,4,1,3,W
133021,5,BEL1,2005-10-15,Roeselare,Louvieroise,4,1,3,W
133022,5,BEL1,2005-10-16,Genk,Standard,0,1,-1,L
133023,5,BEL1,2005-10-16,St Truiden,Gent,1,1,0,D
133024,5,BEL1,2005-10-21,Standard,Charleroi,1,0,1,W
133025,5,BEL1,2005-10-22,Cercle Brugge,Roeselare,2,2,0,D
133026,5,BEL1,2005-10-22,Genk,Mouscron,1,0,1,W
133027,5,BEL1,2005-10-22,Gent,Beveren,3,0,3,W
133028,5,BEL1,2005-10-22,Germinal,FC Brussels,0,1,-1,L
133029,5,BEL1,2005-10-22,Louvieroise,Lierse,1,0,1,W
133030,5,BEL1,2005-10-22,Waregem,St Truiden,1,5,-4,L
133031,5,BEL1,2005-10-22,Westerlo,Lokeren,1,1,0,D
133032,5,BEL1,2005-10-23,Anderlecht,Club Brugge,2,2,0,D
133033,5,BEL1,2005-10-28,Lokeren,Anderlecht,2,2,0,D
133034,5,BEL1,2005-10-29,Beveren,Waregem,2,1,1,W
133035,5,BEL1,2005-10-29,Charleroi,Westerlo,2,1,1,W
133036,5,BEL1,2005-10-29,Club Brugge,Gent,2,1,1,W
133037,5,BEL1,2005-10-29,FC Brussels,Genk,1,0,1,W
133038,5,BEL1,2005-10-29,Lierse,Cercle Brugge,0,4,-4,L
133039,5,BEL1,2005-10-29,St Truiden,Louvieroise,1,3,-2,L
133040,5,BEL1,2005-10-30,Mouscron,Standard,2,1,1,W
133041,5,BEL1,2005-10-30,Roeselare,Germinal,5,1,4,W
133042,5,BEL1,2005-11-04,Gent,Lokeren,1,2,-1,L
133043,5,BEL1,2005-11-05,Anderlecht,Charleroi,3,1,2,W
133044,5,BEL1,2005-11-05,Cercle Brugge,St Truiden,2,1,1,W
133045,5,BEL1,2005-11-05,Genk,Roeselare,4,1,3,W
133046,5,BEL1,2005-11-05,Germinal,Lierse,4,0,4,W
133047,5,BEL1,2005-11-05,Louvieroise,Beveren,2,0,2,W
133048,5,BEL1,2005-11-05,Mouscron,FC Brussels,1,1,0,D
133049,5,BEL1,2005-11-06,Standard,Westerlo,1,0,1,W
133050,5,BEL1,2005-11-06,Waregem,Club Brugge,2,1,1,W
133051,5,BEL1,2005-11-09,Lokeren,Lierse,1,0,1,W
133052,5,BEL1,2005-11-19,Beveren,Cercle Brugge,5,1,4,W
133053,5,BEL1,2005-11-19,Charleroi,Gent,2,0,2,W
133054,5,BEL1,2005-11-19,Club Brugge,Louvieroise,4,0,4,W
133055,5,BEL1,2005-11-19,FC Brussels,Standard,3,1,2,W
133056,5,BEL1,2005-11-19,Lokeren,Waregem,2,3,-1,L
133057,5,BEL1,2005-11-19,St Truiden,Germinal,1,2,-1,L
133058,5,BEL1,2005-11-20,Lierse,Genk,1,2,-1,L
133059,5,BEL1,2005-11-20,Roeselare,Mouscron,5,0,5,W
133060,5,BEL1,2005-11-20,Westerlo,Anderlecht,2,1,1,W
133061,5,BEL1,2005-11-27,Cercle Brugge,Club Brugge,0,1,-1,L
133062,5,BEL1,2005-11-27,Genk,St Truiden,2,0,2,W
133063,5,BEL1,2005-12-02,Anderlecht,Gent,3,0,3,W
133064,5,BEL1,2005-12-03,Charleroi,Louvieroise,0,2,-2,L
133065,5,BEL1,2005-12-03,Club Brugge,Germinal,2,0,2,W
133066,5,BEL1,2005-12-03,Lierse,FC Brussels,1,1,0,D
133067,5,BEL1,2005-12-03,Lokeren,Cercle Brugge,2,1,1,W
133068,5,BEL1,2005-12-03,St Truiden,Mouscron,3,6,-3,L
133069,5,BEL1,2005-12-03,Standard,Roeselare,0,0,0,D
133070,5,BEL1,2005-12-03,Westerlo,Waregem,2,2,0,D
133071,5,BEL1,2005-12-04,Beveren,Genk,0,2,-2,L
133072,5,BEL1,2005-12-09,Germinal,Lokeren,2,1,1,W
133073,5,BEL1,2005-12-10,Cercle Brugge,Charleroi,2,0,2,W
133074,5,BEL1,2005-12-10,FC Brussels,St Truiden,0,0,0,D
133075,5,BEL1,2005-12-10,Louvieroise,Westerlo,0,3,-3,L
133076,5,BEL1,2005-12-10,Mouscron,Beveren,1,3,-2,L
133077,5,BEL1,2005-12-10,Waregem,Anderlecht,1,2,-1,L
133078,5,BEL1,2005-12-11,Genk,Club Brugge,2,2,0,D
133079,5,BEL1,2005-12-11,Gent,Standard,2,1,1,W
133080,5,BEL1,2005-12-11,Roeselare,Lierse,2,0,2,W
133081,5,BEL1,2005-12-14,FC Brussels,Roeselare,1,0,1,W
133082,5,BEL1,2005-12-14,Gent,Westerlo,0,1,-1,L
133083,5,BEL1,2005-12-14,Germinal,Beveren,3,1,2,W
133084,5,BEL1,2005-12-14,Louvieroise,Lokeren,1,1,0,D
133085,5,BEL1,2005-12-14,Mouscron,Lierse,5,0,5,W
133086,5,BEL1,2005-12-14,Standard,Anderlecht,2,0,2,W
133087,5,BEL1,2005-12-14,Waregem,Charleroi,3,0,3,W
133088,5,BEL1,2005-12-17,Cercle Brugge,Westerlo,2,2,0,D
133089,5,BEL1,2005-12-17,FC Brussels,Beveren,3,1,2,W
133090,5,BEL1,2005-12-17,Genk,Lokeren,2,2,0,D
133091,5,BEL1,2005-12-17,Germinal,Charleroi,0,1,-1,L
133092,5,BEL1,2005-12-17,Mouscron,Club Brugge,0,1,-1,L
133093,5,BEL1,2005-12-17,Roeselare,St Truiden,1,1,0,D
133094,5,BEL1,2005-12-18,Lierse,Standard,0,2,-2,L
133095,5,BEL1,2005-12-18,Louvieroise,Anderlecht,0,0,0,D
133096,5,BEL1,2005-12-18,Waregem,Gent,1,2,-1,L
133097,5,BEL1,2006-01-20,Club Brugge,FC Brussels,3,0,3,W
133098,5,BEL1,2006-01-21,Anderlecht,Cercle Brugge,2,2,0,D
133099,5,BEL1,2006-01-21,Beveren,Roeselare,1,1,0,D
133100,5,BEL1,2006-01-21,Gent,Louvieroise,3,0,3,W
133101,5,BEL1,2006-01-21,Lokeren,Mouscron,1,1,0,D
133102,5,BEL1,2006-01-21,St Truiden,Lierse,1,1,0,D
133103,5,BEL1,2006-01-21,Standard,Waregem,1,2,-1,L
133104,5,BEL1,2006-01-21,Westerlo,Germinal,1,3,-2,L
133105,5,BEL1,2006-01-22,Charleroi,Genk,2,1,1,W
133106,5,BEL1,2006-01-27,Germinal,Anderlecht,2,0,2,W
133107,5,BEL1,2006-01-28,Cercle Brugge,Gent,1,2,-1,L
133108,5,BEL1,2006-01-28,FC Brussels,Lokeren,1,1,0,D
133109,5,BEL1,2006-01-28,Genk,Westerlo,2,0,2,W
133110,5,BEL1,2006-01-28,Lierse,Beveren,2,0,2,W
133111,5,BEL1,2006-01-28,Louvieroise,Waregem,2,2,0,D
133112,5,BEL1,2006-01-28,Mouscron,Charleroi,0,1,-1,L
133113,5,BEL1,2006-01-28,St Truiden,Standard,0,0,0,D
133114,5,BEL1,2006-01-29,Roeselare,Club Brugge,1,1,0,D
133115,5,BEL1,2006-02-03,Club Brugge,Lierse,3,1,2,W
133116,5,BEL1,2006-02-04,Anderlecht,Genk,4,1,3,W
133117,5,BEL1,2006-02-04,Beveren,St Truiden,1,1,0,D
133118,5,BEL1,2006-02-04,Charleroi,FC Brussels,1,0,1,W
133119,5,BEL1,2006-02-04,Gent,Germinal,2,1,1,W
133120,5,BEL1,2006-02-04,Lokeren,Roeselare,2,2,0,D
133121,5,BEL1,2006-02-04,Waregem,Cercle Brugge,3,1,2,W
133122,5,BEL1,2006-02-04,Westerlo,Mouscron,0,5,-5,L
133123,5,BEL1,2006-02-11,Beveren,Standard,0,2,-2,L
133124,5,BEL1,2006-02-11,Cercle Brugge,Louvieroise,1,0,1,W
133125,5,BEL1,2006-02-11,Germinal,Waregem,2,0,2,W
133126,5,BEL1,2006-02-11,Lierse,Lokeren,2,0,2,W
133127,5,BEL1,2006-02-11,Mouscron,Anderlecht,0,1,-1,L
133128,5,BEL1,2006-02-11,St Truiden,Club Brugge,2,2,0,D
133129,5,BEL1,2006-02-12,Genk,Gent,2,1,1,W
133130,5,BEL1,2006-02-17,Anderlecht,FC Brussels,2,0,2,W
133131,5,BEL1,2006-02-18,Charleroi,Lierse,0,1,-1,L
133132,5,BEL1,2006-02-18,Gent,Mouscron,0,0,0,D
133133,5,BEL1,2006-02-18,Lokeren,St Truiden,1,2,-1,L
133134,5,BEL1,2006-02-18,Standard,Cercle Brugge,7,1,6,W
133135,5,BEL1,2006-02-18,Waregem,Genk,1,0,1,W
133136,5,BEL1,2006-02-18,Westerlo,Roeselare,3,2,1,W
133137,5,BEL1,2006-02-19,Club Brugge,Beveren,1,0,1,W
133138,5,BEL1,2006-02-19,Louvieroise,Germinal,1,1,0,D
133139,5,BEL1,2006-02-21,Roeselare,Charleroi,2,0,2,W
133140,5,BEL1,2006-02-22,FC Brussels,Westerlo,1,0,1,W
133141,5,BEL1,2006-02-22,Standard,Louvieroise,1,1,0,D
133142,5,BEL1,2006-02-24,Roeselare,Anderlecht,0,2,-2,L
133143,5,BEL1,2006-02-25,Beveren,Lokeren,1,3,-2,L
133144,5,BEL1,2006-02-25,Genk,Louvieroise,1,0,1,W
133145,5,BEL1,2006-02-25,Germinal,Cercle Brugge,0,0,0,D
133146,5,BEL1,2006-02-25,Lierse,Westerlo,2,1,1,W
133147,5,BEL1,2006-02-25,Mouscron,Waregem,0,1,-1,L
133148,5,BEL1,2006-02-25,St Truiden,Charleroi,1,1,0,D
133149,5,BEL1,2006-02-26,Club Brugge,Standard,1,1,0,D
133150,5,BEL1,2006-02-26,FC Brussels,Gent,0,1,-1,L
133151,5,BEL1,2006-03-03,Charleroi,Beveren,4,0,4,W
133152,5,BEL1,2006-03-04,Cercle Brugge,Genk,1,1,0,D
133153,5,BEL1,2006-03-04,Gent,Roeselare,1,2,-1,L
133154,5,BEL1,2006-03-04,Lokeren,Club Brugge,2,0,2,W
133155,5,BEL1,2006-03-04,Louvieroise,Mouscron,0,0,0,D
133156,5,BEL1,2006-03-04,Waregem,FC Brussels,0,0,0,D
133157,5,BEL1,2006-03-04,Westerlo,St Truiden,2,1,1,W
133158,5,BEL1,2006-03-05,Anderlecht,Lierse,3,0,3,W
133159,5,BEL1,2006-03-05,Standard,Germinal,3,1,2,W
133160,5,BEL1,2006-03-10,St Truiden,Anderlecht,3,0,3,W
133161,5,BEL1,2006-03-11,Beveren,Westerlo,4,1,3,W
133162,5,BEL1,2006-03-11,Club Brugge,Charleroi,2,1,1,W
133163,5,BEL1,2006-03-11,FC Brussels,Louvieroise,0,0,0,D
133164,5,BEL1,2006-03-11,Genk,Germinal,1,0,1,W
133165,5,BEL1,2006-03-11,Lierse,Gent,1,3,-2,L
133166,5,BEL1,2006-03-11,Mouscron,Cercle Brugge,6,0,6,W
133167,5,BEL1,2006-03-11,Roeselare,Waregem,0,3,-3,L
133168,5,BEL1,2006-03-12,Lokeren,Standard,0,0,0,D
133169,5,BEL1,2006-03-17,Standard,Genk,1,0,1,W
133170,5,BEL1,2006-03-17,Waregem,Lierse,0,1,-1,L
133171,5,BEL1,2006-03-18,Anderlecht,Beveren,4,0,4,W
133172,5,BEL1,2006-03-18,Cercle Brugge,FC Brussels,0,1,-1,L
133173,5,BEL1,2006-03-18,Charleroi,Lokeren,3,1,2,W
133174,5,BEL1,2006-03-18,Germinal,Mouscron,1,0,1,W
133175,5,BEL1,2006-03-18,Louvieroise,Roeselare,0,0,0,D
133176,5,BEL1,2006-03-18,Westerlo,Club Brugge,0,0,0,D
133177,5,BEL1,2006-03-19,Gent,St Truiden,1,0,1,W
133178,5,BEL1,2006-03-24,Charleroi,Standard,0,0,0,D
133179,5,BEL1,2006-03-25,Beveren,Gent,0,1,-1,L
133180,5,BEL1,2006-03-25,FC Brussels,Germinal,0,1,-1,L
133181,5,BEL1,2006-03-25,Lierse,Louvieroise,0,0,0,D
133182,5,BEL1,2006-03-25,Lokeren,Westerlo,3,2,1,W
133183,5,BEL1,2006-03-25,St Truiden,Waregem,2,0,2,W
133184,5,BEL1,2006-03-26,Club Brugge,Anderlecht,0,2,-2,L
133185,5,BEL1,2006-03-26,Mouscron,Genk,1,0,1,W
133186,5,BEL1,2006-03-26,Roeselare,Cercle Brugge,1,0,1,W
133187,5,BEL1,2006-03-31,Anderlecht,Lokeren,1,1,0,D
133188,5,BEL1,2006-04-01,Cercle Brugge,Lierse,3,0,3,W
133189,5,BEL1,2006-04-01,Genk,FC Brussels,1,0,1,W
133190,5,BEL1,2006-04-01,Gent,Club Brugge,4,1,3,W
133191,5,BEL1,2006-04-01,Germinal,Roeselare,2,2,0,D
133192,5,BEL1,2006-04-01,Louvieroise,St Truiden,0,2,-2,L
133193,5,BEL1,2006-04-01,Standard,Mouscron,2,1,1,W
133194,5,BEL1,2006-04-01,Waregem,Beveren,2,2,0,D
133195,5,BEL1,2006-04-02,Westerlo,Charleroi,1,1,0,D
133196,5,BEL1,2006-04-07,Charleroi,Anderlecht,1,1,0,D
133197,5,BEL1,2006-04-07,Club Brugge,Waregem,2,1,1,W
133198,5,BEL1,2006-04-08,Beveren,Louvieroise,1,0,1,W
133199,5,BEL1,2006-04-08,FC Brussels,Mouscron,0,1,-1,L
133200,5,BEL1,2006-04-08,Lierse,Germinal,0,2,-2,L
133201,5,BEL1,2006-04-08,Lokeren,Gent,1,2,-1,L
133202,5,BEL1,2006-04-08,St Truiden,Cercle Brugge,1,1,0,D
133203,5,BEL1,2006-04-08,Westerlo,Standard,0,2,-2,L
133204,5,BEL1,2006-04-09,Roeselare,Genk,1,2,-1,L
133205,5,BEL1,2006-04-14,Anderlecht,Westerlo,5,0,5,W
133206,5,BEL1,2006-04-15,Cercle Brugge,Beveren,1,1,0,D
133207,5,BEL1,2006-04-15,Genk,Lierse,1,0,1,W
133208,5,BEL1,2006-04-15,Gent,Charleroi,2,2,0,D
133209,5,BEL1,2006-04-15,Germinal,St Truiden,4,0,4,W
133210,5,BEL1,2006-04-15,Mouscron,Roeselare,0,1,-1,L
133211,5,BEL1,2006-04-16,Louvieroise,Club Brugge,0,1,-1,L
133212,5,BEL1,2006-04-16,Standard,FC Brussels,1,0,1,W
133213,5,BEL1,2006-04-16,Waregem,Lokeren,1,1,0,D
133214,5,BEL1,2006-04-21,Anderlecht,Standard,2,0,2,W
133215,5,BEL1,2006-04-22,Beveren,Germinal,0,0,0,D
133216,5,BEL1,2006-04-22,Charleroi,Waregem,2,0,2,W
133217,5,BEL1,2006-04-22,Lierse,Mouscron,2,0,2,W
133218,5,BEL1,2006-04-22,Lokeren,Louvieroise,3,2,1,W
133219,5,BEL1,2006-04-22,Roeselare,FC Brussels,0,1,-1,L
133220,5,BEL1,2006-04-22,St Truiden,Genk,2,2,0,D
133221,5,BEL1,2006-04-23,Club Brugge,Cercle Brugge,2,0,2,W
133222,5,BEL1,2006-04-23,Westerlo,Gent,0,1,-1,L
133223,5,BEL1,2006-04-30,Cercle Brugge,Lokeren,2,0,2,W
133224,5,BEL1,2006-04-30,FC Brussels,Lierse,2,1,1,W
133225,5,BEL1,2006-04-30,Genk,Beveren,2,0,2,W
133226,5,BEL1,2006-04-30,Gent,Anderlecht,0,0,0,D
133227,5,BEL1,2006-04-30,Germinal,Club Brugge,1,1,0,D
133228,5,BEL1,2006-04-30,Louvieroise,Charleroi,2,2,0,D
133229,5,BEL1,2006-04-30,Mouscron,St Truiden,3,0,3,W
133230,5,BEL1,2006-04-30,Roeselare,Standard,0,0,0,D
133231,5,BEL1,2006-04-30,Waregem,Westerlo,1,2,-1,L
133232,5,BEL1,2006-05-05,Anderlecht,Waregem,3,0,3,W
133233,5,BEL1,2006-05-05,Beveren,Mouscron,1,0,1,W
133234,5,BEL1,2006-05-05,Charleroi,Cercle Brugge,0,1,-1,L
133235,5,BEL1,2006-05-05,Club Brugge,Genk,3,0,3,W
133236,5,BEL1,2006-05-05,Lierse,Roeselare,1,0,1,W
133237,5,BEL1,2006-05-05,Lokeren,Germinal,1,2,-1,L
133238,5,BEL1,2006-05-05,St Truiden,FC Brussels,0,1,-1,L
133239,5,BEL1,2006-05-05,Standard,Gent,0,2,-2,L
133240,5,BEL1,2006-05-05,Westerlo,Louvieroise,2,1,1,W
133241,6,BEL1,2006-07-28,Club Brugge,Gent,5,0,5,W
133242,6,BEL1,2006-07-29,Charleroi,Lierse,0,0,0,D
133243,6,BEL1,2006-07-29,FC Brussels,Bergen,1,0,1,W
133244,6,BEL1,2006-07-29,Genk,Waregem,3,1,2,W
133245,6,BEL1,2006-07-29,Germinal,Beveren,1,0,1,W
133246,6,BEL1,2006-07-29,Mouscron,Cercle Brugge,2,1,1,W
133247,6,BEL1,2006-07-30,Lokeren,Standard,2,1,1,W
133248,6,BEL1,2006-07-30,St Truiden,Anderlecht,2,4,-2,L
133249,6,BEL1,2006-07-30,Westerlo,Roeselare,2,1,1,W
133250,6,BEL1,2006-08-04,Standard,Charleroi,1,2,-1,L
133251,6,BEL1,2006-08-05,Anderlecht,Germinal,1,0,1,W
133252,6,BEL1,2006-08-05,Bergen,St Truiden,2,0,2,W
133253,6,BEL1,2006-08-05,Beveren,Westerlo,0,3,-3,L
133254,6,BEL1,2006-08-05,Cercle Brugge,Lokeren,0,0,0,D
133255,6,BEL1,2006-08-05,Gent,Mouscron,1,3,-2,L
133256,6,BEL1,2006-08-05,Lierse,Genk,0,3,-3,L
133257,6,BEL1,2006-08-05,Waregem,FC Brussels,0,1,-1,L
133258,6,BEL1,2006-08-06,Roeselare,Club Brugge,3,2,1,W
133259,6,BEL1,2006-08-19,Charleroi,Cercle Brugge,2,1,1,W
133260,6,BEL1,2006-08-19,Club Brugge,Beveren,2,0,2,W
133261,6,BEL1,2006-08-19,FC Brussels,St Truiden,2,2,0,D
133262,6,BEL1,2006-08-19,Genk,Standard,1,1,0,D
133263,6,BEL1,2006-08-19,Germinal,Bergen,2,1,1,W
133264,6,BEL1,2006-08-19,Mouscron,Roeselare,2,2,0,D
133265,6,BEL1,2006-08-19,Waregem,Lierse,2,1,1,W
133266,6,BEL1,2006-08-20,Lokeren,Gent,1,1,0,D
133267,6,BEL1,2006-08-20,Westerlo,Anderlecht,3,4,-1,L
133268,6,BEL1,2006-08-26,Bergen,Westerlo,1,1,0,D
133269,6,BEL1,2006-08-26,Beveren,Mouscron,3,1,2,W
133270,6,BEL1,2006-08-26,Cercle Brugge,Genk,0,1,-1,L
133271,6,BEL1,2006-08-26,Lierse,FC Brussels,0,1,-1,L
133272,6,BEL1,2006-08-26,St Truiden,Germinal,2,0,2,W
133273,6,BEL1,2006-08-26,Standard,Waregem,1,1,0,D
133274,6,BEL1,2006-08-27,Anderlecht,Club Brugge,1,0,1,W
133275,6,BEL1,2006-08-27,Gent,Charleroi,2,1,1,W
133276,6,BEL1,2006-08-27,Roeselare,Lokeren,2,2,0,D
133277,6,BEL1,2006-09-09,Charleroi,Roeselare,2,1,1,W
133278,6,BEL1,2006-09-09,Club Brugge,Bergen,0,0,0,D
133279,6,BEL1,2006-09-09,FC Brussels,Germinal,1,2,-1,L
133280,6,BEL1,2006-09-09,Lierse,Standard,1,3,-2,L
133281,6,BEL1,2006-09-09,Mouscron,Anderlecht,1,1,0,D
133282,6,BEL1,2006-09-09,Waregem,Cercle Brugge,1,2,-1,L
133283,6,BEL1,2006-09-09,Westerlo,St Truiden,1,0,1,W
133284,6,BEL1,2006-09-10,Genk,Gent,3,1,2,W
133285,6,BEL1,2006-09-10,Lokeren,Beveren,2,0,2,W
133286,6,BEL1,2006-09-16,Anderlecht,Lokeren,2,0,2,W
133287,6,BEL1,2006-09-16,Bergen,Mouscron,1,0,1,W
133288,6,BEL1,2006-09-16,Beveren,Charleroi,2,2,0,D
133289,6,BEL1,2006-09-16,Cercle Brugge,Lierse,2,1,1,W
133290,6,BEL1,2006-09-16,Germinal,Westerlo,0,0,0,D
133291,6,BEL1,2006-09-17,Gent,Waregem,1,1,0,D
133292,6,BEL1,2006-09-17,Roeselare,Genk,3,3,0,D
133293,6,BEL1,2006-09-17,St Truiden,Club Brugge,2,3,-1,L
133294,6,BEL1,2006-09-17,Standard,FC Brussels,2,1,1,W
133295,6,BEL1,2006-09-22,Charleroi,Anderlecht,1,1,0,D
133296,6,BEL1,2006-09-23,Club Brugge,Germinal,1,0,1,W
133297,6,BEL1,2006-09-23,FC Brussels,Westerlo,0,1,-1,L
133298,6,BEL1,2006-09-23,Genk,Beveren,1,0,1,W
133299,6,BEL1,2006-09-23,Lierse,Gent,1,4,-3,L
133300,6,BEL1,2006-09-23,Lokeren,Bergen,0,2,-2,L
133301,6,BEL1,2006-09-23,Mouscron,St Truiden,1,0,1,W
133302,6,BEL1,2006-09-23,Standard,Cercle Brugge,1,0,1,W
133303,6,BEL1,2006-09-24,Waregem,Roeselare,4,2,2,W
133304,6,BEL1,2006-09-30,Anderlecht,Genk,1,4,-3,L
133305,6,BEL1,2006-09-30,Bergen,Charleroi,1,2,-1,L
133306,6,BEL1,2006-09-30,Cercle Brugge,FC Brussels,1,0,1,W
133307,6,BEL1,2006-09-30,Germinal,Mouscron,6,2,4,W
133308,6,BEL1,2006-09-30,Roeselare,Lierse,2,0,2,W
133309,6,BEL1,2006-09-30,St Truiden,Lokeren,1,0,1,W
133310,6,BEL1,2006-10-01,Beveren,Waregem,1,0,1,W
133311,6,BEL1,2006-10-01,Gent,Standard,2,1,1,W
133312,6,BEL1,2006-10-01,Westerlo,Club Brugge,1,2,-1,L
133313,6,BEL1,2006-10-14,Cercle Brugge,Gent,0,1,-1,L
133314,6,BEL1,2006-10-14,Charleroi,St Truiden,2,1,1,W
133315,6,BEL1,2006-10-14,Lierse,Beveren,0,1,-1,L
133316,6,BEL1,2006-10-14,Lokeren,Germinal,0,0,0,D
133317,6,BEL1,2006-10-14,Mouscron,Westerlo,4,0,4,W
133318,6,BEL1,2006-10-14,Standard,Roeselare,2,1,1,W
133319,6,BEL1,2006-10-14,Waregem,Anderlecht,0,4,-4,L
133320,6,BEL1,2006-10-15,FC Brussels,Club Brugge,1,1,0,D
133321,6,BEL1,2006-10-15,Genk,Bergen,5,1,4,W
133322,6,BEL1,2006-10-27,Club Brugge,Mouscron,5,1,4,W
133323,6,BEL1,2006-10-28,Anderlecht,Lierse,2,0,2,W
133324,6,BEL1,2006-10-28,Bergen,Waregem,0,0,0,D
133325,6,BEL1,2006-10-28,Beveren,Standard,0,3,-3,L
133326,6,BEL1,2006-10-28,Gent,FC Brussels,3,3,0,D
133327,6,BEL1,2006-10-28,Germinal,Charleroi,1,1,0,D
133328,6,BEL1,2006-10-28,Roeselare,Cercle Brugge,1,0,1,W
133329,6,BEL1,2006-10-28,Westerlo,Lokeren,4,1,3,W
133330,6,BEL1,2006-10-29,St Truiden,Genk,1,2,-1,L
133331,6,BEL1,2006-11-03,Genk,Germinal,4,0,4,W
133332,6,BEL1,2006-11-04,Cercle Brugge,Beveren,2,2,0,D
133333,6,BEL1,2006-11-04,FC Brussels,Mouscron,1,1,0,D
133334,6,BEL1,2006-11-04,Gent,Roeselare,2,0,2,W
133335,6,BEL1,2006-11-04,Lierse,Bergen,0,0,0,D
133336,6,BEL1,2006-11-05,Charleroi,Westerlo,1,2,-1,L
133337,6,BEL1,2006-11-05,Lokeren,Club Brugge,3,2,1,W
133338,6,BEL1,2006-11-05,Standard,Anderlecht,0,0,0,D
133339,6,BEL1,2006-11-05,Waregem,St Truiden,3,0,3,W
133340,6,BEL1,2006-11-10,Westerlo,Genk,0,1,-1,L
133341,6,BEL1,2006-11-11,Anderlecht,Cercle Brugge,2,0,2,W
133342,6,BEL1,2006-11-11,Beveren,Gent,1,0,1,W
133343,6,BEL1,2006-11-11,Club Brugge,Charleroi,2,0,2,W
133344,6,BEL1,2006-11-11,Germinal,Waregem,1,1,0,D
133345,6,BEL1,2006-11-11,Mouscron,Lokeren,1,1,0,D
133346,6,BEL1,2006-11-11,Roeselare,FC Brussels,1,1,0,D
133347,6,BEL1,2006-11-11,St Truiden,Lierse,4,0,4,W
133348,6,BEL1,2006-11-12,Bergen,Standard,2,3,-1,L
133349,6,BEL1,2006-11-18,Cercle Brugge,Bergen,3,0,3,W
133350,6,BEL1,2006-11-18,FC Brussels,Lokeren,0,0,0,D
133351,6,BEL1,2006-11-18,Gent,Anderlecht,2,1,1,W
133352,6,BEL1,2006-11-18,Lierse,Germinal,2,3,-1,L
133353,6,BEL1,2006-11-18,Roeselare,Beveren,2,1,1,W
133354,6,BEL1,2006-11-18,Standard,St Truiden,1,2,-1,L
133355,6,BEL1,2006-11-18,Waregem,Westerlo,2,2,0,D
133356,6,BEL1,2006-11-19,Charleroi,Mouscron,1,0,1,W
133357,6,BEL1,2006-11-19,Genk,Club Brugge,0,0,0,D
133358,6,BEL1,2006-11-24,Germinal,Standard,1,3,-2,L
133359,6,BEL1,2006-11-25,Bergen,Gent,0,1,-1,L
133360,6,BEL1,2006-11-25,Beveren,FC Brussels,2,2,0,D
133361,6,BEL1,2006-11-25,Lokeren,Charleroi,0,0,0,D
133362,6,BEL1,2006-11-25,Mouscron,Genk,2,2,0,D
133363,6,BEL1,2006-11-25,St Truiden,Cercle Brugge,2,0,2,W
133364,6,BEL1,2006-11-25,Westerlo,Lierse,2,0,2,W
133365,6,BEL1,2006-11-26,Anderlecht,Roeselare,3,2,1,W
133366,6,BEL1,2006-11-26,Club Brugge,Waregem,4,1,3,W
133367,6,BEL1,2006-12-01,Beveren,Anderlecht,1,1,0,D
133368,6,BEL1,2006-12-02,Cercle Brugge,Germinal,1,2,-1,L
133369,6,BEL1,2006-12-02,FC Brussels,Charleroi,0,2,-2,L
133370,6,BEL1,2006-12-02,Genk,Lokeren,1,0,1,W
133371,6,BEL1,2006-12-02,Gent,St Truiden,3,1,2,W
133372,6,BEL1,2006-12-02,Roeselare,Bergen,2,1,1,W
133373,6,BEL1,2006-12-02,Standard,Westerlo,3,0,3,W
133374,6,BEL1,2006-12-02,Waregem,Mouscron,0,0,0,D
133375,6,BEL1,2006-12-03,Lierse,Club Brugge,1,2,-1,L
133376,6,BEL1,2006-12-08,Charleroi,Genk,4,1,3,W
133377,6,BEL1,2006-12-09,Bergen,Beveren,1,0,1,W
133378,6,BEL1,2006-12-09,Germinal,Gent,0,3,-3,L
133379,6,BEL1,2006-12-09,Lokeren,Waregem,0,2,-2,L
133380,6,BEL1,2006-12-09,Mouscron,Lierse,2,2,0,D
133381,6,BEL1,2006-12-09,St Truiden,Roeselare,1,1,0,D
133382,6,BEL1,2006-12-09,Westerlo,Cercle Brugge,0,0,0,D
133383,6,BEL1,2006-12-10,Club Brugge,Standard,4,4,0,D
133384,6,BEL1,2006-12-10,FC Brussels,Anderlecht,0,1,-1,L
133385,6,BEL1,2006-12-15,Standard,Mouscron,2,0,2,W
133386,6,BEL1,2006-12-16,Anderlecht,Bergen,4,1,3,W
133387,6,BEL1,2006-12-16,Beveren,St Truiden,1,2,-1,L
133388,6,BEL1,2006-12-16,Genk,FC Brussels,3,1,2,W
133389,6,BEL1,2006-12-16,Gent,Westerlo,2,0,2,W
133390,6,BEL1,2006-12-16,Lierse,Lokeren,1,0,1,W
133391,6,BEL1,2006-12-16,Roeselare,Germinal,1,1,0,D
133392,6,BEL1,2006-12-17,Cercle Brugge,Club Brugge,1,0,1,W
133393,6,BEL1,2006-12-17,Waregem,Charleroi,1,0,1,W
133394,6,BEL1,2007-01-19,Waregem,Genk,2,2,0,D
133395,6,BEL1,2007-01-20,Anderlecht,St Truiden,2,0,2,W
133396,6,BEL1,2007-01-20,Bergen,FC Brussels,1,1,0,D
133397,6,BEL1,2007-01-20,Beveren,Germinal,1,1,0,D
133398,6,BEL1,2007-01-20,Cercle Brugge,Mouscron,2,1,1,W
133399,6,BEL1,2007-01-20,Lierse,Charleroi,2,1,1,W
133400,6,BEL1,2007-01-20,Roeselare,Westerlo,2,0,2,W
133401,6,BEL1,2007-01-21,Gent,Club Brugge,0,0,0,D
133402,6,BEL1,2007-01-21,Standard,Lokeren,3,1,2,W
133403,6,BEL1,2007-01-26,Charleroi,Standard,2,5,-3,L
133404,6,BEL1,2007-01-27,Club Brugge,Roeselare,0,1,-1,L
133405,6,BEL1,2007-01-27,FC Brussels,Waregem,2,0,2,W
133406,6,BEL1,2007-01-27,Genk,Lierse,3,0,3,W
133407,6,BEL1,2007-01-27,Lokeren,Cercle Brugge,2,0,2,W
133408,6,BEL1,2007-01-27,Mouscron,Gent,0,3,-3,L
133409,6,BEL1,2007-01-27,St Truiden,Bergen,1,0,1,W
133410,6,BEL1,2007-01-27,Westerlo,Beveren,2,0,2,W
133411,6,BEL1,2007-01-28,Germinal,Anderlecht,1,3,-2,L
133412,6,BEL1,2007-02-02,Beveren,Club Brugge,0,2,-2,L
133413,6,BEL1,2007-02-03,Anderlecht,Westerlo,1,0,1,W
133414,6,BEL1,2007-02-03,Bergen,Germinal,2,1,1,W
133415,6,BEL1,2007-02-03,Cercle Brugge,Charleroi,0,0,0,D
133416,6,BEL1,2007-02-03,Gent,Lokeren,3,1,2,W
133417,6,BEL1,2007-02-03,Lierse,Waregem,1,0,1,W
133418,6,BEL1,2007-02-03,Roeselare,Mouscron,2,1,1,W
133419,6,BEL1,2007-02-03,St Truiden,FC Brussels,2,2,0,D
133420,6,BEL1,2007-02-04,Standard,Genk,2,1,1,W
133421,6,BEL1,2007-02-10,FC Brussels,Lierse,2,1,1,W
133422,6,BEL1,2007-02-10,Genk,Cercle Brugge,3,0,3,W
133423,6,BEL1,2007-02-10,Germinal,St Truiden,3,2,1,W
133424,6,BEL1,2007-02-10,Lokeren,Roeselare,1,1,0,D
133425,6,BEL1,2007-02-10,Mouscron,Beveren,4,2,2,W
133426,6,BEL1,2007-02-10,Waregem,Standard,3,1,2,W
133427,6,BEL1,2007-02-10,Westerlo,Bergen,2,1,1,W
133428,6,BEL1,2007-02-11,Charleroi,Gent,1,0,1,W
133429,6,BEL1,2007-02-11,Club Brugge,Anderlecht,2,2,0,D
133430,6,BEL1,2007-02-16,Bergen,Club Brugge,1,0,1,W
133431,6,BEL1,2007-02-17,Anderlecht,Mouscron,2,1,1,W
133432,6,BEL1,2007-02-17,Beveren,Lokeren,3,2,1,W
133433,6,BEL1,2007-02-17,Germinal,FC Brussels,3,0,3,W
133434,6,BEL1,2007-02-17,Roeselare,Charleroi,1,2,-1,L
133435,6,BEL1,2007-02-17,St Truiden,Westerlo,0,2,-2,L
133436,6,BEL1,2007-02-17,Standard,Lierse,3,2,1,W
133437,6,BEL1,2007-02-18,Cercle Brugge,Waregem,2,0,2,W
133438,6,BEL1,2007-02-18,Gent,Genk,1,3,-2,L
133439,6,BEL1,2007-02-23,Club Brugge,St Truiden,1,0,1,W
133440,6,BEL1,2007-02-24,Charleroi,Beveren,2,1,1,W
133441,6,BEL1,2007-02-24,FC Brussels,Standard,0,3,-3,L
133442,6,BEL1,2007-02-24,Genk,Roeselare,3,0,3,W
133443,6,BEL1,2007-02-24,Lierse,Cercle Brugge,0,2,-2,L
133444,6,BEL1,2007-02-24,Mouscron,Bergen,2,2,0,D
133445,6,BEL1,2007-02-24,Westerlo,Germinal,1,1,0,D
133446,6,BEL1,2007-02-25,Lokeren,Anderlecht,1,1,0,D
133447,6,BEL1,2007-02-25,Waregem,Gent,3,2,1,W
133448,6,BEL1,2007-03-02,Roeselare,Waregem,3,1,2,W
133449,6,BEL1,2007-03-03,Anderlecht,Charleroi,3,2,1,W
133450,6,BEL1,2007-03-03,Bergen,Lokeren,1,0,1,W
133451,6,BEL1,2007-03-03,Beveren,Genk,0,5,-5,L
133452,6,BEL1,2007-03-03,Cercle Brugge,Standard,0,2,-2,L
133453,6,BEL1,2007-03-03,Gent,Lierse,4,0,4,W
133454,6,BEL1,2007-03-03,St Truiden,Mouscron,1,1,0,D
133455,6,BEL1,2007-03-03,Westerlo,FC Brussels,1,1,0,D
133456,6,BEL1,2007-03-04,Germinal,Club Brugge,4,0,4,W
133457,6,BEL1,2007-03-09,Charleroi,Bergen,1,0,1,W
133458,6,BEL1,2007-03-10,Club Brugge,Westerlo,2,0,2,W
133459,6,BEL1,2007-03-10,FC Brussels,Cercle Brugge,0,0,0,D
133460,6,BEL1,2007-03-10,Lierse,Roeselare,3,1,2,W
133461,6,BEL1,2007-03-10,Lokeren,St Truiden,1,1,0,D
133462,6,BEL1,2007-03-10,Mouscron,Germinal,1,0,1,W
133463,6,BEL1,2007-03-10,Standard,Gent,0,1,-1,L
133464,6,BEL1,2007-03-10,Waregem,Beveren,2,1,1,W
133465,6,BEL1,2007-03-11,Genk,Anderlecht,1,1,0,D
133466,6,BEL1,2007-03-16,Germinal,Lokeren,1,2,-1,L
133467,6,BEL1,2007-03-17,Anderlecht,Waregem,0,0,0,D
133468,6,BEL1,2007-03-17,Bergen,Genk,5,0,5,W
133469,6,BEL1,2007-03-17,Beveren,Lierse,1,1,0,D
133470,6,BEL1,2007-03-17,Club Brugge,FC Brussels,4,1,3,W
133471,6,BEL1,2007-03-17,St Truiden,Charleroi,1,1,0,D
133472,6,BEL1,2007-03-17,Westerlo,Mouscron,1,0,1,W
133473,6,BEL1,2007-03-18,Gent,Cercle Brugge,0,2,-2,L
133474,6,BEL1,2007-03-18,Roeselare,Standard,2,3,-1,L
133475,6,BEL1,2007-03-30,FC Brussels,Gent,1,1,0,D
133476,6,BEL1,2007-03-31,Cercle Brugge,Roeselare,1,1,0,D
133477,6,BEL1,2007-03-31,Charleroi,Germinal,3,3,0,D
133478,6,BEL1,2007-03-31,Lierse,Anderlecht,1,4,-3,L
133479,6,BEL1,2007-03-31,Lokeren,Westerlo,1,1,0,D
133480,6,BEL1,2007-03-31,Standard,Beveren,0,0,0,D
133481,6,BEL1,2007-03-31,Waregem,Bergen,1,2,-1,L
133482,6,BEL1,2007-04-01,Genk,St Truiden,2,0,2,W
133483,6,BEL1,2007-04-01,Mouscron,Club Brugge,2,1,1,W
133484,6,BEL1,2007-04-06,Anderlecht,Standard,1,0,1,W
133485,6,BEL1,2007-04-07,Bergen,Lierse,1,1,0,D
133486,6,BEL1,2007-04-07,Beveren,Cercle Brugge,1,1,0,D
133487,6,BEL1,2007-04-07,Club Brugge,Lokeren,2,2,0,D
133488,6,BEL1,2007-04-07,Mouscron,FC Brussels,2,2,0,D
133489,6,BEL1,2007-04-07,Roeselare,Gent,1,3,-2,L
133490,6,BEL1,2007-04-07,St Truiden,Waregem,2,2,0,D
133491,6,BEL1,2007-04-08,Germinal,Genk,2,1,1,W
133492,6,BEL1,2007-04-08,Westerlo,Charleroi,0,1,-1,L
133493,6,BEL1,2007-04-13,Cercle Brugge,Anderlecht,0,1,-1,L
133494,6,BEL1,2007-04-14,FC Brussels,Roeselare,6,2,4,W
133495,6,BEL1,2007-04-14,Genk,Westerlo,3,1,2,W
133496,6,BEL1,2007-04-14,Lierse,St Truiden,0,0,0,D
133497,6,BEL1,2007-04-14,Lokeren,Mouscron,1,1,0,D
133498,6,BEL1,2007-04-14,Standard,Bergen,1,0,1,W
133499,6,BEL1,2007-04-14,Waregem,Germinal,0,2,-2,L
133500,6,BEL1,2007-04-15,Charleroi,Club Brugge,1,1,0,D
133501,6,BEL1,2007-04-15,Gent,Beveren,2,1,1,W
133502,6,BEL1,2007-04-20,Germinal,Lierse,2,3,-1,L
133503,6,BEL1,2007-04-21,Bergen,Cercle Brugge,1,0,1,W
133504,6,BEL1,2007-04-21,Beveren,Roeselare,2,2,0,D
133505,6,BEL1,2007-04-21,Lokeren,FC Brussels,0,0,0,D
133506,6,BEL1,2007-04-21,Mouscron,Charleroi,2,1,1,W
133507,6,BEL1,2007-04-21,St Truiden,Standard,0,3,-3,L
133508,6,BEL1,2007-04-21,Westerlo,Waregem,4,2,2,W
133509,6,BEL1,2007-04-22,Anderlecht,Gent,1,0,1,W
133510,6,BEL1,2007-04-22,Club Brugge,Genk,0,1,-1,L
133511,6,BEL1,2007-04-27,Standard,Germinal,2,2,0,D
133512,6,BEL1,2007-04-28,Cercle Brugge,St Truiden,0,1,-1,L
133513,6,BEL1,2007-04-28,Charleroi,Lokeren,4,3,1,W
133514,6,BEL1,2007-04-28,FC Brussels,Beveren,2,0,2,W
133515,6,BEL1,2007-04-28,Gent,Bergen,4,1,3,W
133516,6,BEL1,2007-04-28,Lierse,Westerlo,1,1,0,D
133517,6,BEL1,2007-04-28,Waregem,Club Brugge,2,1,1,W
133518,6,BEL1,2007-04-29,Genk,Mouscron,3,2,1,W
133519,6,BEL1,2007-04-29,Roeselare,Anderlecht,0,5,-5,L
133520,6,BEL1,2007-05-04,Lokeren,Genk,0,1,-1,L
133521,6,BEL1,2007-05-05,Bergen,Roeselare,6,1,5,W
133522,6,BEL1,2007-05-05,Charleroi,FC Brussels,1,0,1,W
133523,6,BEL1,2007-05-05,Club Brugge,Lierse,4,0,4,W
133524,6,BEL1,2007-05-05,Germinal,Cercle Brugge,1,0,1,W
133525,6,BEL1,2007-05-05,Mouscron,Waregem,3,0,3,W
133526,6,BEL1,2007-05-05,St Truiden,Gent,0,1,-1,L
133527,6,BEL1,2007-05-06,Anderlecht,Beveren,8,1,7,W
133528,6,BEL1,2007-05-06,Westerlo,Standard,1,1,0,D
133529,6,BEL1,2007-05-11,Cercle Brugge,Westerlo,4,1,3,W
133530,6,BEL1,2007-05-12,Anderlecht,FC Brussels,6,0,6,W
133531,6,BEL1,2007-05-12,Beveren,Bergen,0,0,0,D
133532,6,BEL1,2007-05-12,Genk,Charleroi,0,2,-2,L
133533,6,BEL1,2007-05-12,Gent,Germinal,1,2,-1,L
133534,6,BEL1,2007-05-12,Lierse,Mouscron,3,3,0,D
133535,6,BEL1,2007-05-12,Roeselare,St Truiden,3,2,1,W
133536,6,BEL1,2007-05-12,Standard,Club Brugge,1,0,1,W
133537,6,BEL1,2007-05-12,Waregem,Lokeren,1,1,0,D
133538,6,BEL1,2007-05-18,Germinal,Roeselare,3,0,3,W
133539,6,BEL1,2007-05-19,Bergen,Anderlecht,3,1,2,W
133540,6,BEL1,2007-05-19,Charleroi,Waregem,2,1,1,W
133541,6,BEL1,2007-05-19,Club Brugge,Cercle Brugge,3,3,0,D
133542,6,BEL1,2007-05-19,FC Brussels,Genk,3,1,2,W
133543,6,BEL1,2007-05-19,Lokeren,Lierse,1,4,-3,L
133544,6,BEL1,2007-05-19,Mouscron,Standard,2,0,2,W
133545,6,BEL1,2007-05-19,St Truiden,Beveren,3,2,1,W
133546,6,BEL1,2007-05-19,Westerlo,Gent,1,1,0,D
133547,7,BEL1,2007-08-03,Mechelen,Anderlecht,0,1,-1,L
133548,7,BEL1,2007-08-04,Charleroi,Roeselare,1,1,0,D
133549,7,BEL1,2007-08-04,Club Brugge,Bergen,2,1,1,W
133550,7,BEL1,2007-08-04,Dender,Germinal,1,2,-1,L
133551,7,BEL1,2007-08-04,FC Brussels,Westerlo,0,1,-1,L
133552,7,BEL1,2007-08-04,Genk,Cercle Brugge,3,1,2,W
133553,7,BEL1,2007-08-04,Lokeren,St Truiden,2,1,1,W
133554,7,BEL1,2007-08-05,Mouscron,Gent,1,4,-3,L
133555,7,BEL1,2007-08-05,Waregem,Standard,1,4,-3,L
133556,7,BEL1,2007-08-10,Westerlo,Charleroi,1,0,1,W
133557,7,BEL1,2007-08-11,Anderlecht,Lokeren,1,0,1,W
133558,7,BEL1,2007-08-11,Bergen,Mechelen,1,1,0,D
133559,7,BEL1,2007-08-11,Cercle Brugge,Waregem,2,0,2,W
133560,7,BEL1,2007-08-11,Gent,Genk,5,0,5,W
133561,7,BEL1,2007-08-11,Roeselare,Dender,3,1,2,W
133562,7,BEL1,2007-08-11,St Truiden,Mouscron,0,2,-2,L
133563,7,BEL1,2007-08-11,Standard,FC Brussels,4,1,3,W
133564,7,BEL1,2007-08-12,Germinal,Club Brugge,0,1,-1,L
133565,7,BEL1,2007-08-17,Club Brugge,St Truiden,3,2,1,W
133566,7,BEL1,2007-08-18,Charleroi,Mechelen,1,0,1,W
133567,7,BEL1,2007-08-18,Dender,Anderlecht,2,2,0,D
133568,7,BEL1,2007-08-18,FC Brussels,Gent,0,2,-2,L
133569,7,BEL1,2007-08-18,Genk,Roeselare,0,0,0,D
133570,7,BEL1,2007-08-18,Lokeren,Germinal,0,0,0,D
133571,7,BEL1,2007-08-18,Mouscron,Bergen,3,1,2,W
133572,7,BEL1,2007-08-18,Waregem,Westerlo,1,0,1,W
133573,7,BEL1,2007-08-19,Standard,Cercle Brugge,4,1,3,W
133574,7,BEL1,2007-08-25,Anderlecht,FC Brussels,3,0,3,W
133575,7,BEL1,2007-08-25,Bergen,Lokeren,0,1,-1,L
133576,7,BEL1,2007-08-25,Cercle Brugge,Dender,3,0,3,W
133577,7,BEL1,2007-08-25,Gent,Waregem,1,1,0,D
133578,7,BEL1,2007-08-25,Germinal,Genk,1,2,-1,L
133579,7,BEL1,2007-08-25,Roeselare,Standard,0,4,-4,L
133580,7,BEL1,2007-08-25,Westerlo,Mouscron,0,2,-2,L
133581,7,BEL1,2007-08-26,St Truiden,Charleroi,1,3,-2,L
133582,7,BEL1,2007-08-27,Mechelen,Club Brugge,1,1,0,D
133583,7,BEL1,2007-08-31,Charleroi,Bergen,3,1,2,W
133584,7,BEL1,2007-09-01,Cercle Brugge,Gent,4,1,3,W
133585,7,BEL1,2007-09-01,Dender,St Truiden,1,0,1,W
133586,7,BEL1,2007-09-01,FC Brussels,Roeselare,0,0,0,D
133587,7,BEL1,2007-09-01,Genk,Westerlo,1,0,1,W
133588,7,BEL1,2007-09-01,Lokeren,Mechelen,3,1,2,W
133589,7,BEL1,2007-09-01,Waregem,Germinal,2,1,1,W
133590,7,BEL1,2007-09-02,Mouscron,Anderlecht,1,2,-1,L
133591,7,BEL1,2007-09-02,Standard,Club Brugge,2,1,1,W
133592,7,BEL1,2007-09-15,Anderlecht,Waregem,2,2,0,D
133593,7,BEL1,2007-09-15,Bergen,FC Brussels,2,1,1,W
133594,7,BEL1,2007-09-15,Club Brugge,Lokeren,1,1,0,D
133595,7,BEL1,2007-09-15,Germinal,Charleroi,1,0,1,W
133596,7,BEL1,2007-09-15,Mechelen,Mouscron,2,2,0,D
133597,7,BEL1,2007-09-15,Roeselare,Cercle Brugge,0,2,-2,L
133598,7,BEL1,2007-09-15,Westerlo,Dender,0,0,0,D
133599,7,BEL1,2007-09-16,Gent,Standard,1,1,0,D
133600,7,BEL1,2007-09-16,St Truiden,Genk,1,2,-1,L
133601,7,BEL1,2007-09-22,Cercle Brugge,Germinal,1,1,0,D
133602,7,BEL1,2007-09-22,Dender,Bergen,0,3,-3,L
133603,7,BEL1,2007-09-22,FC Brussels,St Truiden,2,0,2,W
133604,7,BEL1,2007-09-22,Gent,Roeselare,1,1,0,D
133605,7,BEL1,2007-09-22,Mouscron,Lokeren,2,0,2,W
133606,7,BEL1,2007-09-22,Waregem,Mechelen,2,0,2,W
133607,7,BEL1,2007-09-23,Charleroi,Club Brugge,1,1,0,D
133608,7,BEL1,2007-09-23,Genk,Anderlecht,1,1,0,D
133609,7,BEL1,2007-09-24,Standard,Westerlo,2,1,1,W
133610,7,BEL1,2007-09-28,Bergen,Genk,1,1,0,D
133611,7,BEL1,2007-09-29,Anderlecht,Charleroi,0,1,-1,L
133612,7,BEL1,2007-09-29,Club Brugge,Mouscron,1,0,1,W
133613,7,BEL1,2007-09-29,Lokeren,FC Brussels,0,1,-1,L
133614,7,BEL1,2007-09-29,Roeselare,Waregem,3,2,1,W
133615,7,BEL1,2007-09-29,St Truiden,Standard,0,0,0,D
133616,7,BEL1,2007-09-29,Westerlo,Cercle Brugge,1,1,0,D
133617,7,BEL1,2007-09-30,Germinal,Gent,2,2,0,D
133618,7,BEL1,2007-09-30,Mechelen,Dender,2,2,0,D
133619,7,BEL1,2007-10-05,Charleroi,Mouscron,1,3,-2,L
133620,7,BEL1,2007-10-06,Cercle Brugge,St Truiden,5,1,4,W
133621,7,BEL1,2007-10-06,Dender,Lokeren,0,1,-1,L
133622,7,BEL1,2007-10-06,Genk,Mechelen,2,1,1,W
133623,7,BEL1,2007-10-06,Gent,Westerlo,1,1,0,D
133624,7,BEL1,2007-10-06,Waregem,Bergen,2,1,1,W
133625,7,BEL1,2007-10-07,FC Brussels,Club Brugge,1,3,-2,L
133626,7,BEL1,2007-10-07,Roeselare,Anderlecht,2,2,0,D
133627,7,BEL1,2007-10-07,Standard,Germinal,3,1,2,W
133628,7,BEL1,2007-10-20,Club Brugge,Dender,2,0,2,W
133629,7,BEL1,2007-10-20,Germinal,FC Brussels,3,0,3,W
133630,7,BEL1,2007-10-20,Lokeren,Charleroi,1,0,1,W
133631,7,BEL1,2007-10-20,Mechelen,Cercle Brugge,0,4,-4,L
133632,7,BEL1,2007-10-20,Mouscron,Genk,1,1,0,D
133633,7,BEL1,2007-10-20,St Truiden,Waregem,2,1,1,W
133634,7,BEL1,2007-10-20,Westerlo,Roeselare,6,0,6,W
133635,7,BEL1,2007-10-21,Anderlecht,Gent,2,1,1,W
133636,7,BEL1,2007-10-21,Bergen,Standard,1,1,0,D
133637,7,BEL1,2007-10-26,Gent,Bergen,2,0,2,W
133638,7,BEL1,2007-10-27,Dender,Mouscron,0,3,-3,L
133639,7,BEL1,2007-10-27,FC Brussels,Charleroi,1,2,-1,L
133640,7,BEL1,2007-10-27,Roeselare,St Truiden,2,0,2,W
133641,7,BEL1,2007-10-27,Standard,Mechelen,2,2,0,D
133642,7,BEL1,2007-10-27,Waregem,Lokeren,1,1,0,D
133643,7,BEL1,2007-10-27,Westerlo,Germinal,1,2,-1,L
133644,7,BEL1,2007-10-28,Cercle Brugge,Anderlecht,0,0,0,D
133645,7,BEL1,2007-10-28,Genk,Club Brugge,1,2,-1,L
133646,7,BEL1,2007-11-02,Mouscron,Standard,0,0,0,D
133647,7,BEL1,2007-11-03,Anderlecht,Westerlo,3,1,2,W
133648,7,BEL1,2007-11-03,Bergen,Cercle Brugge,0,2,-2,L
133649,7,BEL1,2007-11-03,Charleroi,Dender,1,0,1,W
133650,7,BEL1,2007-11-03,Club Brugge,Waregem,1,0,1,W
133651,7,BEL1,2007-11-03,Germinal,Roeselare,2,0,2,W
133652,7,BEL1,2007-11-03,St Truiden,Gent,2,1,1,W
133653,7,BEL1,2007-11-04,Lokeren,Genk,1,1,0,D
133654,7,BEL1,2007-11-04,Mechelen,FC Brussels,4,0,4,W
133655,7,BEL1,2007-11-09,Cercle Brugge,Club Brugge,1,2,-1,L
133656,7,BEL1,2007-11-10,FC Brussels,Dender,4,1,3,W
133657,7,BEL1,2007-11-10,Genk,Charleroi,1,0,1,W
133658,7,BEL1,2007-11-10,Standard,Lokeren,1,0,1,W
133659,7,BEL1,2007-11-10,Waregem,Mouscron,2,1,1,W
133660,7,BEL1,2007-11-10,Westerlo,St Truiden,2,0,2,W
133661,7,BEL1,2007-11-11,Gent,Mechelen,4,1,3,W
133662,7,BEL1,2007-11-11,Germinal,Anderlecht,2,0,2,W
133663,7,BEL1,2007-11-12,Roeselare,Bergen,4,3,1,W
133664,7,BEL1,2007-11-30,Anderlecht,Standard,0,0,0,D
133665,7,BEL1,2007-12-01,Bergen,Westerlo,1,3,-2,L
133666,7,BEL1,2007-12-01,Charleroi,Waregem,2,3,-1,L
133667,7,BEL1,2007-12-01,Lokeren,Cercle Brugge,1,1,0,D
133668,7,BEL1,2007-12-01,Mechelen,Roeselare,4,3,1,W
133669,7,BEL1,2007-12-01,Mouscron,FC Brussels,1,1,0,D
133670,7,BEL1,2007-12-01,St Truiden,Germinal,0,3,-3,L
133671,7,BEL1,2007-12-02,Club Brugge,Gent,0,0,0,D
133672,7,BEL1,2007-12-02,Dender,Genk,2,0,2,W
133673,7,BEL1,2007-12-07,Standard,Charleroi,5,1,4,W
133674,7,BEL1,2007-12-08,Cercle Brugge,Mouscron,3,0,3,W
133675,7,BEL1,2007-12-08,FC Brussels,Genk,0,5,-5,L
133676,7,BEL1,2007-12-08,Gent,Lokeren,4,2,2,W
133677,7,BEL1,2007-12-08,Germinal,Bergen,2,0,2,W
133678,7,BEL1,2007-12-08,Waregem,Dender,1,2,-1,L
133679,7,BEL1,2007-12-08,Westerlo,Mechelen,1,1,0,D
133680,7,BEL1,2007-12-09,Roeselare,Club Brugge,1,2,-1,L
133681,7,BEL1,2007-12-09,St Truiden,Anderlecht,4,3,1,W
133682,7,BEL1,2007-12-14,Genk,Waregem,5,2,3,W
133683,7,BEL1,2007-12-15,Bergen,St Truiden,0,0,0,D
133684,7,BEL1,2007-12-15,Dender,Standard,0,0,0,D
133685,7,BEL1,2007-12-15,FC Brussels,Cercle Brugge,1,4,-3,L
133686,7,BEL1,2007-12-15,Lokeren,Westerlo,1,1,0,D
133687,7,BEL1,2007-12-15,Mechelen,Germinal,1,2,-1,L
133688,7,BEL1,2007-12-15,Mouscron,Roeselare,1,3,-2,L
133689,7,BEL1,2007-12-16,Charleroi,Gent,1,2,-1,L
133690,7,BEL1,2007-12-16,Club Brugge,Anderlecht,1,0,1,W
133691,7,BEL1,2007-12-22,Anderlecht,Bergen,3,2,1,W
133692,7,BEL1,2007-12-22,Gent,Dender,2,4,-2,L
133693,7,BEL1,2007-12-22,Germinal,Mouscron,3,0,3,W
133694,7,BEL1,2007-12-22,St Truiden,Mechelen,0,1,-1,L
133695,7,BEL1,2007-12-22,Waregem,FC Brussels,1,0,1,W
133696,7,BEL1,2007-12-23,Cercle Brugge,Charleroi,3,1,2,W
133697,7,BEL1,2007-12-23,Standard,Genk,3,1,2,W
133698,7,BEL1,2008-01-18,Bergen,Club Brugge,0,1,-1,L
133699,7,BEL1,2008-01-19,Anderlecht,Mechelen,1,0,1,W
133700,7,BEL1,2008-01-19,Germinal,Dender,1,0,1,W
133701,7,BEL1,2008-01-19,Roeselare,Charleroi,1,2,-1,L
133702,7,BEL1,2008-01-19,St Truiden,Lokeren,1,1,0,D
133703,7,BEL1,2008-01-19,Standard,Waregem,3,1,2,W
133704,7,BEL1,2008-01-19,Westerlo,FC Brussels,7,2,5,W
133705,7,BEL1,2008-01-20,Cercle Brugge,Genk,5,1,4,W
133706,7,BEL1,2008-01-20,Gent,Mouscron,2,0,2,W
133707,7,BEL1,2008-01-22,Roeselare,Lokeren,1,1,0,D
133708,7,BEL1,2008-01-22,Westerlo,Club Brugge,0,0,0,D
133709,7,BEL1,2008-01-25,Waregem,Cercle Brugge,0,3,-3,L
133710,7,BEL1,2008-01-26,Charleroi,Westerlo,1,1,0,D
133711,7,BEL1,2008-01-26,Club Brugge,Germinal,3,0,3,W
133712,7,BEL1,2008-01-26,Dender,Roeselare,2,1,1,W
133713,7,BEL1,2008-01-26,Genk,Gent,3,3,0,D
133714,7,BEL1,2008-01-26,Mechelen,Bergen,2,0,2,W
133715,7,BEL1,2008-01-26,Mouscron,St Truiden,0,0,0,D
133716,7,BEL1,2008-01-27,FC Brussels,Standard,0,1,-1,L
133717,7,BEL1,2008-01-27,Lokeren,Anderlecht,0,0,0,D
133718,7,BEL1,2008-02-02,Anderlecht,Dender,1,0,1,W
133719,7,BEL1,2008-02-02,Bergen,Mouscron,2,0,2,W
133720,7,BEL1,2008-02-02,Gent,FC Brussels,1,0,1,W
133721,7,BEL1,2008-02-02,Mechelen,Charleroi,1,0,1,W
133722,7,BEL1,2008-02-02,Roeselare,Genk,0,0,0,D
133723,7,BEL1,2008-02-02,Westerlo,Waregem,1,1,0,D
133724,7,BEL1,2008-02-03,Cercle Brugge,Standard,0,0,0,D
133725,7,BEL1,2008-02-03,Germinal,Lokeren,1,1,0,D
133726,7,BEL1,2008-02-03,St Truiden,Club Brugge,1,1,0,D
133727,7,BEL1,2008-02-09,Charleroi,St Truiden,1,1,0,D
133728,7,BEL1,2008-02-09,Club Brugge,Mechelen,2,0,2,W
133729,7,BEL1,2008-02-09,Dender,Cercle Brugge,2,4,-2,L
133730,7,BEL1,2008-02-09,FC Brussels,Anderlecht,2,4,-2,L
133731,7,BEL1,2008-02-09,Lokeren,Bergen,1,2,-1,L
133732,7,BEL1,2008-02-09,Mouscron,Westerlo,1,2,-1,L
133733,7,BEL1,2008-02-09,Standard,Roeselare,0,0,0,D
133734,7,BEL1,2008-02-10,Genk,Germinal,1,3,-2,L
133735,7,BEL1,2008-02-10,Waregem,Gent,2,1,1,W
133736,7,BEL1,2008-02-15,Gent,Cercle Brugge,3,2,1,W
133737,7,BEL1,2008-02-16,Bergen,Charleroi,0,0,0,D
133738,7,BEL1,2008-02-16,Germinal,Waregem,0,0,0,D
133739,7,BEL1,2008-02-16,Mechelen,Lokeren,1,1,0,D
133740,7,BEL1,2008-02-16,Roeselare,FC Brussels,2,0,2,W
133741,7,BEL1,2008-02-16,St Truiden,Dender,1,2,-1,L
133742,7,BEL1,2008-02-16,Westerlo,Genk,2,1,1,W
133743,7,BEL1,2008-02-17,Anderlecht,Mouscron,2,1,1,W
133744,7,BEL1,2008-02-17,Club Brugge,Standard,1,2,-1,L
133745,7,BEL1,2008-02-22,Genk,St Truiden,0,1,-1,L
133746,7,BEL1,2008-02-23,Cercle Brugge,Roeselare,0,0,0,D
133747,7,BEL1,2008-02-23,Charleroi,Germinal,0,0,0,D
133748,7,BEL1,2008-02-23,Dender,Westerlo,2,0,2,W
133749,7,BEL1,2008-02-23,FC Brussels,Bergen,1,1,0,D
133750,7,BEL1,2008-02-23,Mouscron,Mechelen,0,1,-1,L
133751,7,BEL1,2008-02-23,Standard,Gent,0,0,0,D
133752,7,BEL1,2008-02-24,Lokeren,Club Brugge,0,1,-1,L
133753,7,BEL1,2008-02-24,Waregem,Anderlecht,1,0,1,W
133754,7,BEL1,2008-02-29,Club Brugge,Charleroi,0,2,-2,L
133755,7,BEL1,2008-03-01,Bergen,Dender,2,2,0,D
133756,7,BEL1,2008-03-01,Lokeren,Mouscron,0,0,0,D
133757,7,BEL1,2008-03-01,Mechelen,Waregem,2,1,1,W
133758,7,BEL1,2008-03-01,Roeselare,Gent,0,1,-1,L
133759,7,BEL1,2008-03-01,St Truiden,FC Brussels,1,1,0,D
133760,7,BEL1,2008-03-01,Westerlo,Standard,1,3,-2,L
133761,7,BEL1,2008-03-02,Anderlecht,Genk,1,0,1,W
133762,7,BEL1,2008-03-02,Germinal,Cercle Brugge,3,0,3,W
133763,7,BEL1,2008-03-07,Standard,St Truiden,2,1,1,W
133764,7,BEL1,2008-03-08,Cercle Brugge,Westerlo,1,0,1,W
133765,7,BEL1,2008-03-08,Dender,Mechelen,0,3,-3,L
133766,7,BEL1,2008-03-08,FC Brussels,Lokeren,2,0,2,W
133767,7,BEL1,2008-03-08,Genk,Bergen,1,2,-1,L
133768,7,BEL1,2008-03-08,Mouscron,Club Brugge,2,0,2,W
133769,7,BEL1,2008-03-08,Waregem,Roeselare,3,1,2,W
133770,7,BEL1,2008-03-09,Charleroi,Anderlecht,0,2,-2,L
133771,7,BEL1,2008-03-09,Gent,Germinal,2,1,1,W
133772,7,BEL1,2008-03-14,Germinal,Standard,1,2,-1,L
133773,7,BEL1,2008-03-15,Bergen,Waregem,3,0,3,W
133774,7,BEL1,2008-03-15,Club Brugge,FC Brussels,1,0,1,W
133775,7,BEL1,2008-03-15,Lokeren,Dender,1,0,1,W
133776,7,BEL1,2008-03-15,Mouscron,Charleroi,3,1,2,W
133777,7,BEL1,2008-03-15,St Truiden,Cercle Brugge,0,0,0,D
133778,7,BEL1,2008-03-15,Westerlo,Gent,2,0,2,W
133779,7,BEL1,2008-03-16,Anderlecht,Roeselare,5,0,5,W
133780,7,BEL1,2008-03-16,Mechelen,Genk,2,2,0,D
133781,7,BEL1,2008-03-21,Genk,Mouscron,3,1,2,W
133782,7,BEL1,2008-03-22,Cercle Brugge,Mechelen,2,0,2,W
133783,7,BEL1,2008-03-22,Charleroi,Lokeren,1,0,1,W
133784,7,BEL1,2008-03-22,Dender,Club Brugge,1,0,1,W
133785,7,BEL1,2008-03-22,FC Brussels,Germinal,1,2,-1,L
133786,7,BEL1,2008-03-22,Roeselare,Westerlo,0,2,-2,L
133787,7,BEL1,2008-03-22,Waregem,St Truiden,3,2,1,W
133788,7,BEL1,2008-03-23,Gent,Anderlecht,2,3,-1,L
133789,7,BEL1,2008-03-23,Standard,Bergen,2,0,2,W
133790,7,BEL1,2008-03-29,Bergen,Gent,4,0,4,W
133791,7,BEL1,2008-03-29,Charleroi,FC Brussels,1,0,1,W
133792,7,BEL1,2008-03-29,Germinal,Westerlo,0,2,-2,L
133793,7,BEL1,2008-03-29,Lokeren,Waregem,0,0,0,D
133794,7,BEL1,2008-03-29,Mechelen,Standard,0,1,-1,L
133795,7,BEL1,2008-03-29,Mouscron,Dender,2,1,1,W
133796,7,BEL1,2008-03-29,St Truiden,Roeselare,0,1,-1,L
133797,7,BEL1,2008-03-30,Anderlecht,Cercle Brugge,3,1,2,W
133798,7,BEL1,2008-03-30,Club Brugge,Genk,2,6,-4,L
133799,7,BEL1,2008-04-04,Gent,St Truiden,2,3,-1,L
133800,7,BEL1,2008-04-05,Cercle Brugge,Bergen,0,0,0,D
133801,7,BEL1,2008-04-05,Dender,Charleroi,2,4,-2,L
133802,7,BEL1,2008-04-05,FC Brussels,Mechelen,2,2,0,D
133803,7,BEL1,2008-04-05,Genk,Lokeren,2,3,-1,L
133804,7,BEL1,2008-04-05,Roeselare,Germinal,1,0,1,W
133805,7,BEL1,2008-04-05,Waregem,Club Brugge,2,3,-1,L
133806,7,BEL1,2008-04-06,Standard,Mouscron,1,0,1,W
133807,7,BEL1,2008-04-06,Westerlo,Anderlecht,0,2,-2,L
133808,7,BEL1,2008-04-11,Lokeren,Standard,0,0,0,D
133809,7,BEL1,2008-04-12,Bergen,Roeselare,1,1,0,D
133810,7,BEL1,2008-04-12,Charleroi,Genk,3,1,2,W
133811,7,BEL1,2008-04-12,Dender,FC Brussels,1,1,0,D
133812,7,BEL1,2008-04-12,Mechelen,Gent,1,0,1,W
133813,7,BEL1,2008-04-12,Mouscron,Waregem,0,2,-2,L
133814,7,BEL1,2008-04-12,St Truiden,Westerlo,0,2,-2,L
133815,7,BEL1,2008-04-13,Anderlecht,Germinal,2,0,2,W
133816,7,BEL1,2008-04-13,Club Brugge,Cercle Brugge,1,0,1,W
133817,7,BEL1,2008-04-18,Cercle Brugge,Lokeren,3,2,1,W
133818,7,BEL1,2008-04-19,FC Brussels,Mouscron,0,2,-2,L
133819,7,BEL1,2008-04-19,Genk,Dender,2,0,2,W
133820,7,BEL1,2008-04-19,Germinal,St Truiden,2,1,1,W
133821,7,BEL1,2008-04-19,Roeselare,Mechelen,2,2,0,D
133822,7,BEL1,2008-04-19,Waregem,Charleroi,2,2,0,D
133823,7,BEL1,2008-04-19,Westerlo,Bergen,0,0,0,D
133824,7,BEL1,2008-04-20,Gent,Club Brugge,0,0,0,D
133825,7,BEL1,2008-04-20,Standard,Anderlecht,2,0,2,W
133826,7,BEL1,2008-04-25,Lokeren,Gent,1,1,0,D
133827,7,BEL1,2008-04-26,Anderlecht,St Truiden,4,1,3,W
133828,7,BEL1,2008-04-26,Bergen,Germinal,0,0,0,D
133829,7,BEL1,2008-04-26,Dender,Waregem,2,1,1,W
133830,7,BEL1,2008-04-26,Genk,FC Brussels,2,1,1,W
133831,7,BEL1,2008-04-26,Mechelen,Westerlo,1,0,1,W
133832,7,BEL1,2008-04-26,Mouscron,Cercle Brugge,1,0,1,W
133833,7,BEL1,2008-04-27,Charleroi,Standard,2,1,1,W
133834,7,BEL1,2008-04-27,Club Brugge,Roeselare,1,0,1,W
133835,7,BEL1,2008-05-02,Waregem,Genk,2,2,0,D
133836,7,BEL1,2008-05-03,Anderlecht,Club Brugge,2,0,2,W
133837,7,BEL1,2008-05-03,Cercle Brugge,FC Brussels,0,0,0,D
133838,7,BEL1,2008-05-03,Gent,Charleroi,2,1,1,W
133839,7,BEL1,2008-05-03,Germinal,Mechelen,4,3,1,W
133840,7,BEL1,2008-05-03,Roeselare,Mouscron,2,1,1,W
133841,7,BEL1,2008-05-03,St Truiden,Bergen,1,1,0,D
133842,7,BEL1,2008-05-03,Standard,Dender,3,0,3,W
133843,7,BEL1,2008-05-03,Westerlo,Lokeren,1,2,-1,L
133844,7,BEL1,2008-05-09,FC Brussels,Waregem,1,2,-1,L
133845,7,BEL1,2008-05-10,Bergen,Anderlecht,1,2,-1,L
133846,7,BEL1,2008-05-10,Charleroi,Cercle Brugge,1,3,-2,L
133847,7,BEL1,2008-05-10,Club Brugge,Westerlo,4,0,4,W
133848,7,BEL1,2008-05-10,Dender,Gent,0,3,-3,L
133849,7,BEL1,2008-05-10,Genk,Standard,0,2,-2,L
133850,7,BEL1,2008-05-10,Lokeren,Roeselare,3,0,3,W
133851,7,BEL1,2008-05-10,Mechelen,St Truiden,2,3,-1,L
133852,7,BEL1,2008-05-10,Mouscron,Germinal,1,0,1,W
133853,8,BEL1,2008-08-16,Cercle Brugge,Anderlecht,0,3,-3,L
133854,8,BEL1,2008-08-16,Dender,Standard,1,3,-2,L
133855,8,BEL1,2008-08-16,Roeselare,Kortrijk,2,2,0,D
133856,8,BEL1,2008-08-16,Tubize,Mouscron,1,2,-1,L
133857,8,BEL1,2008-08-16,Waregem,Lokeren,0,0,0,D
133858,8,BEL1,2008-08-16,Westerlo,Charleroi,1,0,1,W
133859,8,BEL1,2008-08-17,Genk,Germinal,1,1,0,D
133860,8,BEL1,2008-08-17,Gent,Bergen,5,0,5,W
133861,8,BEL1,2008-08-23,Anderlecht,Gent,2,2,0,D
133862,8,BEL1,2008-08-23,Charleroi,Roeselare,1,0,1,W
133863,8,BEL1,2008-08-23,Germinal,Dender,1,1,0,D
133864,8,BEL1,2008-08-23,Kortrijk,Cercle Brugge,2,1,1,W
133865,8,BEL1,2008-08-23,Lokeren,Tubize,4,1,3,W
133866,8,BEL1,2008-08-23,Mouscron,Mechelen,3,1,2,W
133867,8,BEL1,2008-08-23,Standard,Westerlo,3,0,3,W
133868,8,BEL1,2008-08-24,Bergen,Genk,3,1,2,W
133869,8,BEL1,2008-08-29,Tubize,Club Brugge,1,4,-3,L
133870,8,BEL1,2008-08-30,Anderlecht,Kortrijk,4,0,4,W
133871,8,BEL1,2008-08-30,Cercle Brugge,Bergen,2,1,1,W
133872,8,BEL1,2008-08-30,Dender,Mouscron,1,2,-1,L
133873,8,BEL1,2008-08-30,Genk,Lokeren,1,0,1,W
133874,8,BEL1,2008-08-30,Mechelen,Waregem,0,2,-2,L
133875,8,BEL1,2008-08-30,Westerlo,Germinal,1,0,1,W
133876,8,BEL1,2008-08-31,Gent,Charleroi,2,0,2,W
133877,8,BEL1,2008-08-31,Roeselare,Standard,1,1,0,D
133878,8,BEL1,2008-09-13,Bergen,Anderlecht,1,2,-1,L
133879,8,BEL1,2008-09-13,Club Brugge,Dender,1,1,0,D
133880,8,BEL1,2008-09-13,Germinal,Roeselare,3,0,3,W
133881,8,BEL1,2008-09-13,Lokeren,Westerlo,1,1,0,D
133882,8,BEL1,2008-09-13,Mechelen,Tubize,0,0,0,D
133883,8,BEL1,2008-09-13,Mouscron,Gent,4,2,2,W
133884,8,BEL1,2008-09-13,Standard,Kortrijk,2,0,2,W
133885,8,BEL1,2008-09-14,Charleroi,Cercle Brugge,3,2,1,W
133886,8,BEL1,2008-09-14,Waregem,Genk,1,3,-2,L
133887,8,BEL1,2008-09-19,Anderlecht,Charleroi,2,0,2,W
133888,8,BEL1,2008-09-20,Cercle Brugge,Germinal,1,0,1,W
133889,8,BEL1,2008-09-20,Dender,Waregem,2,0,2,W
133890,8,BEL1,2008-09-20,Gent,Mechelen,1,2,-1,L
133891,8,BEL1,2008-09-20,Kortrijk,Bergen,1,0,1,W
133892,8,BEL1,2008-09-20,Roeselare,Lokeren,0,1,-1,L
133893,8,BEL1,2008-09-20,Westerlo,Mouscron,0,0,0,D
133894,8,BEL1,2008-09-21,Genk,Club Brugge,0,1,-1,L
133895,8,BEL1,2008-09-21,Tubize,Standard,0,1,-1,L
133896,8,BEL1,2008-09-24,Mechelen,Club Brugge,1,1,0,D
133897,8,BEL1,2008-09-26,Standard,Anderlecht,2,1,1,W
133898,8,BEL1,2008-09-27,Bergen,Roeselare,2,0,2,W
133899,8,BEL1,2008-09-27,Charleroi,Kortrijk,1,2,-1,L
133900,8,BEL1,2008-09-27,Club Brugge,Westerlo,2,0,2,W
133901,8,BEL1,2008-09-27,Lokeren,Cercle Brugge,1,1,0,D
133902,8,BEL1,2008-09-27,Waregem,Tubize,1,0,1,W
133903,8,BEL1,2008-09-28,Germinal,Gent,2,2,0,D
133904,8,BEL1,2008-09-28,Mouscron,Genk,1,2,-1,L
133905,8,BEL1,2008-09-29,Mechelen,Dender,4,1,3,W
133906,8,BEL1,2008-10-03,Anderlecht,Mouscron,2,1,1,W
133907,8,BEL1,2008-10-04,Bergen,Charleroi,1,1,0,D
133908,8,BEL1,2008-10-04,Genk,Mechelen,2,1,1,W
133909,8,BEL1,2008-10-04,Gent,Lokeren,1,1,0,D
133910,8,BEL1,2008-10-04,Kortrijk,Germinal,0,0,0,D
133911,8,BEL1,2008-10-04,Tubize,Dender,2,1,1,W
133912,8,BEL1,2008-10-04,Westerlo,Waregem,3,2,1,W
133913,8,BEL1,2008-10-05,Cercle Brugge,Standard,4,1,3,W
133914,8,BEL1,2008-10-05,Roeselare,Club Brugge,0,1,-1,L
133915,8,BEL1,2008-10-18,Dender,Genk,2,4,-2,L
133916,8,BEL1,2008-10-18,Germinal,Charleroi,1,2,-1,L
133917,8,BEL1,2008-10-18,Lokeren,Kortrijk,2,0,2,W
133918,8,BEL1,2008-10-18,Mechelen,Westerlo,1,3,-2,L
133919,8,BEL1,2008-10-18,Mouscron,Roeselare,2,0,2,W
133920,8,BEL1,2008-10-18,Standard,Bergen,2,1,1,W
133921,8,BEL1,2008-10-18,Tubize,Gent,0,1,-1,L
133922,8,BEL1,2008-10-19,Club Brugge,Cercle Brugge,3,1,2,W
133923,8,BEL1,2008-10-19,Waregem,Anderlecht,4,0,4,W
133924,8,BEL1,2008-10-24,Kortrijk,Mouscron,2,2,0,D
133925,8,BEL1,2008-10-25,Anderlecht,Mechelen,7,1,6,W
133926,8,BEL1,2008-10-25,Bergen,Germinal,0,0,0,D
133927,8,BEL1,2008-10-25,Cercle Brugge,Dender,1,2,-1,L
133928,8,BEL1,2008-10-25,Charleroi,Lokeren,1,1,0,D
133929,8,BEL1,2008-10-25,Roeselare,Waregem,0,3,-3,L
133930,8,BEL1,2008-10-25,Westerlo,Tubize,4,1,3,W
133931,8,BEL1,2008-10-26,Genk,Standard,0,0,0,D
133932,8,BEL1,2008-10-26,Gent,Club Brugge,3,0,3,W
133933,8,BEL1,2008-10-29,Club Brugge,Waregem,2,0,2,W
133934,8,BEL1,2008-10-31,Standard,Charleroi,1,2,-1,L
133935,8,BEL1,2008-11-01,Club Brugge,Kortrijk,4,1,3,W
133936,8,BEL1,2008-11-01,Dender,Westerlo,2,2,0,D
133937,8,BEL1,2008-11-01,Lokeren,Bergen,0,0,0,D
133938,8,BEL1,2008-11-01,Mechelen,Roeselare,1,2,-1,L
133939,8,BEL1,2008-11-01,Mouscron,Cercle Brugge,0,1,-1,L
133940,8,BEL1,2008-11-01,Tubize,Genk,1,3,-2,L
133941,8,BEL1,2008-11-02,Germinal,Anderlecht,1,3,-2,L
133942,8,BEL1,2008-11-02,Waregem,Gent,0,2,-2,L
133943,8,BEL1,2008-11-07,Cercle Brugge,Waregem,2,0,2,W
133944,8,BEL1,2008-11-08,Anderlecht,Lokeren,2,3,-1,L
133945,8,BEL1,2008-11-08,Bergen,Mouscron,0,0,0,D
133946,8,BEL1,2008-11-08,Gent,Dender,1,1,0,D
133947,8,BEL1,2008-11-08,Kortrijk,Mechelen,0,0,0,D
133948,8,BEL1,2008-11-08,Roeselare,Tubize,1,2,-1,L
133949,8,BEL1,2008-11-08,Westerlo,Genk,1,0,1,W
133950,8,BEL1,2008-11-09,Charleroi,Club Brugge,2,2,0,D
133951,8,BEL1,2008-11-09,Germinal,Standard,1,3,-2,L
133952,8,BEL1,2008-11-14,Westerlo,Gent,3,2,1,W
133953,8,BEL1,2008-11-15,Dender,Kortrijk,1,0,1,W
133954,8,BEL1,2008-11-15,Genk,Roeselare,1,1,0,D
133955,8,BEL1,2008-11-15,Mechelen,Bergen,0,0,0,D
133956,8,BEL1,2008-11-15,Mouscron,Charleroi,2,1,1,W
133957,8,BEL1,2008-11-15,Tubize,Cercle Brugge,3,0,3,W
133958,8,BEL1,2008-11-15,Waregem,Germinal,2,2,0,D
133959,8,BEL1,2008-11-16,Club Brugge,Anderlecht,1,1,0,D
133960,8,BEL1,2008-11-16,Lokeren,Standard,1,1,0,D
133961,8,BEL1,2008-11-22,Anderlecht,Westerlo,2,0,2,W
133962,8,BEL1,2008-11-22,Bergen,Club Brugge,1,2,-1,L
133963,8,BEL1,2008-11-22,Cercle Brugge,Mechelen,2,1,1,W
133964,8,BEL1,2008-11-22,Charleroi,Tubize,3,2,1,W
133965,8,BEL1,2008-11-22,Germinal,Lokeren,0,2,-2,L
133966,8,BEL1,2008-11-22,Roeselare,Dender,2,2,0,D
133967,8,BEL1,2008-11-22,Standard,Mouscron,3,1,2,W
133968,8,BEL1,2008-11-23,Gent,Genk,2,3,-1,L
133969,8,BEL1,2008-11-28,Dender,Anderlecht,0,2,-2,L
133970,8,BEL1,2008-11-29,Genk,Cercle Brugge,3,2,1,W
133971,8,BEL1,2008-11-29,Gent,Roeselare,4,0,4,W
133972,8,BEL1,2008-11-29,Mouscron,Lokeren,2,0,2,W
133973,8,BEL1,2008-11-29,Tubize,Kortrijk,3,3,0,D
133974,8,BEL1,2008-11-29,Waregem,Charleroi,4,2,2,W
133975,8,BEL1,2008-11-29,Westerlo,Bergen,2,1,1,W
133976,8,BEL1,2008-11-30,Club Brugge,Germinal,3,0,3,W
133977,8,BEL1,2008-11-30,Mechelen,Standard,0,0,0,D
133978,8,BEL1,2008-12-05,Cercle Brugge,Gent,3,1,2,W
133979,8,BEL1,2008-12-06,Anderlecht,Tubize,5,1,4,W
133980,8,BEL1,2008-12-06,Bergen,Dender,5,2,3,W
133981,8,BEL1,2008-12-06,Charleroi,Mechelen,1,2,-1,L
133982,8,BEL1,2008-12-06,Germinal,Mouscron,3,0,3,W
133983,8,BEL1,2008-12-06,Roeselare,Westerlo,1,0,1,W
133984,8,BEL1,2008-12-06,Standard,Waregem,1,2,-1,L
133985,8,BEL1,2008-12-07,Kortrijk,Genk,3,1,2,W
133986,8,BEL1,2008-12-07,Lokeren,Club Brugge,2,0,2,W
133987,8,BEL1,2008-12-12,Mechelen,Germinal,2,1,1,W
133988,8,BEL1,2008-12-13,Dender,Lokeren,1,1,0,D
133989,8,BEL1,2008-12-13,Genk,Charleroi,1,0,1,W
133990,8,BEL1,2008-12-13,Gent,Kortrijk,1,1,0,D
133991,8,BEL1,2008-12-13,Tubize,Bergen,2,1,1,W
133992,8,BEL1,2008-12-13,Waregem,Mouscron,2,1,1,W
133993,8,BEL1,2008-12-13,Westerlo,Cercle Brugge,1,2,-1,L
133994,8,BEL1,2008-12-14,Club Brugge,Standard,1,4,-3,L
133995,8,BEL1,2008-12-14,Roeselare,Anderlecht,0,3,-3,L
133996,8,BEL1,2008-12-16,Kortrijk,Waregem,1,0,1,W
133997,8,BEL1,2008-12-19,Anderlecht,Genk,2,0,2,W
133998,8,BEL1,2008-12-20,Bergen,Waregem,2,2,0,D
133999,8,BEL1,2008-12-20,Cercle Brugge,Roeselare,4,3,1,W
134000,8,BEL1,2008-12-20,Charleroi,Dender,2,0,2,W
134001,8,BEL1,2008-12-20,Germinal,Tubize,2,0,2,W
134002,8,BEL1,2008-12-20,Lokeren,Mechelen,2,2,0,D
134003,8,BEL1,2008-12-20,Mouscron,Club Brugge,5,1,4,W
134004,8,BEL1,2008-12-21,Kortrijk,Westerlo,0,0,0,D
134005,8,BEL1,2008-12-21,Standard,Gent,2,1,1,W
134006,8,BEL1,2009-01-16,Anderlecht,Cercle Brugge,1,2,-1,L
134007,8,BEL1,2009-01-17,Bergen,Gent,1,2,-1,L
134008,8,BEL1,2009-01-17,Club Brugge,Mechelen,3,0,3,W
134009,8,BEL1,2009-01-17,Kortrijk,Roeselare,2,1,1,W
134010,8,BEL1,2009-01-17,Lokeren,Waregem,2,1,1,W
134011,8,BEL1,2009-01-17,Mouscron,Tubize,1,1,0,D
134012,8,BEL1,2009-01-17,Standard,Dender,3,2,1,W
134013,8,BEL1,2009-01-18,Charleroi,Westerlo,1,2,-1,L
134014,8,BEL1,2009-01-18,Germinal,Genk,4,1,3,W
134015,8,BEL1,2009-01-24,Cercle Brugge,Kortrijk,0,1,-1,L
134016,8,BEL1,2009-01-24,Dender,Germinal,0,1,-1,L
134017,8,BEL1,2009-01-24,Genk,Bergen,2,0,2,W
134018,8,BEL1,2009-01-24,Mechelen,Mouscron,2,2,0,D
134019,8,BEL1,2009-01-24,Roeselare,Charleroi,3,1,2,W
134020,8,BEL1,2009-01-24,Tubize,Lokeren,2,1,1,W
134021,8,BEL1,2009-01-25,Waregem,Club Brugge,3,1,2,W
134022,8,BEL1,2009-01-25,Westerlo,Standard,0,1,-1,L
134023,8,BEL1,2009-01-31,Bergen,Cercle Brugge,1,1,0,D
134024,8,BEL1,2009-01-31,Club Brugge,Tubize,3,1,2,W
134025,8,BEL1,2009-01-31,Germinal,Westerlo,2,1,1,W
134026,8,BEL1,2009-01-31,Kortrijk,Anderlecht,1,3,-2,L
134027,8,BEL1,2009-01-31,Mouscron,Dender,0,2,-2,L
134028,8,BEL1,2009-01-31,Standard,Roeselare,3,0,3,W
134029,8,BEL1,2009-01-31,Waregem,Mechelen,1,1,0,D
134030,8,BEL1,2009-02-01,Charleroi,Gent,2,5,-3,L
134031,8,BEL1,2009-02-01,Lokeren,Genk,1,2,-1,L
134032,8,BEL1,2009-02-06,Kortrijk,Standard,0,2,-2,L
134033,8,BEL1,2009-02-07,Anderlecht,Bergen,3,2,1,W
134034,8,BEL1,2009-02-07,Dender,Club Brugge,0,2,-2,L
134035,8,BEL1,2009-02-07,Genk,Waregem,1,2,-1,L
134036,8,BEL1,2009-02-07,Gent,Mouscron,2,0,2,W
134037,8,BEL1,2009-02-07,Roeselare,Germinal,2,2,0,D
134038,8,BEL1,2009-02-07,Tubize,Mechelen,1,5,-4,L
134039,8,BEL1,2009-02-08,Cercle Brugge,Charleroi,2,2,0,D
134040,8,BEL1,2009-02-08,Westerlo,Lokeren,1,0,1,W
134041,8,BEL1,2009-02-14,Bergen,Kortrijk,1,1,0,D
134042,8,BEL1,2009-02-14,Germinal,Cercle Brugge,1,1,0,D
134043,8,BEL1,2009-02-14,Lokeren,Roeselare,2,1,1,W
134044,8,BEL1,2009-02-14,Mechelen,Gent,3,3,0,D
134045,8,BEL1,2009-02-14,Mouscron,Westerlo,0,0,0,D
134046,8,BEL1,2009-02-14,Standard,Tubize,4,0,4,W
134047,8,BEL1,2009-02-14,Waregem,Dender,1,0,1,W
134048,8,BEL1,2009-02-15,Charleroi,Anderlecht,0,1,-1,L
134049,8,BEL1,2009-02-15,Club Brugge,Genk,0,2,-2,L
134050,8,BEL1,2009-02-18,Gent,Anderlecht,1,2,-1,L
134051,8,BEL1,2009-02-20,Genk,Mouscron,1,1,0,D
134052,8,BEL1,2009-02-21,Cercle Brugge,Lokeren,0,0,0,D
134053,8,BEL1,2009-02-21,Dender,Mechelen,1,2,-1,L
134054,8,BEL1,2009-02-21,Gent,Germinal,1,3,-2,L
134055,8,BEL1,2009-02-21,Kortrijk,Charleroi,1,1,0,D
134056,8,BEL1,2009-02-21,Roeselare,Bergen,3,2,1,W
134057,8,BEL1,2009-02-21,Tubize,Waregem,0,6,-6,L
134058,8,BEL1,2009-02-22,Anderlecht,Standard,4,2,2,W
134059,8,BEL1,2009-02-22,Westerlo,Club Brugge,1,1,0,D
134060,8,BEL1,2009-02-27,Mechelen,Genk,2,1,1,W
134061,8,BEL1,2009-02-28,Charleroi,Bergen,3,0,3,W
134062,8,BEL1,2009-02-28,Club Brugge,Roeselare,2,1,1,W
134063,8,BEL1,2009-02-28,Dender,Tubize,4,0,4,W
134064,8,BEL1,2009-02-28,Germinal,Kortrijk,3,0,3,W
134065,8,BEL1,2009-02-28,Mouscron,Anderlecht,1,1,0,D
134066,8,BEL1,2009-02-28,Waregem,Westerlo,1,1,0,D
134067,8,BEL1,2009-03-01,Lokeren,Gent,0,1,-1,L
134068,8,BEL1,2009-03-01,Standard,Cercle Brugge,4,0,4,W
134069,8,BEL1,2009-03-06,Bergen,Standard,0,1,-1,L
134070,8,BEL1,2009-03-07,Anderlecht,Waregem,2,0,2,W
134071,8,BEL1,2009-03-07,Charleroi,Germinal,0,0,0,D
134072,8,BEL1,2009-03-07,Genk,Dender,4,3,1,W
134073,8,BEL1,2009-03-07,Gent,Tubize,2,0,2,W
134074,8,BEL1,2009-03-07,Kortrijk,Lokeren,2,3,-1,L
134075,8,BEL1,2009-03-07,Roeselare,Mouscron,2,0,2,W
134076,8,BEL1,2009-03-08,Cercle Brugge,Club Brugge,1,3,-2,L
134077,8,BEL1,2009-03-08,Westerlo,Mechelen,0,1,-1,L
134078,8,BEL1,2009-03-13,Mechelen,Anderlecht,2,1,1,W
134079,8,BEL1,2009-03-14,Dender,Cercle Brugge,1,0,1,W
134080,8,BEL1,2009-03-14,Germinal,Bergen,2,0,2,W
134081,8,BEL1,2009-03-14,Lokeren,Charleroi,0,0,0,D
134082,8,BEL1,2009-03-14,Mouscron,Kortrijk,1,0,1,W
134083,8,BEL1,2009-03-14,Tubize,Westerlo,1,2,-1,L
134084,8,BEL1,2009-03-14,Waregem,Roeselare,0,0,0,D
134085,8,BEL1,2009-03-15,Club Brugge,Gent,1,4,-3,L
134086,8,BEL1,2009-03-15,Standard,Genk,2,0,2,W
134087,8,BEL1,2009-03-20,Kortrijk,Club Brugge,2,3,-1,L
134088,8,BEL1,2009-03-21,Anderlecht,Germinal,2,0,2,W
134089,8,BEL1,2009-03-21,Bergen,Lokeren,0,2,-2,L
134090,8,BEL1,2009-03-21,Cercle Brugge,Mouscron,0,1,-1,L
134091,8,BEL1,2009-03-21,Genk,Tubize,3,0,3,W
134092,8,BEL1,2009-03-21,Roeselare,Mechelen,1,0,1,W
134093,8,BEL1,2009-03-21,Westerlo,Dender,3,1,2,W
134094,8,BEL1,2009-03-22,Charleroi,Standard,1,0,1,W
134095,8,BEL1,2009-03-22,Gent,Waregem,1,0,1,W
134096,8,BEL1,2009-04-04,Club Brugge,Charleroi,2,1,1,W
134097,8,BEL1,2009-04-04,Dender,Gent,1,1,0,D
134098,8,BEL1,2009-04-04,Genk,Westerlo,1,4,-3,L
134099,8,BEL1,2009-04-04,Mechelen,Kortrijk,1,1,0,D
134100,8,BEL1,2009-04-04,Mouscron,Bergen,3,2,1,W
134101,8,BEL1,2009-04-04,Tubize,Roeselare,0,1,-1,L
134102,8,BEL1,2009-04-04,Waregem,Cercle Brugge,3,1,2,W
134103,8,BEL1,2009-04-05,Lokeren,Anderlecht,0,0,0,D
134104,8,BEL1,2009-04-05,Standard,Germinal,3,1,2,W
134105,8,BEL1,2009-04-10,Roeselare,Genk,1,0,1,W
134106,8,BEL1,2009-04-11,Bergen,Mechelen,0,1,-1,L
134107,8,BEL1,2009-04-11,Cercle Brugge,Tubize,4,1,3,W
134108,8,BEL1,2009-04-11,Charleroi,Mouscron,1,0,1,W
134109,8,BEL1,2009-04-11,Germinal,Waregem,1,2,-1,L
134110,8,BEL1,2009-04-11,Kortrijk,Dender,1,2,-1,L
134111,8,BEL1,2009-04-11,Standard,Lokeren,1,0,1,W
134112,8,BEL1,2009-04-12,Anderlecht,Club Brugge,1,0,1,W
134113,8,BEL1,2009-04-12,Gent,Westerlo,2,0,2,W
134114,8,BEL1,2009-04-17,Genk,Gent,2,2,0,D
134115,8,BEL1,2009-04-18,Club Brugge,Bergen,3,2,1,W
134116,8,BEL1,2009-04-18,Lokeren,Germinal,1,0,1,W
134117,8,BEL1,2009-04-18,Mechelen,Cercle Brugge,0,1,-1,L
134118,8,BEL1,2009-04-18,Mouscron,Standard,0,3,-3,L
134119,8,BEL1,2009-04-18,Tubize,Charleroi,3,1,2,W
134120,8,BEL1,2009-04-18,Waregem,Kortrijk,5,1,4,W
134121,8,BEL1,2009-04-19,Dender,Roeselare,3,1,2,W
134122,8,BEL1,2009-04-19,Westerlo,Anderlecht,0,1,-1,L
134123,8,BEL1,2009-04-24,Germinal,Club Brugge,2,0,2,W
134124,8,BEL1,2009-04-25,Anderlecht,Dender,4,0,4,W
134125,8,BEL1,2009-04-25,Bergen,Westerlo,0,2,-2,L
134126,8,BEL1,2009-04-25,Charleroi,Waregem,1,0,1,W
134127,8,BEL1,2009-04-25,Kortrijk,Tubize,2,2,0,D
134128,8,BEL1,2009-04-25,Lokeren,Mouscron,3,0,3,W
134129,8,BEL1,2009-04-25,Standard,Mechelen,4,1,3,W
134130,8,BEL1,2009-04-26,Cercle Brugge,Genk,1,3,-2,L
134131,8,BEL1,2009-04-26,Roeselare,Gent,1,3,-2,L
134132,8,BEL1,2009-05-01,Club Brugge,Lokeren,2,3,-1,L
134133,8,BEL1,2009-05-02,Dender,Bergen,0,0,0,D
134134,8,BEL1,2009-05-02,Gent,Cercle Brugge,2,1,1,W
134135,8,BEL1,2009-05-02,Mechelen,Charleroi,2,1,1,W
134136,8,BEL1,2009-05-02,Mouscron,Germinal,3,1,2,W
134137,8,BEL1,2009-05-02,Waregem,Standard,0,0,0,D
134138,8,BEL1,2009-05-02,Westerlo,Roeselare,1,0,1,W
134139,8,BEL1,2009-05-03,Genk,Kortrijk,0,1,-1,L
134140,8,BEL1,2009-05-03,Tubize,Anderlecht,1,1,0,D
134141,8,BEL1,2009-05-08,Germinal,Mechelen,3,1,2,W
134142,8,BEL1,2009-05-09,Anderlecht,Roeselare,3,1,2,W
134143,8,BEL1,2009-05-09,Bergen,Tubize,1,1,0,D
134144,8,BEL1,2009-05-09,Cercle Brugge,Westerlo,2,1,1,W
134145,8,BEL1,2009-05-09,Charleroi,Genk,3,0,3,W
134146,8,BEL1,2009-05-09,Kortrijk,Gent,0,2,-2,L
134147,8,BEL1,2009-05-09,Lokeren,Dender,0,2,-2,L
134148,8,BEL1,2009-05-09,Mouscron,Waregem,0,2,-2,L
134149,8,BEL1,2009-05-09,Standard,Club Brugge,2,0,2,W
134150,8,BEL1,2009-05-15,Mechelen,Lokeren,3,0,3,W
134151,8,BEL1,2009-05-16,Club Brugge,Mouscron,4,1,3,W
134152,8,BEL1,2009-05-16,Dender,Charleroi,1,2,-1,L
134153,8,BEL1,2009-05-16,Genk,Anderlecht,0,2,-2,L
134154,8,BEL1,2009-05-16,Gent,Standard,0,1,-1,L
134155,8,BEL1,2009-05-16,Roeselare,Cercle Brugge,1,2,-1,L
134156,8,BEL1,2009-05-16,Tubize,Germinal,1,0,1,W
134157,8,BEL1,2009-05-16,Waregem,Bergen,3,0,3,W
134158,8,BEL1,2009-05-16,Westerlo,Kortrijk,1,3,-2,L
134159,9,BEL1,2009-07-31,Standard,St Truiden,2,2,0,D
134160,9,BEL1,2009-08-01,Kortrijk,Anderlecht,0,2,-2,L
134161,9,BEL1,2009-08-01,Lokeren,Waregem,1,1,0,D
134162,9,BEL1,2009-08-01,Mechelen,Westerlo,4,1,3,W
134163,9,BEL1,2009-08-01,Roeselare,Germinal,1,1,0,D
134164,9,BEL1,2009-08-02,Cercle Brugge,Gent,1,3,-2,L
134165,9,BEL1,2009-08-02,Charleroi,Club Brugge,1,2,-1,L
134166,9,BEL1,2009-08-07,Germinal,Standard,1,1,0,D
134167,9,BEL1,2009-08-08,Anderlecht,Cercle Brugge,3,2,1,W
134168,9,BEL1,2009-08-08,St Truiden,Charleroi,0,0,0,D
134169,9,BEL1,2009-08-08,Waregem,Genk,2,2,0,D
134170,9,BEL1,2009-08-08,Westerlo,Kortrijk,1,1,0,D
134171,9,BEL1,2009-08-09,Club Brugge,Lokeren,2,0,2,W
134172,9,BEL1,2009-08-09,Gent,Mechelen,2,1,1,W
134173,9,BEL1,2009-08-15,Anderlecht,Westerlo,3,0,3,W
134174,9,BEL1,2009-08-15,Cercle Brugge,Waregem,2,2,0,D
134175,9,BEL1,2009-08-15,Genk,Gent,1,1,0,D
134176,9,BEL1,2009-08-15,Lokeren,St Truiden,1,2,-1,L
134177,9,BEL1,2009-08-15,Mechelen,Club Brugge,2,1,1,W
134178,9,BEL1,2009-08-15,Roeselare,Standard,1,5,-4,L
134179,9,BEL1,2009-08-16,Charleroi,Germinal,1,0,1,W
134180,9,BEL1,2009-08-21,Standard,Charleroi,1,1,0,D
134181,9,BEL1,2009-08-22,Gent,Lokeren,4,1,3,W
134182,9,BEL1,2009-08-22,Germinal,Mechelen,1,3,-2,L
134183,9,BEL1,2009-08-22,St Truiden,Roeselare,2,1,1,W
134184,9,BEL1,2009-08-22,Waregem,Anderlecht,0,2,-2,L
134185,9,BEL1,2009-08-23,Club Brugge,Kortrijk,2,2,0,D
134186,9,BEL1,2009-08-23,Westerlo,Genk,0,1,-1,L
134187,9,BEL1,2009-08-28,Westerlo,Waregem,1,2,-1,L
134188,9,BEL1,2009-08-29,Kortrijk,Gent,1,0,1,W
134189,9,BEL1,2009-08-29,Mechelen,St Truiden,0,2,-2,L
134190,9,BEL1,2009-08-29,Roeselare,Charleroi,1,3,-2,L
134191,9,BEL1,2009-08-30,Anderlecht,Standard,1,1,0,D
134192,9,BEL1,2009-08-30,Cercle Brugge,Club Brugge,2,3,-1,L
134193,9,BEL1,2009-08-30,Genk,Germinal,1,1,0,D
134194,9,BEL1,2009-09-12,Charleroi,Cercle Brugge,0,4,-4,L
134195,9,BEL1,2009-09-12,Gent,Roeselare,5,1,4,W
134196,9,BEL1,2009-09-12,St Truiden,Anderlecht,2,1,1,W
134197,9,BEL1,2009-09-12,Standard,Mechelen,3,0,3,W
134198,9,BEL1,2009-09-12,Waregem,Kortrijk,0,2,-2,L
134199,9,BEL1,2009-09-13,Club Brugge,Genk,1,1,0,D
134200,9,BEL1,2009-09-13,Germinal,Lokeren,2,1,1,W
134201,9,BEL1,2009-09-18,Genk,Charleroi,1,2,-1,L
134202,9,BEL1,2009-09-19,Cercle Brugge,Germinal,1,2,-1,L
134203,9,BEL1,2009-09-19,Kortrijk,St Truiden,0,1,-1,L
134204,9,BEL1,2009-09-19,Lokeren,Standard,1,3,-2,L
134205,9,BEL1,2009-09-19,Mechelen,Roeselare,3,2,1,W
134206,9,BEL1,2009-09-20,Anderlecht,Gent,1,1,0,D
134207,9,BEL1,2009-09-20,Westerlo,Club Brugge,1,4,-3,L
134208,9,BEL1,2009-09-22,St Truiden,Genk,2,4,-2,L
134209,9,BEL1,2009-09-23,Charleroi,Mechelen,1,2,-1,L
134210,9,BEL1,2009-09-23,Club Brugge,Waregem,3,1,2,W
134211,9,BEL1,2009-09-23,Gent,Westerlo,1,2,-1,L
134212,9,BEL1,2009-09-23,Germinal,Kortrijk,1,0,1,W
134213,9,BEL1,2009-09-23,Roeselare,Lokeren,1,2,-1,L
134214,9,BEL1,2009-09-23,Standard,Cercle Brugge,1,1,0,D
134215,9,BEL1,2009-09-26,Genk,Roeselare,1,1,0,D
134216,9,BEL1,2009-09-26,Kortrijk,Standard,0,2,-2,L
134217,9,BEL1,2009-09-26,Lokeren,Charleroi,4,1,3,W
134218,9,BEL1,2009-09-26,Waregem,Gent,3,1,2,W
134219,9,BEL1,2009-09-26,Westerlo,St Truiden,2,0,2,W
134220,9,BEL1,2009-09-27,Anderlecht,Germinal,1,0,1,W
134221,9,BEL1,2009-09-28,Cercle Brugge,Mechelen,1,0,1,W
134222,9,BEL1,2009-10-03,Charleroi,Kortrijk,3,3,0,D
134223,9,BEL1,2009-10-03,Germinal,Westerlo,3,1,2,W
134224,9,BEL1,2009-10-03,Mechelen,Lokeren,2,0,2,W
134225,9,BEL1,2009-10-03,Roeselare,Cercle Brugge,3,2,1,W
134226,9,BEL1,2009-10-03,St Truiden,Waregem,1,2,-1,L
134227,9,BEL1,2009-10-04,Club Brugge,Anderlecht,4,2,2,W
134228,9,BEL1,2009-10-04,Standard,Genk,1,0,1,W
134229,9,BEL1,2009-10-17,Anderlecht,Charleroi,2,0,2,W
134230,9,BEL1,2009-10-17,Kortrijk,Roeselare,2,0,2,W
134231,9,BEL1,2009-10-17,Lokeren,Cercle Brugge,1,1,0,D
134232,9,BEL1,2009-10-17,Waregem,Germinal,4,0,4,W
134233,9,BEL1,2009-10-17,Westerlo,Standard,2,0,2,W
134234,9,BEL1,2009-10-18,Club Brugge,Gent,1,0,1,W
134235,9,BEL1,2009-10-18,Genk,Mechelen,1,2,-1,L
134236,9,BEL1,2009-10-23,Lokeren,Genk,0,2,-2,L
134237,9,BEL1,2009-10-24,Cercle Brugge,Kortrijk,1,1,0,D
134238,9,BEL1,2009-10-24,Charleroi,Westerlo,1,1,0,D
134239,9,BEL1,2009-10-24,St Truiden,Gent,1,2,-1,L
134240,9,BEL1,2009-10-24,Standard,Waregem,1,1,0,D
134241,9,BEL1,2009-10-25,Mechelen,Anderlecht,0,2,-2,L
134242,9,BEL1,2009-10-25,Roeselare,Club Brugge,2,3,-1,L
134243,9,BEL1,2009-10-31,Anderlecht,Lokeren,2,0,2,W
134244,9,BEL1,2009-10-31,Club Brugge,St Truiden,1,0,1,W
134245,9,BEL1,2009-10-31,Kortrijk,Mechelen,2,0,2,W
134246,9,BEL1,2009-10-31,Waregem,Charleroi,2,2,0,D
134247,9,BEL1,2009-10-31,Westerlo,Roeselare,2,2,0,D
134248,9,BEL1,2009-11-01,Gent,Germinal,0,1,-1,L
134249,9,BEL1,2009-11-02,Genk,Cercle Brugge,2,0,2,W
134250,9,BEL1,2009-11-06,Charleroi,Gent,0,2,-2,L
134251,9,BEL1,2009-11-07,Cercle Brugge,Westerlo,2,1,1,W
134252,9,BEL1,2009-11-07,Germinal,St Truiden,4,1,3,W
134253,9,BEL1,2009-11-07,Lokeren,Kortrijk,0,0,0,D
134254,9,BEL1,2009-11-07,Roeselare,Waregem,2,0,2,W
134255,9,BEL1,2009-11-08,Genk,Anderlecht,0,2,-2,L
134256,9,BEL1,2009-11-08,Standard,Club Brugge,3,1,2,W
134257,9,BEL1,2009-11-21,Anderlecht,Roeselare,3,1,2,W
134258,9,BEL1,2009-11-21,Club Brugge,Germinal,1,2,-1,L
134259,9,BEL1,2009-11-21,Gent,Standard,2,1,1,W
134260,9,BEL1,2009-11-21,St Truiden,Cercle Brugge,1,1,0,D
134261,9,BEL1,2009-11-21,Westerlo,Lokeren,1,0,1,W
134262,9,BEL1,2009-11-22,Kortrijk,Genk,2,1,1,W
134263,9,BEL1,2009-11-22,Waregem,Mechelen,4,1,3,W
134264,9,BEL1,2009-11-27,Anderlecht,Kortrijk,1,0,1,W
134265,9,BEL1,2009-11-28,Club Brugge,Charleroi,1,0,1,W
134266,9,BEL1,2009-11-28,Gent,Cercle Brugge,3,1,2,W
134267,9,BEL1,2009-11-28,Germinal,Roeselare,3,0,3,W
134268,9,BEL1,2009-11-28,Westerlo,Mechelen,2,0,2,W
134269,9,BEL1,2009-11-29,St Truiden,Standard,2,0,2,W
134270,9,BEL1,2009-11-29,Waregem,Lokeren,1,0,1,W
134271,9,BEL1,2009-12-04,Mechelen,Gent,2,5,-3,L
134272,9,BEL1,2009-12-05,Charleroi,St Truiden,0,0,0,D
134273,9,BEL1,2009-12-05,Genk,Westerlo,0,0,0,D
134274,9,BEL1,2009-12-05,Kortrijk,Waregem,1,0,1,W
134275,9,BEL1,2009-12-05,Standard,Germinal,2,2,0,D
134276,9,BEL1,2009-12-06,Cercle Brugge,Anderlecht,1,3,-2,L
134277,9,BEL1,2009-12-06,Lokeren,Club Brugge,0,1,-1,L
134278,9,BEL1,2009-12-11,Westerlo,Anderlecht,0,2,-2,L
134279,9,BEL1,2009-12-12,Club Brugge,Mechelen,1,1,0,D
134280,9,BEL1,2009-12-12,Germinal,Charleroi,0,0,0,D
134281,9,BEL1,2009-12-12,St Truiden,Kortrijk,0,2,-2,L
134282,9,BEL1,2009-12-12,Standard,Roeselare,0,1,-1,L
134283,9,BEL1,2009-12-13,Gent,Genk,2,1,1,W
134284,9,BEL1,2009-12-13,Waregem,Cercle Brugge,1,0,1,W
134285,9,BEL1,2009-12-19,Genk,Waregem,2,2,0,D
134286,9,BEL1,2009-12-19,Kortrijk,Westerlo,1,1,0,D
134287,9,BEL1,2009-12-19,Lokeren,Gent,0,1,-1,L
134288,9,BEL1,2009-12-19,Roeselare,St Truiden,1,2,-1,L
134289,9,BEL1,2009-12-26,Charleroi,Roeselare,3,0,3,W
134290,9,BEL1,2009-12-26,Club Brugge,Cercle Brugge,2,1,1,W
134291,9,BEL1,2009-12-26,Germinal,Genk,1,0,1,W
134292,9,BEL1,2009-12-26,St Truiden,Mechelen,5,2,3,W
134293,9,BEL1,2009-12-26,Standard,Lokeren,2,0,2,W
134294,9,BEL1,2009-12-27,Gent,Anderlecht,2,2,0,D
134295,9,BEL1,2009-12-27,Waregem,Westerlo,1,0,1,W
134296,9,BEL1,2009-12-29,Cercle Brugge,Standard,2,0,2,W
134297,9,BEL1,2009-12-29,Genk,St Truiden,0,0,0,D
134298,9,BEL1,2009-12-30,Anderlecht,Waregem,2,1,1,W
134299,9,BEL1,2009-12-30,Kortrijk,Club Brugge,1,4,-3,L
134300,9,BEL1,2009-12-30,Lokeren,Germinal,2,0,2,W
134301,9,BEL1,2009-12-30,Mechelen,Charleroi,1,0,1,W
134302,9,BEL1,2009-12-30,Roeselare,Gent,0,4,-4,L
134303,9,BEL1,2010-01-15,Gent,Kortrijk,2,2,0,D
134304,9,BEL1,2010-01-16,Charleroi,Genk,1,3,-2,L
134305,9,BEL1,2010-01-16,Roeselare,Mechelen,1,2,-1,L
134306,9,BEL1,2010-01-16,St Truiden,Lokeren,2,1,1,W
134307,9,BEL1,2010-01-17,Germinal,Cercle Brugge,1,4,-3,L
134308,9,BEL1,2010-01-17,Standard,Anderlecht,0,4,-4,L
134309,9,BEL1,2010-01-23,Kortrijk,Germinal,3,0,3,W
134310,9,BEL1,2010-01-23,Lokeren,Roeselare,1,4,-3,L
134311,9,BEL1,2010-01-23,Waregem,St Truiden,2,0,2,W
134312,9,BEL1,2010-01-23,Westerlo,Gent,0,0,0,D
134313,9,BEL1,2010-01-24,Genk,Club Brugge,2,0,2,W
134314,9,BEL1,2010-01-24,Mechelen,Standard,0,0,0,D
134315,9,BEL1,2010-01-29,Germinal,Anderlecht,0,5,-5,L
134316,9,BEL1,2010-01-30,Club Brugge,Westerlo,2,1,1,W
134317,9,BEL1,2010-01-30,Mechelen,Cercle Brugge,1,2,-1,L
134318,9,BEL1,2010-01-31,Gent,Waregem,0,2,-2,L
134319,9,BEL1,2010-01-31,Standard,Kortrijk,3,1,2,W
134320,9,BEL1,2010-02-02,Mechelen,Germinal,1,0,1,W
134321,9,BEL1,2010-02-03,Anderlecht,Club Brugge,3,2,1,W
134322,9,BEL1,2010-02-03,St Truiden,Westerlo,0,1,-1,L
134323,9,BEL1,2010-02-04,Charleroi,Standard,2,3,-1,L
134324,9,BEL1,2010-02-06,Anderlecht,St Truiden,1,2,-1,L
134325,9,BEL1,2010-02-06,Cercle Brugge,Roeselare,2,0,2,W
134326,9,BEL1,2010-02-06,Lokeren,Mechelen,2,1,1,W
134327,9,BEL1,2010-02-06,Westerlo,Germinal,1,1,0,D
134328,9,BEL1,2010-02-07,Genk,Standard,1,0,1,W
134329,9,BEL1,2010-02-07,Kortrijk,Charleroi,2,1,1,W
134330,9,BEL1,2010-02-07,Waregem,Club Brugge,1,1,0,D
134331,9,BEL1,2010-02-13,Roeselare,Kortrijk,0,2,-2,L
134332,9,BEL1,2010-02-14,Gent,Club Brugge,1,1,0,D
134333,9,BEL1,2010-02-14,Standard,Westerlo,1,0,1,W
134334,9,BEL1,2010-02-19,Genk,Lokeren,3,1,2,W
134335,9,BEL1,2010-02-20,Gent,St Truiden,0,1,-1,L
134336,9,BEL1,2010-02-20,Kortrijk,Cercle Brugge,3,1,2,W
134337,9,BEL1,2010-02-20,Waregem,Roeselare,1,1,0,D
134338,9,BEL1,2010-02-20,Westerlo,Charleroi,4,0,4,W
134339,9,BEL1,2010-02-21,Anderlecht,Mechelen,2,0,2,W
134340,9,BEL1,2010-02-21,Club Brugge,Standard,2,1,1,W
134341,9,BEL1,2010-02-24,Cercle Brugge,Charleroi,1,0,1,W
134342,9,BEL1,2010-02-24,Roeselare,Genk,1,1,0,D
134343,9,BEL1,2010-02-26,Germinal,Gent,1,1,0,D
134344,9,BEL1,2010-02-27,Cercle Brugge,Genk,1,0,1,W
134345,9,BEL1,2010-02-27,Lokeren,Westerlo,1,0,1,W
134346,9,BEL1,2010-02-27,Mechelen,Kortrijk,1,1,0,D
134347,9,BEL1,2010-02-28,Charleroi,Waregem,0,0,0,D
134348,9,BEL1,2010-02-28,Roeselare,Anderlecht,1,2,-1,L
134349,9,BEL1,2010-02-28,St Truiden,Club Brugge,1,1,0,D
134350,9,BEL1,2010-03-06,Cercle Brugge,Lokeren,4,0,4,W
134351,9,BEL1,2010-03-06,Charleroi,Anderlecht,0,2,-2,L
134352,9,BEL1,2010-03-07,Germinal,Waregem,1,1,0,D
134353,9,BEL1,2010-03-07,Mechelen,Genk,2,1,1,W
134354,9,BEL1,2010-03-10,Charleroi,Lokeren,4,1,3,W
134355,9,BEL1,2010-03-14,Anderlecht,Genk,2,0,2,W
134356,9,BEL1,2010-03-14,Club Brugge,Roeselare,1,0,1,W
134357,9,BEL1,2010-03-14,Gent,Charleroi,2,1,1,W
134358,9,BEL1,2010-03-14,Kortrijk,Lokeren,3,1,2,W
134359,9,BEL1,2010-03-14,St Truiden,Germinal,2,0,2,W
134360,9,BEL1,2010-03-14,Waregem,Standard,1,1,0,D
134361,9,BEL1,2010-03-14,Westerlo,Cercle Brugge,2,1,1,W
134362,9,BEL1,2010-03-21,Cercle Brugge,St Truiden,3,1,2,W
134363,9,BEL1,2010-03-21,Genk,Kortrijk,1,1,0,D
134364,9,BEL1,2010-03-21,Germinal,Club Brugge,1,4,-3,L
134365,9,BEL1,2010-03-21,Lokeren,Anderlecht,0,4,-4,L
134366,9,BEL1,2010-03-21,Mechelen,Waregem,2,1,1,W
134367,9,BEL1,2010-03-21,Roeselare,Westerlo,0,0,0,D
134368,9,BEL1,2010-03-21,Standard,Gent,0,2,-2,L
134369,10,BEL1,2010-07-30,Standard,Waregem,1,1,0,D
134370,10,BEL1,2010-07-31,Anderlecht,Eupen,4,1,3,W
134371,10,BEL1,2010-07-31,Kortrijk,Club Brugge,1,0,1,W
134372,10,BEL1,2010-07-31,Mechelen,Lokeren,2,0,2,W
134373,10,BEL1,2010-07-31,St Truiden,Lierse,1,0,1,W
134374,10,BEL1,2010-07-31,Westerlo,Gent,0,1,-1,L
134375,10,BEL1,2010-08-01,Cercle Brugge,Charleroi,1,1,0,D
134376,10,BEL1,2010-08-01,Genk,Germinal,2,1,1,W
134377,10,BEL1,2010-08-06,Lierse,Standard,1,4,-3,L
134378,10,BEL1,2010-08-07,Charleroi,Anderlecht,0,0,0,D
134379,10,BEL1,2010-08-07,Club Brugge,St Truiden,4,1,3,W
134380,10,BEL1,2010-08-07,Eupen,Westerlo,0,1,-1,L
134381,10,BEL1,2010-08-07,Lokeren,Kortrijk,1,1,0,D
134382,10,BEL1,2010-08-07,Waregem,Mechelen,1,2,-1,L
134383,10,BEL1,2010-08-08,Gent,Genk,0,4,-4,L
134384,10,BEL1,2010-08-08,Germinal,Cercle Brugge,0,0,0,D
134385,10,BEL1,2010-08-14,Anderlecht,Germinal,4,0,4,W
134386,10,BEL1,2010-08-14,Gent,Eupen,2,1,1,W
134387,10,BEL1,2010-08-14,Kortrijk,St Truiden,2,0,2,W
134388,10,BEL1,2010-08-14,Mechelen,Lierse,1,0,1,W
134389,10,BEL1,2010-08-14,Standard,Lokeren,3,3,0,D
134390,10,BEL1,2010-08-14,Westerlo,Waregem,1,1,0,D
134391,10,BEL1,2010-08-15,Cercle Brugge,Club Brugge,3,1,2,W
134392,10,BEL1,2010-08-15,Genk,Charleroi,5,0,5,W
134393,10,BEL1,2010-08-20,St Truiden,Standard,1,0,1,W
134394,10,BEL1,2010-08-21,Germinal,Westerlo,0,0,0,D
134395,10,BEL1,2010-08-21,Lierse,Kortrijk,1,2,-1,L
134396,10,BEL1,2010-08-21,Lokeren,Anderlecht,0,3,-3,L
134397,10,BEL1,2010-08-21,Waregem,Cercle Brugge,4,0,4,W
134398,10,BEL1,2010-08-22,Charleroi,Gent,1,3,-2,L
134399,10,BEL1,2010-08-22,Club Brugge,Mechelen,1,2,-1,L
134400,10,BEL1,2010-08-22,Eupen,Genk,1,4,-3,L
134401,10,BEL1,2010-08-28,Anderlecht,Waregem,0,0,0,D
134402,10,BEL1,2010-08-28,Cercle Brugge,Lokeren,1,1,0,D
134403,10,BEL1,2010-08-28,Charleroi,Eupen,2,0,2,W
134404,10,BEL1,2010-08-28,Mechelen,St Truiden,0,0,0,D
134405,10,BEL1,2010-08-28,Standard,Kortrijk,1,0,1,W
134406,10,BEL1,2010-08-29,Genk,Lierse,4,1,3,W
134407,10,BEL1,2010-08-29,Gent,Germinal,1,0,1,W
134408,10,BEL1,2010-08-29,Westerlo,Club Brugge,1,2,-1,L
134409,10,BEL1,2010-09-10,St Truiden,Anderlecht,0,2,-2,L
134410,10,BEL1,2010-09-11,Germinal,Charleroi,1,0,1,W
134411,10,BEL1,2010-09-11,Kortrijk,Mechelen,1,0,1,W
134412,10,BEL1,2010-09-11,Lierse,Gent,2,2,0,D
134413,10,BEL1,2010-09-11,Standard,Cercle Brugge,2,0,2,W
134414,10,BEL1,2010-09-11,Waregem,Eupen,0,0,0,D
134415,10,BEL1,2010-09-12,Club Brugge,Genk,2,2,0,D
134416,10,BEL1,2010-09-12,Lokeren,Westerlo,3,1,2,W
134417,10,BEL1,2010-09-17,Mechelen,Standard,1,0,1,W
134418,10,BEL1,2010-09-18,Cercle Brugge,St Truiden,4,2,2,W
134419,10,BEL1,2010-09-18,Eupen,Germinal,0,1,-1,L
134420,10,BEL1,2010-09-18,Genk,Lokeren,3,1,2,W
134421,10,BEL1,2010-09-18,Westerlo,Lierse,2,0,2,W
134422,10,BEL1,2010-09-19,Anderlecht,Kortrijk,3,0,3,W
134423,10,BEL1,2010-09-19,Charleroi,Club Brugge,0,5,-5,L
134424,10,BEL1,2010-09-19,Gent,Waregem,5,3,2,W
134425,10,BEL1,2010-09-21,St Truiden,Genk,0,2,-2,L
134426,10,BEL1,2010-09-22,Club Brugge,Eupen,4,0,4,W
134427,10,BEL1,2010-09-22,Kortrijk,Westerlo,1,2,-1,L
134428,10,BEL1,2010-09-22,Lierse,Anderlecht,1,1,0,D
134429,10,BEL1,2010-09-22,Lokeren,Gent,3,2,1,W
134430,10,BEL1,2010-09-22,Mechelen,Cercle Brugge,2,2,0,D
134431,10,BEL1,2010-09-22,Standard,Charleroi,2,1,1,W
134432,10,BEL1,2010-09-22,Waregem,Germinal,4,3,1,W
134433,10,BEL1,2010-09-25,Cercle Brugge,Kortrijk,2,1,1,W
134434,10,BEL1,2010-09-25,Charleroi,Lierse,0,1,-1,L
134435,10,BEL1,2010-09-25,Eupen,Lokeren,0,1,-1,L
134436,10,BEL1,2010-09-25,Genk,Waregem,3,0,3,W
134437,10,BEL1,2010-09-25,Gent,St Truiden,2,0,2,W
134438,10,BEL1,2010-09-25,Westerlo,Standard,1,2,-1,L
134439,10,BEL1,2010-09-26,Anderlecht,Mechelen,5,0,5,W
134440,10,BEL1,2010-09-26,Germinal,Club Brugge,2,1,1,W
134441,10,BEL1,2010-10-01,Mechelen,Genk,2,2,0,D
134442,10,BEL1,2010-10-02,Kortrijk,Eupen,3,1,2,W
134443,10,BEL1,2010-10-02,Lierse,Cercle Brugge,0,1,-1,L
134444,10,BEL1,2010-10-02,Lokeren,Germinal,1,0,1,W
134445,10,BEL1,2010-10-02,St Truiden,Westerlo,1,2,-1,L
134446,10,BEL1,2010-10-02,Waregem,Charleroi,1,1,0,D
134447,10,BEL1,2010-10-03,Club Brugge,Gent,3,2,1,W
134448,10,BEL1,2010-10-03,Standard,Anderlecht,5,1,4,W
134449,10,BEL1,2010-10-15,Waregem,Club Brugge,2,3,-1,L
134450,10,BEL1,2010-10-16,Charleroi,Lokeren,1,2,-1,L
134451,10,BEL1,2010-10-16,Eupen,St Truiden,6,0,6,W
134452,10,BEL1,2010-10-16,Gent,Kortrijk,2,0,2,W
134453,10,BEL1,2010-10-16,Germinal,Lierse,1,1,0,D
134454,10,BEL1,2010-10-16,Westerlo,Mechelen,1,1,0,D
134455,10,BEL1,2010-10-17,Cercle Brugge,Anderlecht,1,0,1,W
134456,10,BEL1,2010-10-17,Genk,Standard,4,2,2,W
134457,10,BEL1,2010-10-22,Kortrijk,Genk,1,0,1,W
134458,10,BEL1,2010-10-23,Cercle Brugge,Eupen,2,1,1,W
134459,10,BEL1,2010-10-23,Lierse,Waregem,0,0,0,D
134460,10,BEL1,2010-10-23,Mechelen,Germinal,5,1,4,W
134461,10,BEL1,2010-10-23,St Truiden,Charleroi,3,2,1,W
134462,10,BEL1,2010-10-24,Anderlecht,Westerlo,2,0,2,W
134463,10,BEL1,2010-10-24,Lokeren,Club Brugge,1,0,1,W
134464,10,BEL1,2010-10-24,Standard,Gent,2,1,1,W
134465,10,BEL1,2010-10-29,Charleroi,Kortrijk,0,0,0,D
134466,10,BEL1,2010-10-30,Eupen,Lierse,2,2,0,D
134467,10,BEL1,2010-10-30,Gent,Mechelen,3,1,2,W
134468,10,BEL1,2010-10-30,Germinal,St Truiden,0,0,0,D
134469,10,BEL1,2010-10-30,Waregem,Lokeren,1,1,0,D
134470,10,BEL1,2010-10-30,Westerlo,Cercle Brugge,2,1,1,W
134471,10,BEL1,2010-10-31,Club Brugge,Standard,2,2,0,D
134472,10,BEL1,2010-10-31,Genk,Anderlecht,1,2,-1,L
134473,10,BEL1,2010-11-05,Westerlo,Genk,1,1,0,D
134474,10,BEL1,2010-11-06,Kortrijk,Germinal,4,0,4,W
134475,10,BEL1,2010-11-06,Lierse,Lokeren,2,2,0,D
134476,10,BEL1,2010-11-06,Mechelen,Charleroi,2,0,2,W
134477,10,BEL1,2010-11-06,St Truiden,Waregem,0,3,-3,L
134478,10,BEL1,2010-11-06,Standard,Eupen,1,3,-2,L
134479,10,BEL1,2010-11-07,Anderlecht,Club Brugge,2,2,0,D
134480,10,BEL1,2010-11-07,Cercle Brugge,Gent,0,1,-1,L
134481,10,BEL1,2010-11-13,Charleroi,Westerlo,0,1,-1,L
134482,10,BEL1,2010-11-13,Club Brugge,Lierse,2,0,2,W
134483,10,BEL1,2010-11-13,Genk,Cercle Brugge,3,0,3,W
134484,10,BEL1,2010-11-13,Germinal,Standard,0,1,-1,L
134485,10,BEL1,2010-11-13,Lokeren,St Truiden,3,0,3,W
134486,10,BEL1,2010-11-14,Gent,Anderlecht,1,2,-1,L
134487,10,BEL1,2010-11-14,Waregem,Kortrijk,1,1,0,D
134488,10,BEL1,2010-11-20,Charleroi,Genk,1,3,-2,L
134489,10,BEL1,2010-11-20,Eupen,Kortrijk,3,1,2,W
134490,10,BEL1,2010-11-20,Gent,Westerlo,4,4,0,D
134491,10,BEL1,2010-11-20,Germinal,Anderlecht,0,1,-1,L
134492,10,BEL1,2010-11-20,Lierse,St Truiden,1,2,-1,L
134493,10,BEL1,2010-11-20,Lokeren,Mechelen,3,1,2,W
134494,10,BEL1,2010-11-21,Club Brugge,Cercle Brugge,0,1,-1,L
134495,10,BEL1,2010-11-21,Waregem,Standard,2,0,2,W
134496,10,BEL1,2010-11-26,Genk,Gent,1,2,-1,L
134497,10,BEL1,2010-11-27,Anderlecht,Charleroi,4,1,3,W
134498,10,BEL1,2010-11-27,Cercle Brugge,Germinal,1,1,0,D
134499,10,BEL1,2010-11-27,Standard,Lierse,7,0,7,W
134500,10,BEL1,2010-11-27,Westerlo,Eupen,1,1,0,D
134501,10,BEL1,2010-11-28,Mechelen,Waregem,0,0,0,D
134502,10,BEL1,2010-11-28,St Truiden,Club Brugge,2,1,1,W
134503,10,BEL1,2010-12-03,Lokeren,Standard,2,1,1,W
134504,10,BEL1,2010-12-04,Eupen,Gent,0,3,-3,L
134505,10,BEL1,2010-12-04,St Truiden,Kortrijk,1,0,1,W
134506,10,BEL1,2010-12-05,Club Brugge,Westerlo,4,3,1,W
134507,10,BEL1,2010-12-05,Germinal,Genk,0,1,-1,L
134508,10,BEL1,2010-12-05,Waregem,Anderlecht,1,2,-1,L
134509,10,BEL1,2010-12-10,Mechelen,Club Brugge,0,1,-1,L
134510,10,BEL1,2010-12-11,Cercle Brugge,Waregem,1,3,-2,L
134511,10,BEL1,2010-12-11,Genk,Eupen,5,1,4,W
134512,10,BEL1,2010-12-11,Gent,Charleroi,2,1,1,W
134513,10,BEL1,2010-12-11,Standard,St Truiden,1,0,1,W
134514,10,BEL1,2010-12-11,Westerlo,Germinal,1,1,0,D
134515,10,BEL1,2010-12-12,Anderlecht,Lokeren,0,0,0,D
134516,10,BEL1,2010-12-12,Kortrijk,Lierse,3,1,2,W
134517,10,BEL1,2010-12-17,Kortrijk,Standard,2,1,1,W
134518,10,BEL1,2010-12-18,Eupen,Charleroi,1,0,1,W
134519,10,BEL1,2010-12-18,Lierse,Genk,1,1,0,D
134520,10,BEL1,2010-12-18,Waregem,Westerlo,2,0,2,W
134521,10,BEL1,2010-12-19,Club Brugge,Anderlecht,0,2,-2,L
134522,10,BEL1,2010-12-26,Anderlecht,Lierse,6,0,6,W
134523,10,BEL1,2010-12-26,Cercle Brugge,Standard,1,0,1,W
134524,10,BEL1,2010-12-26,Gent,Club Brugge,0,2,-2,L
134525,10,BEL1,2010-12-29,Club Brugge,Charleroi,5,0,5,W
134526,10,BEL1,2010-12-29,Germinal,Eupen,0,0,0,D
134527,10,BEL1,2010-12-29,Kortrijk,Anderlecht,0,2,-2,L
134528,10,BEL1,2010-12-29,Lierse,Westerlo,2,1,1,W
134529,10,BEL1,2010-12-30,Lokeren,Genk,2,2,0,D
134530,10,BEL1,2010-12-30,Waregem,Gent,2,2,0,D
134531,10,BEL1,2011-01-18,Eupen,Mechelen,0,1,-1,L
134532,10,BEL1,2011-01-18,Kortrijk,Lokeren,0,0,0,D
134533,10,BEL1,2011-01-21,Eupen,Club Brugge,1,4,-3,L
134534,10,BEL1,2011-01-22,Cercle Brugge,Lierse,3,0,3,W
134535,10,BEL1,2011-01-22,Charleroi,Mechelen,0,0,0,D
134536,10,BEL1,2011-01-22,Genk,Kortrijk,3,2,1,W
134537,10,BEL1,2011-01-22,Germinal,Waregem,3,0,3,W
134538,10,BEL1,2011-01-22,Westerlo,St Truiden,3,0,3,W
134539,10,BEL1,2011-01-23,Anderlecht,Standard,2,0,2,W
134540,10,BEL1,2011-01-23,Gent,Lokeren,2,1,1,W
134541,10,BEL1,2011-01-28,Waregem,Genk,0,1,-1,L
134542,10,BEL1,2011-01-29,Club Brugge,Germinal,1,0,1,W
134543,10,BEL1,2011-01-29,Kortrijk,Cercle Brugge,2,1,1,W
134544,10,BEL1,2011-01-29,Lierse,Charleroi,1,0,1,W
134545,10,BEL1,2011-01-29,Lokeren,Eupen,0,2,-2,L
134546,10,BEL1,2011-01-29,Standard,Westerlo,2,1,1,W
134547,10,BEL1,2011-01-30,Mechelen,Anderlecht,0,0,0,D
134548,10,BEL1,2011-01-30,St Truiden,Gent,1,1,0,D
134549,10,BEL1,2011-02-02,Charleroi,Germinal,2,0,2,W
134550,10,BEL1,2011-02-02,Eupen,Waregem,0,2,-2,L
134551,10,BEL1,2011-02-02,Genk,St Truiden,1,1,0,D
134552,10,BEL1,2011-02-02,Lokeren,Cercle Brugge,2,1,1,W
134553,10,BEL1,2011-02-02,Mechelen,Kortrijk,1,0,1,W
134554,10,BEL1,2011-02-04,Gent,Lierse,4,1,3,W
134555,10,BEL1,2011-02-05,Anderlecht,St Truiden,2,0,2,W
134556,10,BEL1,2011-02-05,Cercle Brugge,Mechelen,0,1,-1,L
134557,10,BEL1,2011-02-05,Charleroi,Waregem,2,0,2,W
134558,10,BEL1,2011-02-05,Westerlo,Kortrijk,2,1,1,W
134559,10,BEL1,2011-02-06,Eupen,Standard,0,1,-1,L
134560,10,BEL1,2011-02-06,Genk,Club Brugge,1,0,1,W
134561,10,BEL1,2011-02-06,Germinal,Lokeren,1,1,0,D
134562,10,BEL1,2011-02-12,Anderlecht,Cercle Brugge,1,0,1,W
134563,10,BEL1,2011-02-12,Club Brugge,Waregem,2,0,2,W
134564,10,BEL1,2011-02-12,Lierse,Germinal,2,2,0,D
134565,10,BEL1,2011-02-12,Lokeren,Charleroi,1,1,0,D
134566,10,BEL1,2011-02-12,Mechelen,Westerlo,3,1,2,W
134567,10,BEL1,2011-02-12,St Truiden,Eupen,1,1,0,D
134568,10,BEL1,2011-02-13,Kortrijk,Gent,0,1,-1,L
134569,10,BEL1,2011-02-13,Standard,Genk,0,2,-2,L
134570,10,BEL1,2011-02-15,Lierse,Mechelen,2,1,1,W
134571,10,BEL1,2011-02-16,Germinal,Gent,2,2,0,D
134572,10,BEL1,2011-02-16,Westerlo,Lokeren,1,2,-1,L
134573,10,BEL1,2011-02-19,Charleroi,St Truiden,1,0,1,W
134574,10,BEL1,2011-02-19,Club Brugge,Lokeren,2,1,1,W
134575,10,BEL1,2011-02-19,Eupen,Cercle Brugge,0,0,0,D
134576,10,BEL1,2011-02-19,Genk,Mechelen,1,0,1,W
134577,10,BEL1,2011-02-19,Germinal,Kortrijk,3,1,2,W
134578,10,BEL1,2011-02-19,Waregem,Lierse,1,1,0,D
134579,10,BEL1,2011-02-20,Gent,Standard,4,1,3,W
134580,10,BEL1,2011-02-20,Westerlo,Anderlecht,2,0,2,W
134581,10,BEL1,2011-02-23,St Truiden,Mechelen,0,1,-1,L
134582,10,BEL1,2011-02-26,Standard,Mechelen,3,0,3,W
134583,10,BEL1,2011-02-27,St Truiden,Cercle Brugge,0,3,-3,L
134584,10,BEL1,2011-03-04,Anderlecht,Genk,1,1,0,D
134585,10,BEL1,2011-03-05,Cercle Brugge,Westerlo,0,1,-1,L
134586,10,BEL1,2011-03-05,Kortrijk,Charleroi,3,0,3,W
134587,10,BEL1,2011-03-05,Lokeren,Waregem,2,1,1,W
134588,10,BEL1,2011-03-05,Mechelen,Gent,1,1,0,D
134589,10,BEL1,2011-03-05,St Truiden,Germinal,1,0,1,W
134590,10,BEL1,2011-03-06,Lierse,Eupen,1,1,0,D
134591,10,BEL1,2011-03-06,Standard,Club Brugge,2,2,0,D
134592,10,BEL1,2011-03-12,Charleroi,Standard,0,2,-2,L
134593,10,BEL1,2011-03-12,Club Brugge,Kortrijk,4,1,3,W
134594,10,BEL1,2011-03-12,Eupen,Anderlecht,1,1,0,D
134595,10,BEL1,2011-03-12,Genk,Westerlo,0,2,-2,L
134596,10,BEL1,2011-03-12,Gent,Cercle Brugge,1,0,1,W
134597,10,BEL1,2011-03-12,Germinal,Mechelen,1,1,0,D
134598,10,BEL1,2011-03-12,Lokeren,Lierse,1,1,0,D
134599,10,BEL1,2011-03-12,Waregem,St Truiden,1,2,-1,L
134600,10,BEL1,2011-03-19,Kortrijk,Waregem,2,2,0,D
134601,10,BEL1,2011-03-20,Anderlecht,Gent,3,2,1,W
134602,10,BEL1,2011-03-20,Cercle Brugge,Genk,0,1,-1,L
134603,10,BEL1,2011-03-20,Lierse,Club Brugge,0,0,0,D
134604,10,BEL1,2011-03-20,Mechelen,Eupen,2,0,2,W
134605,10,BEL1,2011-03-20,St Truiden,Lokeren,0,2,-2,L
134606,10,BEL1,2011-03-20,Standard,Germinal,1,0,1,W
134607,10,BEL1,2011-03-20,Westerlo,Charleroi,2,2,0,D
134608,10,BEL1,2011-03-23,Charleroi,Cercle Brugge,0,3,-3,L
134609,11,BEL1,2011-07-29,Oud-Heverlee Leuven,Anderlecht,2,1,1,W
134610,11,BEL1,2011-07-30,Bergen,Standard,1,1,0,D
134611,11,BEL1,2011-07-30,Genk,Germinal,3,1,2,W
134612,11,BEL1,2011-07-30,Gent,Cercle Brugge,0,1,-1,L
134613,11,BEL1,2011-07-30,Kortrijk,Lierse,1,1,0,D
134614,11,BEL1,2011-07-30,Lokeren,Waregem,0,0,0,D
134615,11,BEL1,2011-07-30,Mechelen,St Truiden,2,1,1,W
134616,11,BEL1,2011-07-31,Club Brugge,Westerlo,5,0,5,W
134617,11,BEL1,2011-08-05,Anderlecht,Mechelen,3,1,2,W
134618,11,BEL1,2011-08-06,Cercle Brugge,Bergen,1,1,0,D
134619,11,BEL1,2011-08-06,Germinal,Gent,2,2,0,D
134620,11,BEL1,2011-08-06,Lierse,Genk,0,0,0,D
134621,11,BEL1,2011-08-06,Waregem,Oud-Heverlee Leuven,2,1,1,W
134622,11,BEL1,2011-08-07,St Truiden,Club Brugge,3,3,0,D
134623,11,BEL1,2011-08-07,Standard,Lokeren,3,1,2,W
134624,11,BEL1,2011-08-07,Westerlo,Kortrijk,0,0,0,D
134625,11,BEL1,2011-08-13,Bergen,St Truiden,4,2,2,W
134626,11,BEL1,2011-08-13,Club Brugge,Oud-Heverlee Leuven,1,0,1,W
134627,11,BEL1,2011-08-13,Genk,Waregem,2,2,0,D
134628,11,BEL1,2011-08-13,Gent,Standard,3,1,2,W
134629,11,BEL1,2011-08-13,Germinal,Westerlo,3,1,2,W
134630,11,BEL1,2011-08-13,Kortrijk,Cercle Brugge,2,0,2,W
134631,11,BEL1,2011-08-14,Lokeren,Anderlecht,0,1,-1,L
134632,11,BEL1,2011-08-14,Mechelen,Lierse,2,1,1,W
134633,11,BEL1,2011-08-19,Lierse,Germinal,1,1,0,D
134634,11,BEL1,2011-08-20,Cercle Brugge,Genk,3,2,1,W
134635,11,BEL1,2011-08-20,Oud-Heverlee Leuven,Mechelen,1,2,-1,L
134636,11,BEL1,2011-08-20,St Truiden,Lokeren,0,2,-2,L
134637,11,BEL1,2011-08-20,Westerlo,Gent,2,3,-1,L
134638,11,BEL1,2011-08-21,Anderlecht,Bergen,2,2,0,D
134639,11,BEL1,2011-08-21,Standard,Kortrijk,3,1,2,W
134640,11,BEL1,2011-08-21,Waregem,Club Brugge,1,1,0,D
134641,11,BEL1,2011-08-27,Bergen,Waregem,3,1,2,W
134642,11,BEL1,2011-08-27,Genk,Mechelen,0,0,0,D
134643,11,BEL1,2011-08-27,Gent,Lierse,1,0,1,W
134644,11,BEL1,2011-08-27,Kortrijk,St Truiden,4,0,4,W
134645,11,BEL1,2011-08-27,Lokeren,Oud-Heverlee Leuven,0,1,-1,L
134646,11,BEL1,2011-08-27,Westerlo,Cercle Brugge,1,3,-2,L
134647,11,BEL1,2011-08-28,Club Brugge,Anderlecht,1,1,0,D
134648,11,BEL1,2011-08-28,Germinal,Standard,1,1,0,D
134649,11,BEL1,2011-09-09,St Truiden,Genk,3,4,-1,L
134650,11,BEL1,2011-09-10,Cercle Brugge,Germinal,2,1,1,W
134651,11,BEL1,2011-09-10,Lierse,Lokeren,1,1,0,D
134652,11,BEL1,2011-09-10,Oud-Heverlee Leuven,Bergen,3,1,2,W
134653,11,BEL1,2011-09-10,Standard,Westerlo,1,0,1,W
134654,11,BEL1,2011-09-11,Anderlecht,Kortrijk,2,0,2,W
134655,11,BEL1,2011-09-11,Mechelen,Club Brugge,1,2,-1,L
134656,11,BEL1,2011-09-11,Waregem,Gent,1,3,-2,L
134657,11,BEL1,2011-09-17,Bergen,Mechelen,5,1,4,W
134658,11,BEL1,2011-09-17,Cercle Brugge,Lierse,0,0,0,D
134659,11,BEL1,2011-09-17,Germinal,Waregem,2,0,2,W
134660,11,BEL1,2011-09-17,Kortrijk,Oud-Heverlee Leuven,2,0,2,W
134661,11,BEL1,2011-09-17,Westerlo,St Truiden,2,0,2,W
134662,11,BEL1,2011-09-18,Genk,Standard,3,0,3,W
134663,11,BEL1,2011-09-18,Gent,Anderlecht,0,1,-1,L
134664,11,BEL1,2011-09-18,Lokeren,Club Brugge,1,2,-1,L
134665,11,BEL1,2011-09-24,Club Brugge,Bergen,2,1,1,W
134666,11,BEL1,2011-09-24,Lierse,Westerlo,0,0,0,D
134667,11,BEL1,2011-09-24,Mechelen,Lokeren,0,2,-2,L
134668,11,BEL1,2011-09-24,Oud-Heverlee Leuven,Genk,1,1,0,D
134669,11,BEL1,2011-09-24,St Truiden,Gent,3,4,-1,L
134670,11,BEL1,2011-09-24,Waregem,Kortrijk,1,0,1,W
134671,11,BEL1,2011-09-25,Anderlecht,Germinal,3,2,1,W
134672,11,BEL1,2011-09-25,Standard,Cercle Brugge,0,0,0,D
134673,11,BEL1,2011-10-01,Bergen,Lokeren,3,3,0,D
134674,11,BEL1,2011-10-01,Cercle Brugge,St Truiden,2,2,0,D
134675,11,BEL1,2011-10-01,Gent,Oud-Heverlee Leuven,6,1,5,W
134676,11,BEL1,2011-10-01,Kortrijk,Mechelen,1,0,1,W
134677,11,BEL1,2011-10-01,Westerlo,Waregem,1,1,0,D
134678,11,BEL1,2011-10-02,Genk,Anderlecht,0,1,-1,L
134679,11,BEL1,2011-10-02,Germinal,Club Brugge,1,1,0,D
134680,11,BEL1,2011-10-02,Standard,Lierse,2,0,2,W
134681,11,BEL1,2011-10-15,Bergen,Kortrijk,3,1,2,W
134682,11,BEL1,2011-10-15,Lokeren,Genk,3,1,2,W
134683,11,BEL1,2011-10-15,Mechelen,Cercle Brugge,1,2,-1,L
134684,11,BEL1,2011-10-15,Oud-Heverlee Leuven,Westerlo,1,1,0,D
134685,11,BEL1,2011-10-15,St Truiden,Germinal,2,4,-2,L
134686,11,BEL1,2011-10-15,Waregem,Lierse,1,2,-1,L
134687,11,BEL1,2011-10-16,Anderlecht,Standard,5,0,5,W
134688,11,BEL1,2011-10-16,Club Brugge,Gent,2,0,2,W
134689,11,BEL1,2011-10-22,Cercle Brugge,Oud-Heverlee Leuven,2,0,2,W
134690,11,BEL1,2011-10-22,Genk,Bergen,2,0,2,W
134691,11,BEL1,2011-10-22,Gent,Lokeren,3,1,2,W
134692,11,BEL1,2011-10-22,Germinal,Mechelen,2,2,0,D
134693,11,BEL1,2011-10-22,Lierse,St Truiden,0,2,-2,L
134694,11,BEL1,2011-10-23,Kortrijk,Club Brugge,2,1,1,W
134695,11,BEL1,2011-10-23,Standard,Waregem,1,0,1,W
134696,11,BEL1,2011-10-23,Westerlo,Anderlecht,1,2,-1,L
134697,11,BEL1,2011-10-29,Bergen,Gent,1,1,0,D
134698,11,BEL1,2011-10-29,Club Brugge,Genk,4,5,-1,L
134699,11,BEL1,2011-10-29,Lokeren,Kortrijk,1,4,-3,L
134700,11,BEL1,2011-10-29,Mechelen,Westerlo,1,0,1,W
134701,11,BEL1,2011-10-29,Oud-Heverlee Leuven,Germinal,3,2,1,W
134702,11,BEL1,2011-10-29,Waregem,Cercle Brugge,1,1,0,D
134703,11,BEL1,2011-10-30,Anderlecht,Lierse,4,0,4,W
134704,11,BEL1,2011-10-30,St Truiden,Standard,1,1,0,D
134705,11,BEL1,2011-11-04,Gent,Mechelen,6,2,4,W
134706,11,BEL1,2011-11-05,Genk,Kortrijk,2,2,0,D
134707,11,BEL1,2011-11-05,Germinal,Bergen,2,0,2,W
134708,11,BEL1,2011-11-05,Lierse,Oud-Heverlee Leuven,3,1,2,W
134709,11,BEL1,2011-11-05,Waregem,St Truiden,0,0,0,D
134710,11,BEL1,2011-11-05,Westerlo,Lokeren,2,4,-2,L
134711,11,BEL1,2011-11-06,Cercle Brugge,Anderlecht,1,0,1,W
134712,11,BEL1,2011-11-06,Standard,Club Brugge,2,1,1,W
134713,11,BEL1,2011-11-18,Oud-Heverlee Leuven,Standard,1,3,-2,L
134714,11,BEL1,2011-11-19,Bergen,Lierse,2,1,1,W
134715,11,BEL1,2011-11-19,Genk,Westerlo,3,0,3,W
134716,11,BEL1,2011-11-19,Kortrijk,Gent,0,4,-4,L
134717,11,BEL1,2011-11-19,Lokeren,Germinal,1,1,0,D
134718,11,BEL1,2011-11-19,Mechelen,Waregem,1,1,0,D
134719,11,BEL1,2011-11-20,Anderlecht,St Truiden,3,1,2,W
134720,11,BEL1,2011-11-20,Club Brugge,Cercle Brugge,1,0,1,W
134721,11,BEL1,2011-11-25,Standard,Mechelen,3,2,1,W
134722,11,BEL1,2011-11-26,Cercle Brugge,Lokeren,1,1,0,D
134723,11,BEL1,2011-11-26,Germinal,Kortrijk,0,1,-1,L
134724,11,BEL1,2011-11-26,Lierse,Club Brugge,0,1,-1,L
134725,11,BEL1,2011-11-26,St Truiden,Oud-Heverlee Leuven,2,1,1,W
134726,11,BEL1,2011-11-26,Waregem,Anderlecht,2,3,-1,L
134727,11,BEL1,2011-11-26,Westerlo,Bergen,2,1,1,W
134728,11,BEL1,2011-11-27,Gent,Genk,2,0,2,W
134729,11,BEL1,2011-12-02,Germinal,Genk,2,0,2,W
134730,11,BEL1,2011-12-03,Cercle Brugge,Kortrijk,1,2,-1,L
134731,11,BEL1,2011-12-03,Lierse,Mechelen,2,2,0,D
134732,11,BEL1,2011-12-03,St Truiden,Bergen,2,3,-1,L
134733,11,BEL1,2011-12-03,Waregem,Lokeren,1,1,0,D
134734,11,BEL1,2011-12-03,Westerlo,Club Brugge,0,1,-1,L
134735,11,BEL1,2011-12-04,Anderlecht,Oud-Heverlee Leuven,0,0,0,D
134736,11,BEL1,2011-12-04,Standard,Gent,0,0,0,D
134737,11,BEL1,2011-12-09,Mechelen,Anderlecht,2,1,1,W
134738,11,BEL1,2011-12-10,Bergen,Cercle Brugge,0,2,-2,L
134739,11,BEL1,2011-12-10,Genk,Lierse,4,0,4,W
134740,11,BEL1,2011-12-10,Gent,Germinal,0,1,-1,L
134741,11,BEL1,2011-12-10,Kortrijk,Westerlo,1,0,1,W
134742,11,BEL1,2011-12-10,Lokeren,Standard,1,1,0,D
134743,11,BEL1,2011-12-10,Oud-Heverlee Leuven,Waregem,2,2,0,D
134744,11,BEL1,2011-12-11,Club Brugge,St Truiden,1,0,1,W
134745,11,BEL1,2011-12-17,Lierse,Kortrijk,2,0,2,W
134746,11,BEL1,2011-12-17,St Truiden,Mechelen,0,0,0,D
134747,11,BEL1,2011-12-17,Waregem,Bergen,2,3,-1,L
134748,11,BEL1,2011-12-17,Westerlo,Germinal,3,1,2,W
134749,11,BEL1,2011-12-18,Anderlecht,Lokeren,3,2,1,W
134750,11,BEL1,2011-12-18,Cercle Brugge,Gent,0,1,-1,L
134751,11,BEL1,2011-12-18,Oud-Heverlee Leuven,Club Brugge,3,1,2,W
134752,11,BEL1,2011-12-18,Standard,Genk,0,0,0,D
134753,11,BEL1,2011-12-26,Club Brugge,Waregem,1,0,1,W
134754,11,BEL1,2011-12-26,Genk,Cercle Brugge,4,2,2,W
134755,11,BEL1,2011-12-26,Gent,Westerlo,3,1,2,W
134756,11,BEL1,2011-12-26,Germinal,Lierse,0,0,0,D
134757,11,BEL1,2011-12-26,Kortrijk,Standard,2,0,2,W
134758,11,BEL1,2011-12-26,Lokeren,St Truiden,0,0,0,D
134759,11,BEL1,2011-12-26,Mechelen,Oud-Heverlee Leuven,2,2,0,D
134760,11,BEL1,2011-12-27,Bergen,Anderlecht,1,1,0,D
134761,11,BEL1,2012-01-14,Cercle Brugge,Westerlo,3,1,2,W
134762,11,BEL1,2012-01-14,Lierse,Gent,2,1,1,W
134763,11,BEL1,2012-01-14,Mechelen,Bergen,4,1,3,W
134764,11,BEL1,2012-01-14,Oud-Heverlee Leuven,Lokeren,1,1,0,D
134765,11,BEL1,2012-01-14,St Truiden,Kortrijk,0,0,0,D
134766,11,BEL1,2012-01-14,Standard,Germinal,6,1,5,W
134767,11,BEL1,2012-01-15,Anderlecht,Club Brugge,3,0,3,W
134768,11,BEL1,2012-01-15,Waregem,Genk,1,1,0,D
134769,11,BEL1,2012-01-20,Genk,St Truiden,2,1,1,W
134770,11,BEL1,2012-01-21,Bergen,Oud-Heverlee Leuven,2,2,0,D
134771,11,BEL1,2012-01-21,Club Brugge,Mechelen,0,1,-1,L
134772,11,BEL1,2012-01-21,Gent,Waregem,0,0,0,D
134773,11,BEL1,2012-01-21,Germinal,Cercle Brugge,4,0,4,W
134774,11,BEL1,2012-01-21,Kortrijk,Anderlecht,0,1,-1,L
134775,11,BEL1,2012-01-21,Lokeren,Lierse,2,0,2,W
134776,11,BEL1,2012-01-22,Westerlo,Standard,0,0,0,D
134777,11,BEL1,2012-01-24,Anderlecht,Gent,3,1,2,W
134778,11,BEL1,2012-01-25,Club Brugge,Lokeren,3,0,3,W
134779,11,BEL1,2012-01-25,Lierse,Cercle Brugge,2,2,0,D
134780,11,BEL1,2012-01-25,Mechelen,Genk,3,2,1,W
134781,11,BEL1,2012-01-25,Oud-Heverlee Leuven,Kortrijk,0,2,-2,L
134782,11,BEL1,2012-01-25,St Truiden,Westerlo,0,3,-3,L
134783,11,BEL1,2012-01-25,Waregem,Germinal,1,0,1,W
134784,11,BEL1,2012-01-26,Standard,Bergen,2,1,1,W
134785,11,BEL1,2012-01-28,Genk,Oud-Heverlee Leuven,5,0,5,W
134786,11,BEL1,2012-01-28,Gent,St Truiden,6,0,6,W
134787,11,BEL1,2012-01-28,Germinal,Anderlecht,0,0,0,D
134788,11,BEL1,2012-01-28,Kortrijk,Waregem,0,0,0,D
134789,11,BEL1,2012-01-28,Lokeren,Mechelen,3,2,1,W
134790,11,BEL1,2012-01-28,Westerlo,Lierse,0,2,-2,L
134791,11,BEL1,2012-01-29,Bergen,Club Brugge,0,2,-2,L
134792,11,BEL1,2012-01-29,Cercle Brugge,Standard,0,1,-1,L
134793,11,BEL1,2012-02-04,Lierse,Standard,0,2,-2,L
134794,11,BEL1,2012-02-04,Lokeren,Bergen,3,1,2,W
134795,11,BEL1,2012-02-04,Mechelen,Kortrijk,0,0,0,D
134796,11,BEL1,2012-02-04,Oud-Heverlee Leuven,Gent,2,3,-1,L
134797,11,BEL1,2012-02-04,St Truiden,Cercle Brugge,0,1,-1,L
134798,11,BEL1,2012-02-04,Waregem,Westerlo,3,1,2,W
134799,11,BEL1,2012-02-05,Anderlecht,Genk,4,2,2,W
134800,11,BEL1,2012-02-05,Club Brugge,Germinal,5,1,4,W
134801,11,BEL1,2012-02-11,Cercle Brugge,Mechelen,1,0,1,W
134802,11,BEL1,2012-02-11,Genk,Lokeren,0,1,-1,L
134803,11,BEL1,2012-02-11,Germinal,St Truiden,3,2,1,W
134804,11,BEL1,2012-02-11,Kortrijk,Bergen,2,2,0,D
134805,11,BEL1,2012-02-11,Lierse,Waregem,2,1,1,W
134806,11,BEL1,2012-02-11,Westerlo,Oud-Heverlee Leuven,1,3,-2,L
134807,11,BEL1,2012-02-12,Gent,Club Brugge,1,3,-2,L
134808,11,BEL1,2012-02-12,Standard,Anderlecht,1,2,-1,L
134809,11,BEL1,2012-02-18,Bergen,Genk,1,2,-1,L
134810,11,BEL1,2012-02-18,Lokeren,Gent,1,1,0,D
134811,11,BEL1,2012-02-18,Mechelen,Germinal,2,1,1,W
134812,11,BEL1,2012-02-18,Oud-Heverlee Leuven,Cercle Brugge,2,3,-1,L
134813,11,BEL1,2012-02-18,St Truiden,Lierse,1,1,0,D
134814,11,BEL1,2012-02-19,Anderlecht,Westerlo,3,1,2,W
134815,11,BEL1,2012-02-19,Club Brugge,Kortrijk,2,1,1,W
134816,11,BEL1,2012-02-19,Waregem,Standard,4,2,2,W
134817,11,BEL1,2012-02-25,Cercle Brugge,Waregem,1,0,1,W
134818,11,BEL1,2012-02-25,Gent,Bergen,2,0,2,W
134819,11,BEL1,2012-02-25,Germinal,Oud-Heverlee Leuven,2,1,1,W
134820,11,BEL1,2012-02-25,Kortrijk,Lokeren,2,5,-3,L
134821,11,BEL1,2012-02-25,Westerlo,Mechelen,1,3,-2,L
134822,11,BEL1,2012-02-26,Genk,Club Brugge,3,0,3,W
134823,11,BEL1,2012-02-26,Lierse,Anderlecht,0,0,0,D
134824,11,BEL1,2012-02-26,Standard,St Truiden,0,0,0,D
134825,11,BEL1,2012-03-03,Bergen,Germinal,4,2,2,W
134826,11,BEL1,2012-03-03,Kortrijk,Genk,3,2,1,W
134827,11,BEL1,2012-03-03,Lokeren,Westerlo,4,0,4,W
134828,11,BEL1,2012-03-03,Mechelen,Gent,0,2,-2,L
134829,11,BEL1,2012-03-03,Oud-Heverlee Leuven,Lierse,0,0,0,D
134830,11,BEL1,2012-03-03,St Truiden,Waregem,1,0,1,W
134831,11,BEL1,2012-03-04,Anderlecht,Cercle Brugge,4,0,4,W
134832,11,BEL1,2012-03-04,Club Brugge,Standard,1,0,1,W
134833,11,BEL1,2012-03-18,Cercle Brugge,Club Brugge,1,2,-1,L
134834,11,BEL1,2012-03-18,Gent,Kortrijk,3,1,2,W
134835,11,BEL1,2012-03-18,Germinal,Lokeren,2,2,0,D
134836,11,BEL1,2012-03-18,Lierse,Bergen,1,1,0,D
134837,11,BEL1,2012-03-18,St Truiden,Anderlecht,2,2,0,D
134838,11,BEL1,2012-03-18,Standard,Oud-Heverlee Leuven,4,0,4,W
134839,11,BEL1,2012-03-18,Waregem,Mechelen,2,0,2,W
134840,11,BEL1,2012-03-18,Westerlo,Genk,3,2,1,W
134841,11,BEL1,2012-03-21,Anderlecht,Waregem,2,1,1,W
134842,11,BEL1,2012-03-21,Bergen,Westerlo,2,1,1,W
134843,11,BEL1,2012-03-21,Club Brugge,Lierse,1,0,1,W
134844,11,BEL1,2012-03-21,Genk,Gent,3,1,2,W
134845,11,BEL1,2012-03-21,Kortrijk,Germinal,2,0,2,W
134846,11,BEL1,2012-03-21,Lokeren,Cercle Brugge,1,0,1,W
134847,11,BEL1,2012-03-21,Mechelen,Standard,1,2,-1,L
134848,11,BEL1,2012-03-21,Oud-Heverlee Leuven,St Truiden,3,1,2,W
134849,12,BEL1,2012-07-28,Bergen,Oud-Heverlee Leuven,5,2,3,W
134850,12,BEL1,2012-07-28,Club Brugge,Waasland-Beveren,3,1,2,W
134851,12,BEL1,2012-07-28,Germinal,Lokeren,2,4,-2,L
134852,12,BEL1,2012-07-28,Kortrijk,Anderlecht,1,1,0,D
134853,12,BEL1,2012-07-28,Mechelen,Charleroi,4,2,2,W
134854,12,BEL1,2012-07-29,Genk,Cercle Brugge,3,3,0,D
134855,12,BEL1,2012-07-29,Gent,Lierse,2,0,2,W
134856,12,BEL1,2012-07-29,Standard,Waregem,0,1,-1,L
134857,12,BEL1,2012-08-03,Lierse,Standard,0,0,0,D
134858,12,BEL1,2012-08-04,Anderlecht,Germinal,1,0,1,W
134859,12,BEL1,2012-08-04,Cercle Brugge,Kortrijk,1,2,-1,L
134860,12,BEL1,2012-08-04,Charleroi,Club Brugge,0,1,-1,L
134861,12,BEL1,2012-08-04,Lokeren,Bergen,2,2,0,D
134862,12,BEL1,2012-08-04,Waasland-Beveren,Mechelen,0,0,0,D
134863,12,BEL1,2012-08-05,Oud-Heverlee Leuven,Genk,2,2,0,D
134864,12,BEL1,2012-08-05,Waregem,Gent,3,1,2,W
134865,12,BEL1,2012-08-10,Standard,Waasland-Beveren,3,1,2,W
134866,12,BEL1,2012-08-11,Bergen,Lierse,1,1,0,D
134867,12,BEL1,2012-08-11,Germinal,Waregem,1,1,0,D
134868,12,BEL1,2012-08-11,Kortrijk,Charleroi,0,1,-1,L
134869,12,BEL1,2012-08-11,Mechelen,Club Brugge,3,3,0,D
134870,12,BEL1,2012-08-12,Cercle Brugge,Anderlecht,0,3,-3,L
134871,12,BEL1,2012-08-12,Genk,Lokeren,1,0,1,W
134872,12,BEL1,2012-08-12,Gent,Oud-Heverlee Leuven,1,1,0,D
134873,12,BEL1,2012-08-18,Anderlecht,Bergen,2,1,1,W
134874,12,BEL1,2012-08-18,Club Brugge,Germinal,3,1,2,W
134875,12,BEL1,2012-08-18,Lierse,Genk,1,1,0,D
134876,12,BEL1,2012-08-18,Lokeren,Mechelen,2,1,1,W
134877,12,BEL1,2012-08-18,Oud-Heverlee Leuven,Cercle Brugge,3,2,1,W
134878,12,BEL1,2012-08-18,Waasland-Beveren,Gent,0,2,-2,L
134879,12,BEL1,2012-08-18,Waregem,Kortrijk,2,0,2,W
134880,12,BEL1,2012-08-19,Charleroi,Standard,2,6,-4,L
134881,12,BEL1,2012-08-25,Bergen,Club Brugge,1,3,-2,L
134882,12,BEL1,2012-08-25,Cercle Brugge,Lierse,0,3,-3,L
134883,12,BEL1,2012-08-25,Genk,Waregem,2,0,2,W
134884,12,BEL1,2012-08-25,Germinal,Charleroi,2,0,2,W
134885,12,BEL1,2012-08-25,Kortrijk,Waasland-Beveren,2,1,1,W
134886,12,BEL1,2012-08-25,Oud-Heverlee Leuven,Anderlecht,1,1,0,D
134887,12,BEL1,2012-08-25,Standard,Mechelen,3,2,1,W
134888,12,BEL1,2012-08-26,Gent,Lokeren,2,1,1,W
134889,12,BEL1,2012-09-01,Charleroi,Gent,1,1,0,D
134890,12,BEL1,2012-09-01,Lierse,Oud-Heverlee Leuven,1,1,0,D
134891,12,BEL1,2012-09-01,Mechelen,Germinal,0,2,-2,L
134892,12,BEL1,2012-09-01,Waasland-Beveren,Cercle Brugge,2,0,2,W
134893,12,BEL1,2012-09-01,Waregem,Bergen,2,4,-2,L
134894,12,BEL1,2012-09-02,Anderlecht,Genk,2,2,0,D
134895,12,BEL1,2012-09-02,Club Brugge,Standard,4,2,2,W
134896,12,BEL1,2012-09-02,Lokeren,Kortrijk,0,1,-1,L
134897,12,BEL1,2012-09-14,Kortrijk,Club Brugge,1,1,0,D
134898,12,BEL1,2012-09-15,Bergen,Charleroi,2,3,-1,L
134899,12,BEL1,2012-09-15,Cercle Brugge,Lokeren,0,1,-1,L
134900,12,BEL1,2012-09-15,Genk,Waasland-Beveren,1,1,0,D
134901,12,BEL1,2012-09-15,Gent,Mechelen,0,2,-2,L
134902,12,BEL1,2012-09-15,Lierse,Anderlecht,1,1,0,D
134903,12,BEL1,2012-09-15,Oud-Heverlee Leuven,Waregem,0,1,-1,L
134904,12,BEL1,2012-09-16,Germinal,Standard,3,2,1,W
134905,12,BEL1,2012-09-21,Standard,Gent,1,2,-1,L
134906,12,BEL1,2012-09-22,Germinal,Kortrijk,2,1,1,W
134907,12,BEL1,2012-09-22,Lokeren,Oud-Heverlee Leuven,2,2,0,D
134908,12,BEL1,2012-09-22,Mechelen,Bergen,3,0,3,W
134909,12,BEL1,2012-09-22,Waasland-Beveren,Lierse,1,1,0,D
134910,12,BEL1,2012-09-22,Waregem,Anderlecht,2,3,-1,L
134911,12,BEL1,2012-09-23,Charleroi,Genk,1,2,-1,L
134912,12,BEL1,2012-09-23,Club Brugge,Cercle Brugge,4,0,4,W
134913,12,BEL1,2012-09-29,Anderlecht,Lokeren,3,0,3,W
134914,12,BEL1,2012-09-29,Bergen,Germinal,1,0,1,W
134915,12,BEL1,2012-09-29,Cercle Brugge,Charleroi,1,0,1,W
134916,12,BEL1,2012-09-29,Genk,Mechelen,2,1,1,W
134917,12,BEL1,2012-09-29,Lierse,Waregem,1,4,-3,L
134918,12,BEL1,2012-09-29,Oud-Heverlee Leuven,Waasland-Beveren,5,2,3,W
134919,12,BEL1,2012-09-30,Gent,Club Brugge,2,2,0,D
134920,12,BEL1,2012-09-30,Kortrijk,Standard,2,1,1,W
134921,12,BEL1,2012-10-05,Germinal,Gent,2,2,0,D
134922,12,BEL1,2012-10-06,Charleroi,Oud-Heverlee Leuven,0,4,-4,L
134923,12,BEL1,2012-10-06,Lokeren,Lierse,2,2,0,D
134924,12,BEL1,2012-10-06,Mechelen,Kortrijk,0,2,-2,L
134925,12,BEL1,2012-10-06,Waasland-Beveren,Bergen,2,2,0,D
134926,12,BEL1,2012-10-06,Waregem,Cercle Brugge,3,1,2,W
134927,12,BEL1,2012-10-07,Club Brugge,Genk,1,1,0,D
134928,12,BEL1,2012-10-07,Standard,Anderlecht,2,1,1,W
134929,12,BEL1,2012-10-19,Anderlecht,Waasland-Beveren,2,0,2,W
134930,12,BEL1,2012-10-20,Cercle Brugge,Mechelen,1,2,-1,L
134931,12,BEL1,2012-10-20,Genk,Germinal,3,0,3,W
134932,12,BEL1,2012-10-20,Gent,Kortrijk,0,1,-1,L
134933,12,BEL1,2012-10-20,Lierse,Charleroi,0,1,-1,L
134934,12,BEL1,2012-10-20,Oud-Heverlee Leuven,Club Brugge,4,1,3,W
134935,12,BEL1,2012-10-20,Waregem,Lokeren,0,3,-3,L
134936,12,BEL1,2012-10-21,Bergen,Standard,3,1,2,W
134937,12,BEL1,2012-10-26,Standard,Cercle Brugge,2,1,1,W
134938,12,BEL1,2012-10-27,Charleroi,Anderlecht,2,0,2,W
134939,12,BEL1,2012-10-27,Gent,Bergen,2,0,2,W
134940,12,BEL1,2012-10-27,Germinal,Oud-Heverlee Leuven,1,3,-2,L
134941,12,BEL1,2012-10-27,Mechelen,Lierse,3,0,3,W
134942,12,BEL1,2012-10-27,Waasland-Beveren,Waregem,0,2,-2,L
134943,12,BEL1,2012-10-28,Club Brugge,Lokeren,2,3,-1,L
134944,12,BEL1,2012-10-28,Kortrijk,Genk,1,1,0,D
134945,12,BEL1,2012-10-30,Anderlecht,Gent,5,0,5,W
134946,12,BEL1,2012-10-31,Bergen,Kortrijk,1,0,1,W
134947,12,BEL1,2012-10-31,Cercle Brugge,Germinal,3,1,2,W
134948,12,BEL1,2012-10-31,Genk,Standard,0,2,-2,L
134949,12,BEL1,2012-10-31,Lierse,Club Brugge,3,2,1,W
134950,12,BEL1,2012-10-31,Lokeren,Waasland-Beveren,2,0,2,W
134951,12,BEL1,2012-10-31,Oud-Heverlee Leuven,Mechelen,3,1,2,W
134952,12,BEL1,2012-10-31,Waregem,Charleroi,4,1,3,W
134953,12,BEL1,2012-11-03,Bergen,Cercle Brugge,3,2,1,W
134954,12,BEL1,2012-11-03,Charleroi,Lokeren,0,2,-2,L
134955,12,BEL1,2012-11-03,Gent,Genk,1,2,-1,L
134956,12,BEL1,2012-11-03,Germinal,Waasland-Beveren,1,2,-1,L
134957,12,BEL1,2012-11-03,Kortrijk,Lierse,4,1,3,W
134958,12,BEL1,2012-11-03,Mechelen,Anderlecht,1,4,-3,L
134959,12,BEL1,2012-11-04,Club Brugge,Waregem,0,1,-1,L
134960,12,BEL1,2012-11-04,Standard,Oud-Heverlee Leuven,2,0,2,W
134961,12,BEL1,2012-11-09,Lokeren,Standard,2,1,1,W
134962,12,BEL1,2012-11-10,Cercle Brugge,Gent,2,2,0,D
134963,12,BEL1,2012-11-10,Lierse,Germinal,1,3,-2,L
134964,12,BEL1,2012-11-10,Oud-Heverlee Leuven,Kortrijk,0,0,0,D
134965,12,BEL1,2012-11-10,Waasland-Beveren,Charleroi,0,0,0,D
134966,12,BEL1,2012-11-10,Waregem,Mechelen,1,1,0,D
134967,12,BEL1,2012-11-11,Anderlecht,Club Brugge,6,1,5,W
134968,12,BEL1,2012-11-11,Genk,Bergen,5,1,4,W
134969,12,BEL1,2012-11-17,Cercle Brugge,Genk,3,1,2,W
134970,12,BEL1,2012-11-17,Charleroi,Mechelen,1,1,0,D
134971,12,BEL1,2012-11-17,Lierse,Gent,2,0,2,W
134972,12,BEL1,2012-11-17,Oud-Heverlee Leuven,Bergen,1,3,-2,L
134973,12,BEL1,2012-11-17,Waasland-Beveren,Club Brugge,2,6,-4,L
134974,12,BEL1,2012-11-18,Anderlecht,Kortrijk,1,0,1,W
134975,12,BEL1,2012-11-18,Lokeren,Germinal,1,0,1,W
134976,12,BEL1,2012-11-18,Waregem,Standard,0,0,0,D
134977,12,BEL1,2012-11-23,Standard,Lierse,3,0,3,W
134978,12,BEL1,2012-11-24,Bergen,Lokeren,1,2,-1,L
134979,12,BEL1,2012-11-24,Gent,Waregem,0,1,-1,L
134980,12,BEL1,2012-11-24,Germinal,Anderlecht,1,4,-3,L
134981,12,BEL1,2012-11-24,Kortrijk,Cercle Brugge,3,1,2,W
134982,12,BEL1,2012-11-24,Mechelen,Waasland-Beveren,0,1,-1,L
134983,12,BEL1,2012-11-25,Club Brugge,Charleroi,1,0,1,W
134984,12,BEL1,2012-11-25,Genk,Oud-Heverlee Leuven,1,1,0,D
134985,12,BEL1,2012-12-01,Anderlecht,Cercle Brugge,2,1,1,W
134986,12,BEL1,2012-12-01,Charleroi,Kortrijk,2,0,2,W
134987,12,BEL1,2012-12-01,Club Brugge,Mechelen,1,1,0,D
134988,12,BEL1,2012-12-01,Lierse,Bergen,0,3,-3,L
134989,12,BEL1,2012-12-01,Oud-Heverlee Leuven,Gent,1,1,0,D
134990,12,BEL1,2012-12-01,Waregem,Germinal,0,0,0,D
134991,12,BEL1,2012-12-02,Lokeren,Genk,3,4,-1,L
134992,12,BEL1,2012-12-02,Waasland-Beveren,Standard,0,2,-2,L
134993,12,BEL1,2012-12-07,Standard,Charleroi,6,1,5,W
134994,12,BEL1,2012-12-08,Bergen,Anderlecht,0,5,-5,L
134995,12,BEL1,2012-12-08,Cercle Brugge,Oud-Heverlee Leuven,1,1,0,D
134996,12,BEL1,2012-12-08,Gent,Waasland-Beveren,0,2,-2,L
134997,12,BEL1,2012-12-08,Kortrijk,Waregem,1,2,-1,L
134998,12,BEL1,2012-12-08,Mechelen,Lokeren,2,1,1,W
134999,12,BEL1,2012-12-09,Genk,Lierse,4,1,3,W
135000,12,BEL1,2012-12-09,Germinal,Club Brugge,1,7,-6,L
135001,12,BEL1,2012-12-15,Charleroi,Germinal,1,0,1,W
135002,12,BEL1,2012-12-15,Club Brugge,Bergen,2,0,2,W
135003,12,BEL1,2012-12-15,Lierse,Cercle Brugge,1,1,0,D
135004,12,BEL1,2012-12-15,Lokeren,Gent,2,2,0,D
135005,12,BEL1,2012-12-15,Mechelen,Standard,0,2,-2,L
135006,12,BEL1,2012-12-15,Waasland-Beveren,Kortrijk,1,0,1,W
135007,12,BEL1,2012-12-16,Anderlecht,Oud-Heverlee Leuven,2,1,1,W
135008,12,BEL1,2012-12-16,Waregem,Genk,3,2,1,W
135009,12,BEL1,2012-12-21,Kortrijk,Lokeren,2,3,-1,L
135010,12,BEL1,2012-12-22,Bergen,Waregem,1,1,0,D
135011,12,BEL1,2012-12-22,Cercle Brugge,Waasland-Beveren,2,2,0,D
135012,12,BEL1,2012-12-22,Gent,Charleroi,1,2,-1,L
135013,12,BEL1,2012-12-22,Germinal,Mechelen,0,2,-2,L
135014,12,BEL1,2012-12-22,Oud-Heverlee Leuven,Lierse,2,2,0,D
135015,12,BEL1,2012-12-23,Genk,Anderlecht,2,4,-2,L
135016,12,BEL1,2012-12-23,Standard,Club Brugge,1,3,-2,L
135017,12,BEL1,2012-12-26,Charleroi,Bergen,1,2,-1,L
135018,12,BEL1,2012-12-26,Club Brugge,Kortrijk,0,0,0,D
135019,12,BEL1,2012-12-26,Lokeren,Cercle Brugge,3,0,3,W
135020,12,BEL1,2012-12-26,Mechelen,Gent,1,0,1,W
135021,12,BEL1,2012-12-26,Waasland-Beveren,Genk,1,1,0,D
135022,12,BEL1,2012-12-26,Waregem,Oud-Heverlee Leuven,2,1,1,W
135023,12,BEL1,2012-12-27,Anderlecht,Lierse,4,1,3,W
135024,12,BEL1,2012-12-27,Standard,Germinal,3,0,3,W
135025,12,BEL1,2013-01-19,Bergen,Mechelen,2,3,-1,L
135026,12,BEL1,2013-01-19,Genk,Charleroi,3,1,2,W
135027,12,BEL1,2013-01-19,Gent,Standard,0,0,0,D
135028,12,BEL1,2013-01-19,Kortrijk,Germinal,4,0,4,W
135029,12,BEL1,2013-01-19,Lierse,Waasland-Beveren,0,0,0,D
135030,12,BEL1,2013-01-19,Oud-Heverlee Leuven,Lokeren,2,6,-4,L
135031,12,BEL1,2013-01-25,Standard,Kortrijk,2,0,2,W
135032,12,BEL1,2013-01-26,Germinal,Bergen,0,0,0,D
135033,12,BEL1,2013-01-26,Lokeren,Anderlecht,0,2,-2,L
135034,12,BEL1,2013-01-26,Mechelen,Genk,2,1,1,W
135035,12,BEL1,2013-01-26,Waasland-Beveren,Oud-Heverlee Leuven,2,0,2,W
135036,12,BEL1,2013-01-26,Waregem,Lierse,2,0,2,W
135037,12,BEL1,2013-01-27,Club Brugge,Gent,0,0,0,D
135038,12,BEL1,2013-02-02,Bergen,Waasland-Beveren,3,0,3,W
135039,12,BEL1,2013-02-02,Cercle Brugge,Waregem,1,2,-1,L
135040,12,BEL1,2013-02-02,Gent,Germinal,2,1,1,W
135041,12,BEL1,2013-02-02,Kortrijk,Mechelen,2,1,1,W
135042,12,BEL1,2013-02-02,Lierse,Lokeren,1,1,0,D
135043,12,BEL1,2013-02-02,Oud-Heverlee Leuven,Charleroi,1,0,1,W
135044,12,BEL1,2013-02-03,Anderlecht,Standard,2,2,0,D
135045,12,BEL1,2013-02-03,Genk,Club Brugge,4,1,3,W
135046,12,BEL1,2013-02-09,Charleroi,Lierse,1,0,1,W
135047,12,BEL1,2013-02-09,Club Brugge,Oud-Heverlee Leuven,3,1,2,W
135048,12,BEL1,2013-02-09,Germinal,Genk,0,2,-2,L
135049,12,BEL1,2013-02-09,Kortrijk,Gent,1,0,1,W
135050,12,BEL1,2013-02-09,Lokeren,Waregem,1,1,0,D
135051,12,BEL1,2013-02-09,Mechelen,Cercle Brugge,2,0,2,W
135052,12,BEL1,2013-02-10,Standard,Bergen,0,1,-1,L
135053,12,BEL1,2013-02-10,Waasland-Beveren,Anderlecht,1,2,-1,L
135054,12,BEL1,2013-02-15,Anderlecht,Charleroi,2,0,2,W
135055,12,BEL1,2013-02-16,Bergen,Gent,0,2,-2,L
135056,12,BEL1,2013-02-16,Cercle Brugge,Standard,0,1,-1,L
135057,12,BEL1,2013-02-16,Lierse,Mechelen,0,2,-2,L
135058,12,BEL1,2013-02-16,Oud-Heverlee Leuven,Germinal,1,1,0,D
135059,12,BEL1,2013-02-16,Waregem,Waasland-Beveren,2,0,2,W
135060,12,BEL1,2013-02-17,Genk,Kortrijk,2,0,2,W
135061,12,BEL1,2013-02-17,Lokeren,Club Brugge,1,1,0,D
135062,12,BEL1,2013-02-20,Charleroi,Cercle Brugge,2,1,1,W
135063,12,BEL1,2013-02-23,Gent,Cercle Brugge,2,0,2,W
135064,12,BEL1,2013-02-23,Germinal,Lierse,1,3,-2,L
135065,12,BEL1,2013-02-23,Kortrijk,Bergen,0,1,-1,L
135066,12,BEL1,2013-02-23,Mechelen,Oud-Heverlee Leuven,1,2,-1,L
135067,12,BEL1,2013-02-23,Waasland-Beveren,Lokeren,0,0,0,D
135068,12,BEL1,2013-02-24,Club Brugge,Anderlecht,2,2,0,D
135069,12,BEL1,2013-02-24,Standard,Genk,0,0,0,D
135070,12,BEL1,2013-02-27,Anderlecht,Waregem,0,1,-1,L
135071,12,BEL1,2013-02-28,Cercle Brugge,Club Brugge,0,3,-3,L
135072,12,BEL1,2013-03-03,Charleroi,Waregem,0,1,-1,L
135073,12,BEL1,2013-03-09,Anderlecht,Mechelen,1,0,1,W
135074,12,BEL1,2013-03-09,Cercle Brugge,Bergen,1,3,-2,L
135075,12,BEL1,2013-03-09,Genk,Gent,3,2,1,W
135076,12,BEL1,2013-03-09,Lierse,Kortrijk,1,0,1,W
135077,12,BEL1,2013-03-09,Lokeren,Charleroi,1,1,0,D
135078,12,BEL1,2013-03-09,Oud-Heverlee Leuven,Standard,0,4,-4,L
135079,12,BEL1,2013-03-09,Waasland-Beveren,Germinal,3,2,1,W
135080,12,BEL1,2013-03-09,Waregem,Club Brugge,1,2,-1,L
135081,12,BEL1,2013-03-16,Bergen,Genk,1,5,-4,L
135082,12,BEL1,2013-03-16,Charleroi,Waasland-Beveren,3,0,3,W
135083,12,BEL1,2013-03-16,Club Brugge,Lierse,3,0,3,W
135084,12,BEL1,2013-03-16,Gent,Anderlecht,1,1,0,D
135085,12,BEL1,2013-03-16,Germinal,Cercle Brugge,3,1,2,W
135086,12,BEL1,2013-03-16,Kortrijk,Oud-Heverlee Leuven,0,0,0,D
135087,12,BEL1,2013-03-16,Mechelen,Waregem,2,3,-1,L
135088,12,BEL1,2013-03-16,Standard,Lokeren,0,2,-2,L
135089,13,BEL1,2013-07-26,Club Brugge,Charleroi,2,0,2,W
135090,13,BEL1,2013-07-27,Bergen,Cercle Brugge,1,1,0,D
135091,13,BEL1,2013-07-27,Genk,Oostende,3,0,3,W
135092,13,BEL1,2013-07-27,Kortrijk,Oud-Heverlee Leuven,1,0,1,W
135093,13,BEL1,2013-07-27,Lierse,Waregem,1,2,-1,L
135094,13,BEL1,2013-07-27,Waasland-Beveren,Gent,1,1,0,D
135095,13,BEL1,2013-07-28,Anderlecht,Lokeren,2,3,-1,L
135096,13,BEL1,2013-07-28,Mechelen,Standard,0,2,-2,L
135097,13,BEL1,2013-08-02,Cercle Brugge,Anderlecht,0,4,-4,L
135098,13,BEL1,2013-08-03,Charleroi,Waasland-Beveren,1,1,0,D
135099,13,BEL1,2013-08-03,Lokeren,Bergen,2,1,1,W
135100,13,BEL1,2013-08-03,Oud-Heverlee Leuven,Genk,1,4,-3,L
135101,13,BEL1,2013-08-03,Waregem,Kortrijk,1,0,1,W
135102,13,BEL1,2013-08-04,Gent,Mechelen,2,1,1,W
135103,13,BEL1,2013-08-04,Oostende,Club Brugge,1,2,-1,L
135104,13,BEL1,2013-08-04,Standard,Lierse,3,0,3,W
135105,13,BEL1,2013-08-09,Kortrijk,Lokeren,3,3,0,D
135106,13,BEL1,2013-08-10,Bergen,Charleroi,1,2,-1,L
135107,13,BEL1,2013-08-10,Lierse,Cercle Brugge,1,1,0,D
135108,13,BEL1,2013-08-10,Oostende,Oud-Heverlee Leuven,1,1,0,D
135109,13,BEL1,2013-08-10,Waasland-Beveren,Mechelen,0,0,0,D
135110,13,BEL1,2013-08-11,Anderlecht,Gent,4,1,3,W
135111,13,BEL1,2013-08-11,Club Brugge,Waregem,1,1,0,D
135112,13,BEL1,2013-08-11,Genk,Standard,0,2,-2,L
135113,13,BEL1,2013-08-17,Cercle Brugge,Oostende,2,0,2,W
135114,13,BEL1,2013-08-17,Charleroi,Kortrijk,1,2,-1,L
135115,13,BEL1,2013-08-17,Gent,Lierse,2,1,1,W
135116,13,BEL1,2013-08-17,Lokeren,Genk,3,1,2,W
135117,13,BEL1,2013-08-17,Mechelen,Club Brugge,1,2,-1,L
135118,13,BEL1,2013-08-17,Waregem,Bergen,2,0,2,W
135119,13,BEL1,2013-08-18,Standard,Oud-Heverlee Leuven,1,0,1,W
135120,13,BEL1,2013-08-18,Waasland-Beveren,Anderlecht,0,3,-3,L
135121,13,BEL1,2013-08-24,Kortrijk,Mechelen,1,2,-1,L
135122,13,BEL1,2013-08-24,Lierse,Waasland-Beveren,1,0,1,W
135123,13,BEL1,2013-08-24,Oud-Heverlee Leuven,Lokeren,2,1,1,W
135124,13,BEL1,2013-08-25,Anderlecht,Charleroi,5,2,3,W
135125,13,BEL1,2013-08-25,Bergen,Standard,0,2,-2,L
135126,13,BEL1,2013-08-25,Club Brugge,Gent,1,1,0,D
135127,13,BEL1,2013-08-25,Genk,Cercle Brugge,1,0,1,W
135128,13,BEL1,2013-08-25,Oostende,Waregem,1,1,0,D
135129,13,BEL1,2013-08-31,Cercle Brugge,Oud-Heverlee Leuven,1,1,0,D
135130,13,BEL1,2013-08-31,Gent,Bergen,1,0,1,W
135131,13,BEL1,2013-08-31,Lokeren,Oostende,1,0,1,W
135132,13,BEL1,2013-08-31,Mechelen,Lierse,0,0,0,D
135133,13,BEL1,2013-09-01,Charleroi,Genk,1,1,0,D
135134,13,BEL1,2013-09-01,Standard,Kortrijk,2,0,2,W
135135,13,BEL1,2013-09-01,Waasland-Beveren,Club Brugge,1,2,-1,L
135136,13,BEL1,2013-09-01,Waregem,Anderlecht,4,3,1,W
135137,13,BEL1,2013-09-14,Anderlecht,Mechelen,5,0,5,W
135138,13,BEL1,2013-09-14,Bergen,Waasland-Beveren,1,1,0,D
135139,13,BEL1,2013-09-14,Club Brugge,Lierse,4,1,3,W
135140,13,BEL1,2013-09-14,Kortrijk,Gent,3,0,3,W
135141,13,BEL1,2013-09-14,Lokeren,Cercle Brugge,3,0,3,W
135142,13,BEL1,2013-09-14,Oud-Heverlee Leuven,Charleroi,0,0,0,D
135143,13,BEL1,2013-09-15,Genk,Waregem,5,2,3,W
135144,13,BEL1,2013-09-15,Oostende,Standard,2,4,-2,L
135145,13,BEL1,2013-09-21,Charleroi,Cercle Brugge,2,0,2,W
135146,13,BEL1,2013-09-21,Gent,Oostende,1,1,0,D
135147,13,BEL1,2013-09-21,Lierse,Kortrijk,2,0,2,W
135148,13,BEL1,2013-09-21,Mechelen,Bergen,4,2,2,W
135149,13,BEL1,2013-09-22,Club Brugge,Anderlecht,4,0,4,W
135150,13,BEL1,2013-09-22,Standard,Lokeren,2,1,1,W
135151,13,BEL1,2013-09-22,Waasland-Beveren,Genk,0,0,0,D
135152,13,BEL1,2013-09-22,Waregem,Oud-Heverlee Leuven,4,2,2,W
135153,13,BEL1,2013-09-28,Bergen,Club Brugge,0,1,-1,L
135154,13,BEL1,2013-09-28,Genk,Mechelen,1,0,1,W
135155,13,BEL1,2013-09-28,Kortrijk,Waasland-Beveren,2,1,1,W
135156,13,BEL1,2013-09-28,Lokeren,Waregem,2,4,-2,L
135157,13,BEL1,2013-09-28,Oostende,Charleroi,1,0,1,W
135158,13,BEL1,2013-09-28,Oud-Heverlee Leuven,Gent,1,1,0,D
135159,13,BEL1,2013-09-29,Anderlecht,Lierse,2,0,2,W
135160,13,BEL1,2013-09-29,Cercle Brugge,Standard,0,5,-5,L
135161,13,BEL1,2013-10-05,Charleroi,Lokeren,2,1,1,W
135162,13,BEL1,2013-10-05,Club Brugge,Oud-Heverlee Leuven,1,0,1,W
135163,13,BEL1,2013-10-05,Lierse,Bergen,2,1,1,W
135164,13,BEL1,2013-10-05,Mechelen,Cercle Brugge,1,2,-1,L
135165,13,BEL1,2013-10-05,Waasland-Beveren,Oostende,2,0,2,W
135166,13,BEL1,2013-10-06,Anderlecht,Kortrijk,0,1,-1,L
135167,13,BEL1,2013-10-06,Gent,Genk,1,2,-1,L
135168,13,BEL1,2013-10-06,Waregem,Standard,1,0,1,W
135169,13,BEL1,2013-10-18,Bergen,Anderlecht,0,2,-2,L
135170,13,BEL1,2013-10-19,Cercle Brugge,Waregem,1,1,0,D
135171,13,BEL1,2013-10-19,Genk,Lierse,4,0,4,W
135172,13,BEL1,2013-10-19,Lokeren,Gent,2,2,0,D
135173,13,BEL1,2013-10-19,Oostende,Mechelen,0,3,-3,L
135174,13,BEL1,2013-10-19,Oud-Heverlee Leuven,Waasland-Beveren,4,2,2,W
135175,13,BEL1,2013-10-20,Kortrijk,Club Brugge,4,1,3,W
135176,13,BEL1,2013-10-20,Standard,Charleroi,2,2,0,D
135177,13,BEL1,2013-10-25,Gent,Cercle Brugge,1,1,0,D
135178,13,BEL1,2013-10-26,Bergen,Kortrijk,0,1,-1,L
135179,13,BEL1,2013-10-26,Lierse,Oostende,0,2,-2,L
135180,13,BEL1,2013-10-26,Mechelen,Oud-Heverlee Leuven,4,2,2,W
135181,13,BEL1,2013-10-26,Waasland-Beveren,Lokeren,0,2,-2,L
135182,13,BEL1,2013-10-27,Anderlecht,Standard,1,1,0,D
135183,13,BEL1,2013-10-27,Club Brugge,Genk,0,2,-2,L
135184,13,BEL1,2013-10-27,Waregem,Charleroi,1,1,0,D
135185,13,BEL1,2013-10-30,Charleroi,Mechelen,2,2,0,D
135186,13,BEL1,2013-10-30,Genk,Kortrijk,1,0,1,W
135187,13,BEL1,2013-10-30,Lokeren,Lierse,1,0,1,W
135188,13,BEL1,2013-10-30,Oostende,Anderlecht,0,3,-3,L
135189,13,BEL1,2013-10-30,Oud-Heverlee Leuven,Bergen,2,2,0,D
135190,13,BEL1,2013-10-30,Waregem,Gent,3,2,1,W
135191,13,BEL1,2013-10-31,Cercle Brugge,Club Brugge,2,0,2,W
135192,13,BEL1,2013-10-31,Standard,Waasland-Beveren,2,2,0,D
135193,13,BEL1,2013-11-02,Anderlecht,Oud-Heverlee Leuven,3,1,2,W
135194,13,BEL1,2013-11-02,Bergen,Genk,2,3,-1,L
135195,13,BEL1,2013-11-02,Kortrijk,Oostende,2,0,2,W
135196,13,BEL1,2013-11-02,Lierse,Charleroi,2,1,1,W
135197,13,BEL1,2013-11-02,Mechelen,Waregem,2,2,0,D
135198,13,BEL1,2013-11-03,Club Brugge,Lokeren,1,0,1,W
135199,13,BEL1,2013-11-03,Gent,Standard,0,1,-1,L
135200,13,BEL1,2013-11-03,Waasland-Beveren,Cercle Brugge,0,1,-1,L
135201,13,BEL1,2013-11-08,Lokeren,Mechelen,4,0,4,W
135202,13,BEL1,2013-11-09,Cercle Brugge,Kortrijk,3,1,2,W
135203,13,BEL1,2013-11-09,Charleroi,Gent,0,1,-1,L
135204,13,BEL1,2013-11-09,Oostende,Bergen,2,0,2,W
135205,13,BEL1,2013-11-09,Oud-Heverlee Leuven,Lierse,2,0,2,W
135206,13,BEL1,2013-11-10,Genk,Anderlecht,0,1,-1,L
135207,13,BEL1,2013-11-10,Standard,Club Brugge,0,0,0,D
135208,13,BEL1,2013-11-10,Waregem,Waasland-Beveren,2,0,2,W
135209,13,BEL1,2013-11-23,Cercle Brugge,Lierse,2,4,-2,L
135210,13,BEL1,2013-11-23,Charleroi,Anderlecht,2,1,1,W
135211,13,BEL1,2013-11-23,Gent,Waasland-Beveren,2,0,2,W
135212,13,BEL1,2013-11-23,Oostende,Genk,4,0,4,W
135213,13,BEL1,2013-11-23,Oud-Heverlee Leuven,Kortrijk,1,1,0,D
135214,13,BEL1,2013-11-23,Waregem,Mechelen,3,1,2,W
135215,13,BEL1,2013-11-24,Lokeren,Club Brugge,0,3,-3,L
135216,13,BEL1,2013-11-24,Standard,Bergen,1,0,1,W
135217,13,BEL1,2013-11-30,Bergen,Lokeren,1,0,1,W
135218,13,BEL1,2013-11-30,Club Brugge,Oostende,2,0,2,W
135219,13,BEL1,2013-11-30,Mechelen,Gent,0,1,-1,L
135220,13,BEL1,2013-11-30,Waasland-Beveren,Charleroi,0,0,0,D
135221,13,BEL1,2013-12-01,Anderlecht,Cercle Brugge,2,1,1,W
135222,13,BEL1,2013-12-01,Genk,Oud-Heverlee Leuven,3,0,3,W
135223,13,BEL1,2013-12-01,Kortrijk,Waregem,1,1,0,D
135224,13,BEL1,2013-12-01,Lierse,Standard,0,5,-5,L
135225,13,BEL1,2013-12-07,Anderlecht,Waasland-Beveren,2,0,2,W
135226,13,BEL1,2013-12-07,Bergen,Waregem,1,1,0,D
135227,13,BEL1,2013-12-07,Club Brugge,Mechelen,3,0,3,W
135228,13,BEL1,2013-12-07,Kortrijk,Charleroi,1,1,0,D
135229,13,BEL1,2013-12-07,Lierse,Gent,1,3,-2,L
135230,13,BEL1,2013-12-07,Oostende,Cercle Brugge,2,0,2,W
135231,13,BEL1,2013-12-08,Genk,Lokeren,0,2,-2,L
135232,13,BEL1,2013-12-08,Oud-Heverlee Leuven,Standard,0,0,0,D
135233,13,BEL1,2013-12-14,Cercle Brugge,Bergen,2,1,1,W
135234,13,BEL1,2013-12-14,Lokeren,Kortrijk,0,0,0,D
135235,13,BEL1,2013-12-14,Mechelen,Waasland-Beveren,0,0,0,D
135236,13,BEL1,2013-12-14,Oud-Heverlee Leuven,Oostende,1,2,-1,L
135237,13,BEL1,2013-12-15,Charleroi,Club Brugge,2,2,0,D
135238,13,BEL1,2013-12-15,Gent,Anderlecht,1,2,-1,L
135239,13,BEL1,2013-12-15,Standard,Genk,3,1,2,W
135240,13,BEL1,2013-12-15,Waregem,Lierse,3,0,3,W
135241,13,BEL1,2013-12-21,Cercle Brugge,Genk,1,0,1,W
135242,13,BEL1,2013-12-21,Charleroi,Bergen,0,2,-2,L
135243,13,BEL1,2013-12-21,Lokeren,Oud-Heverlee Leuven,2,0,2,W
135244,13,BEL1,2013-12-21,Mechelen,Kortrijk,5,2,3,W
135245,13,BEL1,2013-12-21,Waasland-Beveren,Lierse,3,1,2,W
135246,13,BEL1,2013-12-21,Waregem,Oostende,2,2,0,D
135247,13,BEL1,2013-12-22,Gent,Club Brugge,1,3,-2,L
135248,13,BEL1,2013-12-22,Standard,Anderlecht,1,1,0,D
135249,13,BEL1,2013-12-26,Anderlecht,Waregem,1,0,1,W
135250,13,BEL1,2013-12-26,Bergen,Gent,1,0,1,W
135251,13,BEL1,2013-12-26,Club Brugge,Waasland-Beveren,1,2,-1,L
135252,13,BEL1,2013-12-26,Genk,Charleroi,0,3,-3,L
135253,13,BEL1,2013-12-26,Lierse,Mechelen,3,0,3,W
135254,13,BEL1,2013-12-26,Oostende,Lokeren,0,3,-3,L
135255,13,BEL1,2013-12-26,Oud-Heverlee Leuven,Cercle Brugge,3,0,3,W
135256,13,BEL1,2013-12-27,Kortrijk,Standard,1,5,-4,L
135257,13,BEL1,2014-01-18,Cercle Brugge,Lokeren,0,3,-3,L
135258,13,BEL1,2014-01-18,Charleroi,Oud-Heverlee Leuven,2,0,2,W
135259,13,BEL1,2014-01-18,Gent,Kortrijk,0,1,-1,L
135260,13,BEL1,2014-01-18,Lierse,Club Brugge,1,1,0,D
135261,13,BEL1,2014-01-18,Standard,Oostende,2,0,2,W
135262,13,BEL1,2014-01-18,Waasland-Beveren,Bergen,4,1,3,W
135263,13,BEL1,2014-01-19,Mechelen,Anderlecht,2,1,1,W
135264,13,BEL1,2014-01-19,Waregem,Genk,1,0,1,W
135265,13,BEL1,2014-01-24,Lokeren,Standard,0,1,-1,L
135266,13,BEL1,2014-01-25,Bergen,Mechelen,0,2,-2,L
135267,13,BEL1,2014-01-25,Cercle Brugge,Charleroi,3,0,3,W
135268,13,BEL1,2014-01-25,Kortrijk,Lierse,3,4,-1,L
135269,13,BEL1,2014-01-25,Oostende,Waasland-Beveren,2,1,1,W
135270,13,BEL1,2014-01-25,Oud-Heverlee Leuven,Waregem,1,0,1,W
135271,13,BEL1,2014-01-26,Anderlecht,Club Brugge,2,0,2,W
135272,13,BEL1,2014-01-26,Genk,Gent,1,2,-1,L
135273,13,BEL1,2014-01-31,Lierse,Anderlecht,2,0,2,W
135274,13,BEL1,2014-02-01,Charleroi,Oostende,0,1,-1,L
135275,13,BEL1,2014-02-01,Club Brugge,Bergen,2,1,1,W
135276,13,BEL1,2014-02-01,Gent,Oud-Heverlee Leuven,2,0,2,W
135277,13,BEL1,2014-02-01,Mechelen,Genk,0,2,-2,L
135278,13,BEL1,2014-02-01,Standard,Cercle Brugge,4,0,4,W
135279,13,BEL1,2014-02-01,Waasland-Beveren,Kortrijk,1,1,0,D
135280,13,BEL1,2014-02-02,Waregem,Lokeren,1,1,0,D
135281,13,BEL1,2014-02-08,Bergen,Lierse,1,5,-4,L
135282,13,BEL1,2014-02-08,Cercle Brugge,Waasland-Beveren,0,0,0,D
135283,13,BEL1,2014-02-08,Kortrijk,Anderlecht,2,2,0,D
135284,13,BEL1,2014-02-08,Lokeren,Charleroi,3,1,2,W
135285,13,BEL1,2014-02-08,Oostende,Gent,0,0,0,D
135286,13,BEL1,2014-02-08,Oud-Heverlee Leuven,Mechelen,0,0,0,D
135287,13,BEL1,2014-02-09,Genk,Club Brugge,1,3,-2,L
135288,13,BEL1,2014-02-09,Standard,Waregem,2,0,2,W
135289,13,BEL1,2014-02-14,Club Brugge,Kortrijk,3,1,2,W
135290,13,BEL1,2014-02-15,Charleroi,Standard,0,1,-1,L
135291,13,BEL1,2014-02-15,Lierse,Genk,0,1,-1,L
135292,13,BEL1,2014-02-15,Mechelen,Oostende,1,1,0,D
135293,13,BEL1,2014-02-15,Waasland-Beveren,Oud-Heverlee Leuven,1,0,1,W
135294,13,BEL1,2014-02-15,Waregem,Cercle Brugge,2,1,1,W
135295,13,BEL1,2014-02-16,Anderlecht,Bergen,2,0,2,W
135296,13,BEL1,2014-02-16,Gent,Lokeren,1,1,0,D
135297,13,BEL1,2014-02-21,Lokeren,Anderlecht,2,1,1,W
135298,13,BEL1,2014-02-22,Cercle Brugge,Mechelen,3,2,1,W
135299,13,BEL1,2014-02-22,Charleroi,Waregem,3,2,1,W
135300,13,BEL1,2014-02-22,Kortrijk,Bergen,1,2,-1,L
135301,13,BEL1,2014-02-22,Oostende,Lierse,3,2,1,W
135302,13,BEL1,2014-02-23,Genk,Waasland-Beveren,0,2,-2,L
135303,13,BEL1,2014-02-23,Oud-Heverlee Leuven,Club Brugge,2,5,-3,L
135304,13,BEL1,2014-02-23,Standard,Gent,2,3,-1,L
135305,13,BEL1,2014-02-28,Mechelen,Lokeren,1,0,1,W
135306,13,BEL1,2014-03-01,Bergen,Oostende,3,0,3,W
135307,13,BEL1,2014-03-01,Gent,Charleroi,2,1,1,W
135308,13,BEL1,2014-03-01,Kortrijk,Cercle Brugge,4,0,4,W
135309,13,BEL1,2014-03-01,Lierse,Oud-Heverlee Leuven,0,0,0,D
135310,13,BEL1,2014-03-01,Waasland-Beveren,Waregem,2,2,0,D
135311,13,BEL1,2014-03-02,Anderlecht,Genk,2,0,2,W
135312,13,BEL1,2014-03-02,Club Brugge,Standard,1,0,1,W
135313,13,BEL1,2014-03-08,Cercle Brugge,Gent,1,4,-3,L
135314,13,BEL1,2014-03-08,Charleroi,Lierse,1,1,0,D
135315,13,BEL1,2014-03-08,Genk,Bergen,3,1,2,W
135316,13,BEL1,2014-03-08,Lokeren,Waasland-Beveren,0,0,0,D
135317,13,BEL1,2014-03-08,Oostende,Kortrijk,0,0,0,D
135318,13,BEL1,2014-03-08,Oud-Heverlee Leuven,Anderlecht,1,0,1,W
135319,13,BEL1,2014-03-08,Standard,Mechelen,2,0,2,W
135320,13,BEL1,2014-03-08,Waregem,Club Brugge,1,1,0,D
135321,13,BEL1,2014-03-16,Anderlecht,Oostende,4,0,4,W
135322,13,BEL1,2014-03-16,Bergen,Oud-Heverlee Leuven,3,2,1,W
135323,13,BEL1,2014-03-16,Club Brugge,Cercle Brugge,2,0,2,W
135324,13,BEL1,2014-03-16,Gent,Waregem,0,1,-1,L
135325,13,BEL1,2014-03-16,Kortrijk,Genk,2,2,0,D
135326,13,BEL1,2014-03-16,Lierse,Lokeren,1,2,-1,L
135327,13,BEL1,2014-03-16,Mechelen,Charleroi,0,3,-3,L
135328,13,BEL1,2014-03-16,Waasland-Beveren,Standard,1,1,0,D
135329,14,BEL1,2014-07-25,Standard,Charleroi,3,0,3,W
135330,14,BEL1,2014-07-26,Cercle Brugge,Gent,0,0,0,D
135331,14,BEL1,2014-07-26,Lierse,Oostende,2,0,2,W
135332,14,BEL1,2014-07-26,Waasland-Beveren,Club Brugge,0,2,-2,L
135333,14,BEL1,2014-07-26,Westerlo,Lokeren,1,0,1,W
135334,14,BEL1,2014-07-27,Anderlecht,Mouscron-Peruwelz,3,1,2,W
135335,14,BEL1,2014-07-27,Mechelen,Genk,3,1,2,W
135336,14,BEL1,2014-07-27,Waregem,Kortrijk,2,0,2,W
135337,14,BEL1,2014-08-01,Oostende,Anderlecht,0,2,-2,L
135338,14,BEL1,2014-08-02,Charleroi,Westerlo,2,3,-1,L
135339,14,BEL1,2014-08-02,Genk,Cercle Brugge,1,1,0,D
135340,14,BEL1,2014-08-02,Kortrijk,Standard,2,3,-1,L
135341,14,BEL1,2014-08-02,Mouscron-Peruwelz,Waasland-Beveren,1,0,1,W
135342,14,BEL1,2014-08-03,Club Brugge,Lierse,1,0,1,W
135343,14,BEL1,2014-08-03,Gent,Mechelen,3,1,2,W
135344,14,BEL1,2014-08-03,Lokeren,Waregem,2,1,1,W
135345,14,BEL1,2014-08-08,Genk,Lokeren,0,0,0,D
135346,14,BEL1,2014-08-09,Cercle Brugge,Oostende,0,1,-1,L
135347,14,BEL1,2014-08-09,Lierse,Mouscron-Peruwelz,2,2,0,D
135348,14,BEL1,2014-08-09,Mechelen,Kortrijk,1,2,-1,L
135349,14,BEL1,2014-08-09,Waasland-Beveren,Westerlo,1,1,0,D
135350,14,BEL1,2014-08-10,Anderlecht,Charleroi,1,0,1,W
135351,14,BEL1,2014-08-10,Standard,Gent,0,1,-1,L
135352,14,BEL1,2014-08-10,Waregem,Club Brugge,1,1,0,D
135353,14,BEL1,2014-08-15,Club Brugge,Cercle Brugge,1,1,0,D
135354,14,BEL1,2014-08-15,Mouscron-Peruwelz,Standard,5,2,3,W
135355,14,BEL1,2014-08-16,Charleroi,Waasland-Beveren,2,2,0,D
135356,14,BEL1,2014-08-16,Kortrijk,Genk,1,1,0,D
135357,14,BEL1,2014-08-16,Lokeren,Lierse,2,0,2,W
135358,14,BEL1,2014-08-16,Oostende,Mechelen,2,0,2,W
135359,14,BEL1,2014-08-17,Gent,Waregem,3,1,2,W
135360,14,BEL1,2014-08-17,Westerlo,Anderlecht,2,2,0,D
135361,14,BEL1,2014-08-22,Genk,Gent,3,2,1,W
135362,14,BEL1,2014-08-23,Kortrijk,Oostende,0,2,-2,L
135363,14,BEL1,2014-08-23,Lierse,Charleroi,0,2,-2,L
135364,14,BEL1,2014-08-23,Standard,Westerlo,2,2,0,D
135365,14,BEL1,2014-08-23,Waregem,Mouscron-Peruwelz,1,1,0,D
135366,14,BEL1,2014-08-24,Anderlecht,Waasland-Beveren,1,0,1,W
135367,14,BEL1,2014-08-24,Cercle Brugge,Lokeren,1,0,1,W
135368,14,BEL1,2014-08-24,Mechelen,Club Brugge,3,1,2,W
135369,14,BEL1,2014-08-29,Gent,Kortrijk,0,1,-1,L
135370,14,BEL1,2014-08-30,Mouscron-Peruwelz,Cercle Brugge,4,0,4,W
135371,14,BEL1,2014-08-30,Oostende,Genk,1,1,0,D
135372,14,BEL1,2014-08-30,Waasland-Beveren,Lierse,2,0,2,W
135373,14,BEL1,2014-08-30,Westerlo,Waregem,2,2,0,D
135374,14,BEL1,2014-08-31,Charleroi,Mechelen,2,0,2,W
135375,14,BEL1,2014-08-31,Club Brugge,Anderlecht,2,2,0,D
135376,14,BEL1,2014-08-31,Lokeren,Standard,1,1,0,D
135377,14,BEL1,2014-09-13,Cercle Brugge,Charleroi,1,0,1,W
135378,14,BEL1,2014-09-13,Lierse,Anderlecht,2,2,0,D
135379,14,BEL1,2014-09-13,Mechelen,Westerlo,5,2,3,W
135380,14,BEL1,2014-09-13,Standard,Oostende,3,5,-2,L
135381,14,BEL1,2014-09-13,Waregem,Waasland-Beveren,1,4,-3,L
135382,14,BEL1,2014-09-14,Genk,Club Brugge,1,1,0,D
135383,14,BEL1,2014-09-14,Gent,Mouscron-Peruwelz,1,0,1,W
135384,14,BEL1,2014-09-14,Kortrijk,Lokeren,2,3,-1,L
135385,14,BEL1,2014-09-19,Charleroi,Waregem,2,1,1,W
135386,14,BEL1,2014-09-20,Anderlecht,Cercle Brugge,3,2,1,W
135387,14,BEL1,2014-09-20,Mouscron-Peruwelz,Genk,1,2,-1,L
135388,14,BEL1,2014-09-20,Oostende,Gent,1,3,-2,L
135389,14,BEL1,2014-09-20,Westerlo,Lierse,6,1,5,W
135390,14,BEL1,2014-09-21,Club Brugge,Kortrijk,5,0,5,W
135391,14,BEL1,2014-09-21,Lokeren,Mechelen,3,2,1,W
135392,14,BEL1,2014-09-21,Waasland-Beveren,Standard,0,2,-2,L
135393,14,BEL1,2014-09-27,Cercle Brugge,Westerlo,1,2,-1,L
135394,14,BEL1,2014-09-27,Genk,Charleroi,1,1,0,D
135395,14,BEL1,2014-09-27,Kortrijk,Mouscron-Peruwelz,3,0,3,W
135396,14,BEL1,2014-09-27,Mechelen,Waasland-Beveren,2,0,2,W
135397,14,BEL1,2014-09-27,Waregem,Anderlecht,0,2,-2,L
135398,14,BEL1,2014-09-28,Gent,Lokeren,1,1,0,D
135399,14,BEL1,2014-09-28,Oostende,Club Brugge,2,2,0,D
135400,14,BEL1,2014-09-28,Standard,Lierse,2,2,0,D
135401,14,BEL1,2014-10-03,Westerlo,Gent,0,0,0,D
135402,14,BEL1,2014-10-04,Charleroi,Kortrijk,0,2,-2,L
135403,14,BEL1,2014-10-04,Lierse,Waregem,3,1,2,W
135404,14,BEL1,2014-10-04,Mouscron-Peruwelz,Mechelen,1,1,0,D
135405,14,BEL1,2014-10-04,Waasland-Beveren,Cercle Brugge,1,0,1,W
135406,14,BEL1,2014-10-05,Anderlecht,Genk,0,0,0,D
135407,14,BEL1,2014-10-05,Club Brugge,Standard,3,0,3,W
135408,14,BEL1,2014-10-05,Lokeren,Oostende,3,1,2,W
135409,14,BEL1,2014-10-18,Cercle Brugge,Lierse,1,2,-1,L
135410,14,BEL1,2014-10-18,Gent,Charleroi,2,2,0,D
135411,14,BEL1,2014-10-18,Kortrijk,Waasland-Beveren,2,1,1,W
135412,14,BEL1,2014-10-18,Mechelen,Anderlecht,1,1,0,D
135413,14,BEL1,2014-10-18,Oostende,Mouscron-Peruwelz,0,0,0,D
135414,14,BEL1,2014-10-19,Genk,Westerlo,3,1,2,W
135415,14,BEL1,2014-10-19,Lokeren,Club Brugge,1,3,-2,L
135416,14,BEL1,2014-10-19,Standard,Waregem,1,2,-1,L
135417,14,BEL1,2014-10-24,Lierse,Mechelen,0,1,-1,L
135418,14,BEL1,2014-10-25,Charleroi,Oostende,2,0,2,W
135419,14,BEL1,2014-10-25,Waasland-Beveren,Genk,0,1,-1,L
135420,14,BEL1,2014-10-25,Waregem,Cercle Brugge,1,2,-1,L
135421,14,BEL1,2014-10-25,Westerlo,Kortrijk,2,1,1,W
135422,14,BEL1,2014-10-26,Anderlecht,Standard,0,2,-2,L
135423,14,BEL1,2014-10-26,Club Brugge,Gent,2,2,0,D
135424,14,BEL1,2014-10-26,Mouscron-Peruwelz,Lokeren,2,2,0,D
135425,14,BEL1,2014-10-28,Genk,Lierse,3,0,3,W
135426,14,BEL1,2014-10-28,Mechelen,Waregem,1,1,0,D
135427,14,BEL1,2014-10-29,Cercle Brugge,Standard,0,1,-1,L
135428,14,BEL1,2014-10-29,Gent,Waasland-Beveren,4,1,3,W
135429,14,BEL1,2014-10-29,Kortrijk,Anderlecht,2,3,-1,L
135430,14,BEL1,2014-10-29,Lokeren,Charleroi,5,2,3,W
135431,14,BEL1,2014-10-29,Oostende,Westerlo,4,0,4,W
135432,14,BEL1,2014-10-30,Mouscron-Peruwelz,Club Brugge,1,4,-3,L
135433,14,BEL1,2014-10-31,Waregem,Genk,2,0,2,W
135434,14,BEL1,2014-11-01,Anderlecht,Lokeren,1,1,0,D
135435,14,BEL1,2014-11-01,Cercle Brugge,Kortrijk,0,4,-4,L
135436,14,BEL1,2014-11-01,Standard,Mechelen,2,0,2,W
135437,14,BEL1,2014-11-01,Waasland-Beveren,Oostende,1,0,1,W
135438,14,BEL1,2014-11-02,Charleroi,Club Brugge,0,0,0,D
135439,14,BEL1,2014-11-02,Lierse,Gent,0,1,-1,L
135440,14,BEL1,2014-11-02,Westerlo,Mouscron-Peruwelz,1,3,-2,L
135441,14,BEL1,2014-11-07,Oostende,Waregem,1,3,-2,L
135442,14,BEL1,2014-11-08,Kortrijk,Lierse,1,0,1,W
135443,14,BEL1,2014-11-08,Mechelen,Cercle Brugge,1,1,0,D
135444,14,BEL1,2014-11-08,Mouscron-Peruwelz,Charleroi,0,2,-2,L
135445,14,BEL1,2014-11-09,Club Brugge,Westerlo,5,0,5,W
135446,14,BEL1,2014-11-09,Genk,Standard,0,2,-2,L
135447,14,BEL1,2014-11-09,Gent,Anderlecht,0,2,-2,L
135448,14,BEL1,2014-11-09,Lokeren,Waasland-Beveren,3,0,3,W
135449,14,BEL1,2014-11-22,Charleroi,Anderlecht,3,1,2,W
135450,14,BEL1,2014-11-22,Club Brugge,Waasland-Beveren,4,2,2,W
135451,14,BEL1,2014-11-22,Gent,Cercle Brugge,4,0,4,W
135452,14,BEL1,2014-11-22,Lokeren,Westerlo,0,0,0,D
135453,14,BEL1,2014-11-22,Mouscron-Peruwelz,Lierse,2,1,1,W
135454,14,BEL1,2014-11-23,Genk,Mechelen,3,0,3,W
135455,14,BEL1,2014-11-23,Kortrijk,Waregem,3,1,2,W
135456,14,BEL1,2014-11-23,Oostende,Standard,3,2,1,W
135457,14,BEL1,2014-11-28,Waregem,Gent,2,1,1,W
135458,14,BEL1,2014-11-29,Cercle Brugge,Genk,0,1,-1,L
135459,14,BEL1,2014-11-29,Mechelen,Oostende,0,0,0,D
135460,14,BEL1,2014-11-29,Waasland-Beveren,Mouscron-Peruwelz,2,1,1,W
135461,14,BEL1,2014-11-29,Westerlo,Charleroi,2,3,-1,L
135462,14,BEL1,2014-11-30,Anderlecht,Club Brugge,2,2,0,D
135463,14,BEL1,2014-11-30,Lierse,Lokeren,1,1,0,D
135464,14,BEL1,2014-11-30,Standard,Kortrijk,0,2,-2,L
135465,14,BEL1,2014-12-05,Westerlo,Waasland-Beveren,1,2,-1,L
135466,14,BEL1,2014-12-06,Kortrijk,Mechelen,3,0,3,W
135467,14,BEL1,2014-12-06,Lokeren,Cercle Brugge,0,0,0,D
135468,14,BEL1,2014-12-06,Mouscron-Peruwelz,Anderlecht,4,2,2,W
135469,14,BEL1,2014-12-06,Oostende,Lierse,2,1,1,W
135470,14,BEL1,2014-12-07,Charleroi,Standard,0,1,-1,L
135471,14,BEL1,2014-12-07,Club Brugge,Waregem,2,1,1,W
135472,14,BEL1,2014-12-07,Gent,Genk,0,0,0,D
135473,14,BEL1,2014-12-12,Mechelen,Gent,0,0,0,D
135474,14,BEL1,2014-12-13,Cercle Brugge,Mouscron-Peruwelz,2,1,1,W
135475,14,BEL1,2014-12-13,Genk,Kortrijk,3,0,3,W
135476,14,BEL1,2014-12-13,Lierse,Westerlo,3,3,0,D
135477,14,BEL1,2014-12-13,Waasland-Beveren,Charleroi,1,3,-2,L
135478,14,BEL1,2014-12-14,Anderlecht,Oostende,3,0,3,W
135479,14,BEL1,2014-12-14,Standard,Club Brugge,1,3,-2,L
135480,14,BEL1,2014-12-14,Waregem,Lokeren,1,0,1,W
135481,14,BEL1,2014-12-20,Charleroi,Lierse,6,0,6,W
135482,14,BEL1,2014-12-20,Mouscron-Peruwelz,Waregem,0,1,-1,L
135483,14,BEL1,2014-12-20,Oostende,Cercle Brugge,2,0,2,W
135484,14,BEL1,2014-12-20,Waasland-Beveren,Anderlecht,0,2,-2,L
135485,14,BEL1,2014-12-20,Westerlo,Mechelen,1,1,0,D
135486,14,BEL1,2014-12-21,Club Brugge,Genk,4,1,3,W
135487,14,BEL1,2014-12-21,Gent,Standard,1,2,-1,L
135488,14,BEL1,2014-12-21,Lokeren,Kortrijk,1,2,-1,L
135489,14,BEL1,2014-12-26,Anderlecht,Westerlo,4,0,4,W
135490,14,BEL1,2014-12-26,Kortrijk,Gent,2,3,-1,L
135491,14,BEL1,2014-12-26,Lierse,Club Brugge,0,6,-6,L
135492,14,BEL1,2014-12-26,Mechelen,Mouscron-Peruwelz,1,0,1,W
135493,14,BEL1,2014-12-26,Waregem,Charleroi,1,3,-2,L
135494,14,BEL1,2014-12-27,Cercle Brugge,Waasland-Beveren,1,0,1,W
135495,14,BEL1,2014-12-27,Standard,Lokeren,2,0,2,W
135496,14,BEL1,2015-01-16,Club Brugge,Mechelen,1,1,0,D
135497,14,BEL1,2015-01-17,Charleroi,Cercle Brugge,0,2,-2,L
135498,14,BEL1,2015-01-17,Mouscron-Peruwelz,Gent,1,3,-2,L
135499,14,BEL1,2015-01-17,Oostende,Kortrijk,1,7,-6,L
135500,14,BEL1,2015-01-17,Waasland-Beveren,Waregem,1,3,-2,L
135501,14,BEL1,2015-01-18,Anderlecht,Lierse,3,0,3,W
135502,14,BEL1,2015-01-18,Lokeren,Genk,1,1,0,D
135503,14,BEL1,2015-01-18,Westerlo,Standard,1,1,0,D
135504,14,BEL1,2015-01-23,Genk,Mouscron-Peruwelz,2,0,2,W
135505,14,BEL1,2015-01-24,Kortrijk,Charleroi,0,0,0,D
135506,14,BEL1,2015-01-24,Lierse,Waasland-Beveren,1,1,0,D
135507,14,BEL1,2015-01-24,Mechelen,Lokeren,0,1,-1,L
135508,14,BEL1,2015-01-24,Waregem,Westerlo,1,3,-2,L
135509,14,BEL1,2015-01-25,Cercle Brugge,Club Brugge,0,3,-3,L
135510,14,BEL1,2015-01-25,Gent,Oostende,3,1,2,W
135511,14,BEL1,2015-01-25,Standard,Anderlecht,2,0,2,W
135512,14,BEL1,2015-01-30,Club Brugge,Oostende,2,0,2,W
135513,14,BEL1,2015-01-31,Charleroi,Genk,1,0,1,W
135514,14,BEL1,2015-01-31,Mouscron-Peruwelz,Kortrijk,0,3,-3,L
135515,14,BEL1,2015-01-31,Waasland-Beveren,Mechelen,2,2,0,D
135516,14,BEL1,2015-01-31,Westerlo,Cercle Brugge,1,0,1,W
135517,14,BEL1,2015-02-01,Anderlecht,Waregem,0,0,0,D
135518,14,BEL1,2015-02-01,Lierse,Standard,2,3,-1,L
135519,14,BEL1,2015-02-01,Lokeren,Gent,3,3,0,D
135520,14,BEL1,2015-02-03,Genk,Oostende,1,1,0,D
135521,14,BEL1,2015-02-06,Standard,Mouscron-Peruwelz,3,0,3,W
135522,14,BEL1,2015-02-07,Gent,Westerlo,4,0,4,W
135523,14,BEL1,2015-02-07,Mechelen,Charleroi,0,0,0,D
135524,14,BEL1,2015-02-07,Oostende,Lokeren,0,1,-1,L
135525,14,BEL1,2015-02-07,Waregem,Lierse,2,3,-1,L
135526,14,BEL1,2015-02-08,Cercle Brugge,Anderlecht,0,2,-2,L
135527,14,BEL1,2015-02-08,Genk,Waasland-Beveren,1,0,1,W
135528,14,BEL1,2015-02-08,Kortrijk,Club Brugge,2,0,2,W
135529,14,BEL1,2015-02-13,Westerlo,Genk,1,2,-1,L
135530,14,BEL1,2015-02-14,Lierse,Cercle Brugge,2,1,1,W
135531,14,BEL1,2015-02-14,Mouscron-Peruwelz,Oostende,0,1,-1,L
135532,14,BEL1,2015-02-14,Waasland-Beveren,Kortrijk,1,0,1,W
135533,14,BEL1,2015-02-14,Waregem,Standard,1,1,0,D
135534,14,BEL1,2015-02-15,Anderlecht,Mechelen,1,1,0,D
135535,14,BEL1,2015-02-15,Charleroi,Gent,0,0,0,D
135536,14,BEL1,2015-02-15,Club Brugge,Lokeren,1,1,0,D
135537,14,BEL1,2015-02-20,Standard,Waasland-Beveren,3,2,1,W
135538,14,BEL1,2015-02-21,Cercle Brugge,Waregem,2,2,0,D
135539,14,BEL1,2015-02-21,Kortrijk,Westerlo,6,0,6,W
135540,14,BEL1,2015-02-21,Lokeren,Mouscron-Peruwelz,1,0,1,W
135541,14,BEL1,2015-02-21,Oostende,Charleroi,1,3,-2,L
135542,14,BEL1,2015-02-22,Genk,Anderlecht,0,1,-1,L
135543,14,BEL1,2015-02-22,Gent,Club Brugge,2,1,1,W
135544,14,BEL1,2015-02-22,Mechelen,Lierse,2,1,1,W
135545,14,BEL1,2015-02-27,Standard,Cercle Brugge,1,0,1,W
135546,14,BEL1,2015-02-28,Charleroi,Lokeren,1,0,1,W
135547,14,BEL1,2015-02-28,Lierse,Genk,0,2,-2,L
135548,14,BEL1,2015-02-28,Waregem,Mechelen,2,3,-1,L
135549,14,BEL1,2015-02-28,Westerlo,Oostende,3,0,3,W
135550,14,BEL1,2015-03-01,Anderlecht,Kortrijk,2,0,2,W
135551,14,BEL1,2015-03-01,Club Brugge,Mouscron-Peruwelz,3,0,3,W
135552,14,BEL1,2015-03-01,Waasland-Beveren,Gent,0,1,-1,L
135553,14,BEL1,2015-03-07,Club Brugge,Charleroi,1,0,1,W
135554,14,BEL1,2015-03-07,Genk,Waregem,3,2,1,W
135555,14,BEL1,2015-03-07,Gent,Lierse,2,1,1,W
135556,14,BEL1,2015-03-07,Kortrijk,Cercle Brugge,1,0,1,W
135557,14,BEL1,2015-03-07,Lokeren,Anderlecht,1,2,-1,L
135558,14,BEL1,2015-03-07,Mechelen,Standard,1,0,1,W
135559,14,BEL1,2015-03-07,Mouscron-Peruwelz,Westerlo,1,0,1,W
135560,14,BEL1,2015-03-07,Oostende,Waasland-Beveren,4,3,1,W
135561,14,BEL1,2015-03-15,Anderlecht,Gent,1,2,-1,L
135562,14,BEL1,2015-03-15,Cercle Brugge,Mechelen,2,3,-1,L
135563,14,BEL1,2015-03-15,Charleroi,Mouscron-Peruwelz,2,0,2,W
135564,14,BEL1,2015-03-15,Lierse,Kortrijk,0,0,0,D
135565,14,BEL1,2015-03-15,Standard,Genk,1,0,1,W
135566,14,BEL1,2015-03-15,Waasland-Beveren,Lokeren,0,0,0,D
135567,14,BEL1,2015-03-15,Waregem,Oostende,1,4,-3,L
135568,14,BEL1,2015-03-15,Westerlo,Club Brugge,1,3,-2,L
135569,15,BEL1,2015-07-24,St Truiden,Club Brugge,2,1,1,W
135570,15,BEL1,2015-07-25,Genk,Oud-Heverlee Leuven,3,1,2,W
135571,15,BEL1,2015-07-25,Kortrijk,Standard,2,1,1,W
135572,15,BEL1,2015-07-25,Oostende,Mechelen,3,1,2,W
135573,15,BEL1,2015-07-25,Waregem,Lokeren,3,1,2,W
135574,15,BEL1,2015-07-26,Anderlecht,Waasland-Beveren,3,2,1,W
135575,15,BEL1,2015-07-26,Charleroi,Mouscron-Peruwelz,2,1,1,W
135576,15,BEL1,2015-07-26,Westerlo,Gent,1,1,0,D
135577,15,BEL1,2015-07-31,Gent,Genk,1,0,1,W
135578,15,BEL1,2015-08-01,Club Brugge,Mechelen,3,0,3,W
135579,15,BEL1,2015-08-01,Mouscron-Peruwelz,St Truiden,0,2,-2,L
135580,15,BEL1,2015-08-01,Oostende,Westerlo,2,1,1,W
135581,15,BEL1,2015-08-01,Waasland-Beveren,Kortrijk,2,1,1,W
135582,15,BEL1,2015-08-02,Lokeren,Charleroi,2,2,0,D
135583,15,BEL1,2015-08-02,Oud-Heverlee Leuven,Anderlecht,0,2,-2,L
135584,15,BEL1,2015-08-02,Standard,Waregem,2,1,1,W
135585,15,BEL1,2015-08-07,Waregem,Genk,0,0,0,D
135586,15,BEL1,2015-08-08,Kortrijk,Lokeren,0,0,0,D
135587,15,BEL1,2015-08-08,Mechelen,Mouscron-Peruwelz,3,1,2,W
135588,15,BEL1,2015-08-08,St Truiden,Oostende,1,1,0,D
135589,15,BEL1,2015-08-08,Westerlo,Oud-Heverlee Leuven,3,2,1,W
135590,15,BEL1,2015-08-09,Anderlecht,Gent,1,1,0,D
135591,15,BEL1,2015-08-09,Charleroi,Club Brugge,0,0,0,D
135592,15,BEL1,2015-08-09,Standard,Waasland-Beveren,1,0,1,W
135593,15,BEL1,2015-08-14,Club Brugge,Kortrijk,2,1,1,W
135594,15,BEL1,2015-08-15,Genk,Westerlo,2,1,1,W
135595,15,BEL1,2015-08-15,Lokeren,Mechelen,2,0,2,W
135596,15,BEL1,2015-08-15,Mouscron-Peruwelz,Standard,1,1,0,D
135597,15,BEL1,2015-08-15,Waasland-Beveren,Waregem,2,1,1,W
135598,15,BEL1,2015-08-16,Gent,St Truiden,1,0,1,W
135599,15,BEL1,2015-08-16,Oostende,Anderlecht,3,1,2,W
135600,15,BEL1,2015-08-16,Oud-Heverlee Leuven,Charleroi,2,0,2,W
135601,15,BEL1,2015-08-21,St Truiden,Genk,3,1,2,W
135602,15,BEL1,2015-08-22,Charleroi,Westerlo,0,0,0,D
135603,15,BEL1,2015-08-22,Mechelen,Oud-Heverlee Leuven,2,1,1,W
135604,15,BEL1,2015-08-22,Waasland-Beveren,Mouscron-Peruwelz,3,3,0,D
135605,15,BEL1,2015-08-22,Waregem,Club Brugge,2,0,2,W
135606,15,BEL1,2015-08-23,Anderlecht,Lokeren,1,0,1,W
135607,15,BEL1,2015-08-23,Kortrijk,Gent,0,0,0,D
135608,15,BEL1,2015-08-23,Standard,Oostende,1,2,-1,L
135609,15,BEL1,2015-08-28,Genk,Charleroi,2,0,2,W
135610,15,BEL1,2015-08-29,Gent,Mechelen,2,2,0,D
135611,15,BEL1,2015-08-29,Mouscron-Peruwelz,Kortrijk,0,1,-1,L
135612,15,BEL1,2015-08-29,Oostende,Waregem,0,2,-2,L
135613,15,BEL1,2015-08-29,Oud-Heverlee Leuven,St Truiden,1,0,1,W
135614,15,BEL1,2015-08-30,Club Brugge,Standard,7,1,6,W
135615,15,BEL1,2015-08-30,Lokeren,Waasland-Beveren,1,2,-1,L
135616,15,BEL1,2015-08-30,Westerlo,Anderlecht,0,3,-3,L
135617,15,BEL1,2015-09-11,Mouscron-Peruwelz,Club Brugge,2,1,1,W
135618,15,BEL1,2015-09-12,Kortrijk,Oud-Heverlee Leuven,0,0,0,D
135619,15,BEL1,2015-09-12,Mechelen,Westerlo,2,2,0,D
135620,15,BEL1,2015-09-12,Waasland-Beveren,Oostende,1,5,-4,L
135621,15,BEL1,2015-09-12,Waregem,Gent,1,1,0,D
135622,15,BEL1,2015-09-13,Anderlecht,Genk,0,0,0,D
135623,15,BEL1,2015-09-13,St Truiden,Charleroi,1,1,0,D
135624,15,BEL1,2015-09-13,Standard,Lokeren,0,1,-1,L
135625,15,BEL1,2015-09-18,Genk,Mechelen,3,1,2,W
135626,15,BEL1,2015-09-19,Lokeren,Mouscron-Peruwelz,1,2,-1,L
135627,15,BEL1,2015-09-19,Oostende,Kortrijk,1,0,1,W
135628,15,BEL1,2015-09-19,Oud-Heverlee Leuven,Waregem,2,3,-1,L
135629,15,BEL1,2015-09-19,Westerlo,St Truiden,0,3,-3,L
135630,15,BEL1,2015-09-20,Charleroi,Anderlecht,1,1,0,D
135631,15,BEL1,2015-09-20,Club Brugge,Waasland-Beveren,5,1,4,W
135632,15,BEL1,2015-09-20,Gent,Standard,4,1,3,W
135633,15,BEL1,2015-09-25,Waregem,Westerlo,4,2,2,W
135634,15,BEL1,2015-09-26,Mechelen,Charleroi,0,1,-1,L
135635,15,BEL1,2015-09-26,Mouscron-Peruwelz,Oostende,2,2,0,D
135636,15,BEL1,2015-09-26,Standard,Oud-Heverlee Leuven,2,2,0,D
135637,15,BEL1,2015-09-26,Waasland-Beveren,Gent,1,3,-2,L
135638,15,BEL1,2015-09-27,Anderlecht,St Truiden,1,0,1,W
135639,15,BEL1,2015-09-27,Kortrijk,Genk,1,0,1,W
135640,15,BEL1,2015-09-27,Lokeren,Club Brugge,0,1,-1,L
135641,15,BEL1,2015-10-02,Oostende,Lokeren,2,0,2,W
135642,15,BEL1,2015-10-03,Charleroi,Waregem,3,0,3,W
135643,15,BEL1,2015-10-03,Oud-Heverlee Leuven,Mouscron-Peruwelz,1,1,0,D
135644,15,BEL1,2015-10-03,St Truiden,Waasland-Beveren,1,3,-2,L
135645,15,BEL1,2015-10-03,Westerlo,Kortrijk,1,1,0,D
135646,15,BEL1,2015-10-04,Anderlecht,Mechelen,1,1,0,D
135647,15,BEL1,2015-10-04,Genk,Standard,3,1,2,W
135648,15,BEL1,2015-10-04,Gent,Club Brugge,4,1,3,W
135649,15,BEL1,2015-10-16,Mouscron-Peruwelz,Gent,1,2,-1,L
135650,15,BEL1,2015-10-17,Lokeren,Oud-Heverlee Leuven,1,2,-1,L
135651,15,BEL1,2015-10-17,Mechelen,St Truiden,3,0,3,W
135652,15,BEL1,2015-10-17,Standard,Westerlo,1,2,-1,L
135653,15,BEL1,2015-10-17,Waasland-Beveren,Genk,0,1,-1,L
135654,15,BEL1,2015-10-18,Club Brugge,Oostende,1,0,1,W
135655,15,BEL1,2015-10-18,Kortrijk,Charleroi,2,0,2,W
135656,15,BEL1,2015-10-18,Waregem,Anderlecht,0,4,-4,L
135657,15,BEL1,2015-10-23,Genk,Mouscron-Peruwelz,0,4,-4,L
135658,15,BEL1,2015-10-24,Gent,Oostende,2,2,0,D
135659,15,BEL1,2015-10-24,Mechelen,Waregem,3,4,-1,L
135660,15,BEL1,2015-10-24,Oud-Heverlee Leuven,Waasland-Beveren,0,2,-2,L
135661,15,BEL1,2015-10-24,Westerlo,Lokeren,1,2,-1,L
135662,15,BEL1,2015-10-25,Anderlecht,Club Brugge,3,1,2,W
135663,15,BEL1,2015-10-25,Charleroi,Standard,2,3,-1,L
135664,15,BEL1,2015-10-25,St Truiden,Kortrijk,2,1,1,W
135665,15,BEL1,2015-10-27,Lokeren,Gent,1,2,-1,L
135666,15,BEL1,2015-10-27,Mouscron-Peruwelz,Westerlo,2,2,0,D
135667,15,BEL1,2015-10-27,Oostende,Genk,3,2,1,W
135668,15,BEL1,2015-10-28,Club Brugge,Oud-Heverlee Leuven,2,0,2,W
135669,15,BEL1,2015-10-28,Standard,Mechelen,2,1,1,W
135670,15,BEL1,2015-10-28,Waasland-Beveren,Charleroi,0,1,-1,L
135671,15,BEL1,2015-10-28,Waregem,St Truiden,4,0,4,W
135672,15,BEL1,2015-10-29,Kortrijk,Anderlecht,1,1,0,D
135673,15,BEL1,2015-10-30,Genk,Lokeren,0,2,-2,L
135674,15,BEL1,2015-10-31,Charleroi,Oostende,1,1,0,D
135675,15,BEL1,2015-10-31,Mechelen,Waasland-Beveren,2,0,2,W
135676,15,BEL1,2015-10-31,Oud-Heverlee Leuven,Gent,0,2,-2,L
135677,15,BEL1,2015-10-31,Westerlo,Club Brugge,0,2,-2,L
135678,15,BEL1,2015-11-01,Anderlecht,Mouscron-Peruwelz,2,0,2,W
135679,15,BEL1,2015-11-01,St Truiden,Standard,1,0,1,W
135680,15,BEL1,2015-11-01,Waregem,Kortrijk,2,2,0,D
135681,15,BEL1,2015-11-06,Mouscron-Peruwelz,Waregem,2,2,0,D
135682,15,BEL1,2015-11-07,Kortrijk,Mechelen,1,0,1,W
135683,15,BEL1,2015-11-07,Lokeren,St Truiden,1,1,0,D
135684,15,BEL1,2015-11-07,Oostende,Oud-Heverlee Leuven,3,0,3,W
135685,15,BEL1,2015-11-07,Waasland-Beveren,Westerlo,2,2,0,D
135686,15,BEL1,2015-11-08,Club Brugge,Genk,1,0,1,W
135687,15,BEL1,2015-11-08,Gent,Charleroi,1,3,-2,L
135688,15,BEL1,2015-11-08,Standard,Anderlecht,1,0,1,W
135689,15,BEL1,2015-11-20,Gent,Westerlo,5,0,5,W
135690,15,BEL1,2015-11-21,Club Brugge,Waregem,3,0,3,W
135691,15,BEL1,2015-11-21,Oud-Heverlee Leuven,Genk,1,3,-2,L
135692,15,BEL1,2015-11-21,Waasland-Beveren,St Truiden,2,1,1,W
135693,15,BEL1,2015-11-22,Mechelen,Oostende,2,1,1,W
135694,15,BEL1,2015-11-22,Standard,Kortrijk,1,1,0,D
135695,15,BEL1,2015-11-27,Waregem,Standard,2,3,-1,L
135696,15,BEL1,2015-11-28,Charleroi,Lokeren,1,2,-1,L
135697,15,BEL1,2015-11-28,Genk,Gent,0,1,-1,L
135698,15,BEL1,2015-11-28,Kortrijk,Waasland-Beveren,3,1,2,W
135699,15,BEL1,2015-11-28,St Truiden,Mouscron-Peruwelz,0,1,-1,L
135700,15,BEL1,2015-11-29,Anderlecht,Oud-Heverlee Leuven,3,2,1,W
135701,15,BEL1,2015-11-29,Mechelen,Club Brugge,1,4,-3,L
135702,15,BEL1,2015-11-29,Westerlo,Oostende,0,1,-1,L
135703,15,BEL1,2015-12-04,Gent,Waregem,2,2,0,D
135704,15,BEL1,2015-12-05,Mouscron-Peruwelz,Mechelen,2,3,-1,L
135705,15,BEL1,2015-12-05,Oostende,St Truiden,1,2,-1,L
135706,15,BEL1,2015-12-05,Oud-Heverlee Leuven,Westerlo,5,1,4,W
135707,15,BEL1,2015-12-05,Waasland-Beveren,Standard,0,0,0,D
135708,15,BEL1,2015-12-06,Club Brugge,Charleroi,2,1,1,W
135709,15,BEL1,2015-12-06,Genk,Anderlecht,0,0,0,D
135710,15,BEL1,2015-12-06,Lokeren,Kortrijk,3,1,2,W
135711,15,BEL1,2015-12-11,Westerlo,Genk,0,0,0,D
135712,15,BEL1,2015-12-12,Charleroi,Oud-Heverlee Leuven,2,1,1,W
135713,15,BEL1,2015-12-12,Kortrijk,Mouscron-Peruwelz,1,3,-2,L
135714,15,BEL1,2015-12-12,Mechelen,Lokeren,1,1,0,D
135715,15,BEL1,2015-12-12,Waregem,Waasland-Beveren,2,1,1,W
135716,15,BEL1,2015-12-13,Anderlecht,Oostende,1,1,0,D
135717,15,BEL1,2015-12-13,St Truiden,Gent,0,2,-2,L
135718,15,BEL1,2015-12-13,Standard,Club Brugge,2,0,2,W
135719,15,BEL1,2015-12-18,Lokeren,Waregem,1,1,0,D
135720,15,BEL1,2015-12-19,Genk,St Truiden,3,0,3,W
135721,15,BEL1,2015-12-19,Mouscron-Peruwelz,Waasland-Beveren,0,1,-1,L
135722,15,BEL1,2015-12-19,Oud-Heverlee Leuven,Mechelen,3,1,2,W
135723,15,BEL1,2015-12-19,Westerlo,Charleroi,2,1,1,W
135724,15,BEL1,2015-12-20,Club Brugge,Anderlecht,1,4,-3,L
135725,15,BEL1,2015-12-20,Gent,Kortrijk,3,0,3,W
135726,15,BEL1,2015-12-20,Oostende,Standard,4,1,3,W
135727,15,BEL1,2015-12-22,Mouscron-Peruwelz,Charleroi,0,1,-1,L
135728,15,BEL1,2015-12-23,Lokeren,Anderlecht,1,1,0,D
135729,15,BEL1,2015-12-26,Charleroi,Genk,1,0,1,W
135730,15,BEL1,2015-12-26,Kortrijk,Club Brugge,1,4,-3,L
135731,15,BEL1,2015-12-26,Mechelen,Gent,2,0,2,W
135732,15,BEL1,2015-12-26,St Truiden,Oud-Heverlee Leuven,2,2,0,D
135733,15,BEL1,2015-12-26,Waasland-Beveren,Lokeren,2,3,-1,L
135734,15,BEL1,2015-12-27,Anderlecht,Westerlo,2,1,1,W
135735,15,BEL1,2015-12-27,Standard,Mouscron-Peruwelz,3,0,3,W
135736,15,BEL1,2015-12-27,Waregem,Oostende,1,0,1,W
135737,15,BEL1,2016-01-15,Genk,Waregem,2,1,1,W
135738,15,BEL1,2016-01-16,Charleroi,St Truiden,0,0,0,D
135739,15,BEL1,2016-01-16,Club Brugge,Mouscron-Peruwelz,3,0,3,W
135740,15,BEL1,2016-01-16,Oud-Heverlee Leuven,Kortrijk,1,0,1,W
135741,15,BEL1,2016-01-16,Westerlo,Mechelen,3,2,1,W
135742,15,BEL1,2016-01-17,Gent,Anderlecht,2,0,2,W
135743,15,BEL1,2016-01-17,Lokeren,Standard,0,2,-2,L
135744,15,BEL1,2016-01-17,Oostende,Waasland-Beveren,3,3,0,D
135745,15,BEL1,2016-01-22,Kortrijk,Oostende,2,1,1,W
135746,15,BEL1,2016-01-23,Mechelen,Genk,1,1,0,D
135747,15,BEL1,2016-01-23,Mouscron-Peruwelz,Lokeren,1,1,0,D
135748,15,BEL1,2016-01-23,St Truiden,Westerlo,1,2,-1,L
135749,15,BEL1,2016-01-23,Waregem,Oud-Heverlee Leuven,2,2,0,D
135750,15,BEL1,2016-01-24,Anderlecht,Charleroi,2,1,1,W
135751,15,BEL1,2016-01-24,Standard,Gent,0,3,-3,L
135752,15,BEL1,2016-01-24,Waasland-Beveren,Club Brugge,1,2,-1,L
135753,15,BEL1,2016-01-29,St Truiden,Anderlecht,1,2,-1,L
135754,15,BEL1,2016-01-30,Charleroi,Mechelen,3,2,1,W
135755,15,BEL1,2016-01-30,Genk,Kortrijk,1,0,1,W
135756,15,BEL1,2016-01-30,Oud-Heverlee Leuven,Standard,0,2,-2,L
135757,15,BEL1,2016-01-30,Westerlo,Waregem,1,2,-1,L
135758,15,BEL1,2016-01-31,Club Brugge,Lokeren,2,1,1,W
135759,15,BEL1,2016-01-31,Gent,Waasland-Beveren,2,1,1,W
135760,15,BEL1,2016-01-31,Oostende,Mouscron-Peruwelz,3,3,0,D
135761,15,BEL1,2016-02-05,Mechelen,Anderlecht,2,2,0,D
135762,15,BEL1,2016-02-06,Kortrijk,Westerlo,1,1,0,D
135763,15,BEL1,2016-02-06,Mouscron-Peruwelz,Genk,0,1,-1,L
135764,15,BEL1,2016-02-06,Waasland-Beveren,Oud-Heverlee Leuven,2,2,0,D
135765,15,BEL1,2016-02-06,Waregem,Charleroi,2,3,-1,L
135766,15,BEL1,2016-02-07,Club Brugge,Gent,1,0,1,W
135767,15,BEL1,2016-02-07,Lokeren,Oostende,0,1,-1,L
135768,15,BEL1,2016-02-07,Standard,St Truiden,1,2,-1,L
135769,15,BEL1,2016-02-12,Gent,Mouscron-Peruwelz,2,0,2,W
135770,15,BEL1,2016-02-13,Anderlecht,Waregem,3,0,3,W
135771,15,BEL1,2016-02-13,Charleroi,Kortrijk,1,1,0,D
135772,15,BEL1,2016-02-13,Genk,Waasland-Beveren,6,1,5,W
135773,15,BEL1,2016-02-13,Oud-Heverlee Leuven,Lokeren,3,3,0,D
135774,15,BEL1,2016-02-14,Oostende,Club Brugge,0,2,-2,L
135775,15,BEL1,2016-02-14,St Truiden,Mechelen,0,3,-3,L
135776,15,BEL1,2016-02-14,Westerlo,Standard,2,0,2,W
135777,15,BEL1,2016-02-19,Club Brugge,Westerlo,6,0,6,W
135778,15,BEL1,2016-02-20,Kortrijk,St Truiden,3,0,3,W
135779,15,BEL1,2016-02-20,Lokeren,Genk,0,0,0,D
135780,15,BEL1,2016-02-20,Mouscron-Peruwelz,Oud-Heverlee Leuven,3,1,2,W
135781,15,BEL1,2016-02-20,Standard,Charleroi,3,0,3,W
135782,15,BEL1,2016-02-21,Oostende,Gent,5,2,3,W
135783,15,BEL1,2016-02-21,Waasland-Beveren,Anderlecht,1,0,1,W
135784,15,BEL1,2016-02-21,Waregem,Mechelen,2,3,-1,L
135785,15,BEL1,2016-02-26,Gent,Lokeren,3,1,2,W
135786,15,BEL1,2016-02-27,Mechelen,Kortrijk,0,2,-2,L
135787,15,BEL1,2016-02-27,Oud-Heverlee Leuven,Oostende,4,1,3,W
135788,15,BEL1,2016-02-27,St Truiden,Waregem,1,2,-1,L
135789,15,BEL1,2016-02-27,Westerlo,Mouscron-Peruwelz,2,2,0,D
135790,15,BEL1,2016-02-28,Anderlecht,Standard,3,3,0,D
135791,15,BEL1,2016-02-28,Charleroi,Waasland-Beveren,2,3,-1,L
135792,15,BEL1,2016-02-28,Genk,Club Brugge,3,2,1,W
135793,15,BEL1,2016-03-04,Gent,Oud-Heverlee Leuven,1,1,0,D
135794,15,BEL1,2016-03-05,Club Brugge,St Truiden,3,0,3,W
135795,15,BEL1,2016-03-05,Kortrijk,Waregem,1,0,1,W
135796,15,BEL1,2016-03-05,Lokeren,Westerlo,2,1,1,W
135797,15,BEL1,2016-03-05,Mouscron-Peruwelz,Anderlecht,2,1,1,W
135798,15,BEL1,2016-03-05,Oostende,Charleroi,2,1,1,W
135799,15,BEL1,2016-03-05,Standard,Genk,2,1,1,W
135800,15,BEL1,2016-03-05,Waasland-Beveren,Mechelen,0,0,0,D
135801,15,BEL1,2016-03-13,Anderlecht,Kortrijk,3,0,3,W
135802,15,BEL1,2016-03-13,Charleroi,Gent,1,1,0,D
135803,15,BEL1,2016-03-13,Genk,Oostende,4,1,3,W
135804,15,BEL1,2016-03-13,Mechelen,Standard,4,0,4,W
135805,15,BEL1,2016-03-13,Oud-Heverlee Leuven,Club Brugge,0,1,-1,L
135806,15,BEL1,2016-03-13,St Truiden,Lokeren,1,1,0,D
135807,15,BEL1,2016-03-13,Waregem,Mouscron-Peruwelz,3,0,3,W
135808,15,BEL1,2016-03-13,Westerlo,Waasland-Beveren,1,0,1,W
135809,16,BEL1,2016-07-29,Mechelen,Club Brugge,0,2,-2,L
135810,16,BEL1,2016-07-30,Mouscron,Anderlecht,1,2,-1,L
135811,16,BEL1,2016-07-30,Waregem,Eupen,3,0,3,W
135812,16,BEL1,2016-07-30,St Truiden,Lokeren,1,0,1,W
135813,16,BEL1,2016-07-30,Charleroi,Beveren,1,0,1,W
135814,16,BEL1,2016-07-31,Westerlo,Standard,2,2,0,D
135815,16,BEL1,2016-07-31,Genk,Oostende,2,1,1,W
135816,16,BEL1,2016-07-31,Kortrijk,Gent,1,1,0,D
135817,16,BEL1,2016-08-05,Oostende,Club Brugge,1,0,1,W
135818,16,BEL1,2016-08-06,Mouscron,Charleroi,0,1,-1,L
135819,16,BEL1,2016-08-06,Eupen,Mechelen,0,2,-2,L
135820,16,BEL1,2016-08-06,Beveren,Waregem,0,2,-2,L
135821,16,BEL1,2016-08-06,Standard,St Truiden,2,0,2,W
135822,16,BEL1,2016-08-07,Lokeren,Westerlo,3,0,3,W
135823,16,BEL1,2016-08-07,Anderlecht,Kortrijk,5,1,4,W
135824,16,BEL1,2016-08-07,Gent,Genk,1,0,1,W
135825,16,BEL1,2016-08-12,St Truiden,Anderlecht,0,0,0,D
135826,16,BEL1,2016-08-13,Charleroi,Gent,1,1,0,D
135827,16,BEL1,2016-08-13,Mechelen,Kortrijk,0,0,0,D
135828,16,BEL1,2016-08-13,Westerlo,Eupen,1,2,-1,L
135829,16,BEL1,2016-08-13,Genk,Beveren,2,2,0,D
135830,16,BEL1,2016-08-14,Waregem,Standard,1,0,1,W
135831,16,BEL1,2016-08-14,Club Brugge,Lokeren,1,0,1,W
135832,16,BEL1,2016-08-14,Oostende,Mouscron,2,1,1,W
135833,16,BEL1,2016-08-19,Standard,Charleroi,0,0,0,D
135834,16,BEL1,2016-08-20,Kortrijk,Club Brugge,2,1,1,W
135835,16,BEL1,2016-08-20,Mouscron,St Truiden,2,1,1,W
135836,16,BEL1,2016-08-20,Beveren,Mechelen,2,2,0,D
135837,16,BEL1,2016-08-20,Waregem,Oostende,1,1,0,D
135838,16,BEL1,2016-08-21,Eupen,Anderlecht,2,2,0,D
135839,16,BEL1,2016-08-21,Lokeren,Genk,0,3,-3,L
135840,16,BEL1,2016-08-21,Gent,Westerlo,4,2,2,W
135841,16,BEL1,2016-08-26,Charleroi,Eupen,3,2,1,W
135842,16,BEL1,2016-08-27,Lokeren,Mouscron,2,1,1,W
135843,16,BEL1,2016-08-27,Westerlo,Mechelen,1,2,-1,L
135844,16,BEL1,2016-08-27,St Truiden,Kortrijk,1,2,-1,L
135845,16,BEL1,2016-08-27,Oostende,Beveren,2,1,1,W
135846,16,BEL1,2016-08-28,Club Brugge,Standard,2,2,0,D
135847,16,BEL1,2016-08-28,Anderlecht,Gent,2,2,0,D
135848,16,BEL1,2016-08-28,Genk,Waregem,1,0,1,W
135849,16,BEL1,2016-09-09,Beveren,Club Brugge,1,0,1,W
135850,16,BEL1,2016-09-10,Eupen,Oostende,2,1,1,W
135851,16,BEL1,2016-09-10,Kortrijk,Westerlo,4,1,3,W
135852,16,BEL1,2016-09-10,Mechelen,St Truiden,2,0,2,W
135853,16,BEL1,2016-09-10,Mouscron,Waregem,1,5,-4,L
135854,16,BEL1,2016-09-11,Gent,Lokeren,3,0,3,W
135855,16,BEL1,2016-09-11,Anderlecht,Charleroi,3,2,1,W
135856,16,BEL1,2016-09-11,Standard,Genk,2,0,2,W
135857,16,BEL1,2016-09-16,Charleroi,Mechelen,0,0,0,D
135858,16,BEL1,2016-09-17,Club Brugge,Eupen,3,2,1,W
135859,16,BEL1,2016-09-17,Westerlo,Mouscron,1,3,-2,L
135860,16,BEL1,2016-09-17,St Truiden,Beveren,4,1,3,W
135861,16,BEL1,2016-09-17,Waregem,Kortrijk,2,1,1,W
135862,16,BEL1,2016-09-18,Genk,Anderlecht,0,2,-2,L
135863,16,BEL1,2016-09-18,Lokeren,Standard,0,1,-1,L
135864,16,BEL1,2016-09-18,Oostende,Gent,1,0,1,W
135865,16,BEL1,2016-09-23,Mouscron,Club Brugge,0,3,-3,L
135866,16,BEL1,2016-09-24,Beveren,Lokeren,1,1,0,D
135867,16,BEL1,2016-09-24,Gent,St Truiden,2,1,1,W
135868,16,BEL1,2016-09-24,Mechelen,Waregem,2,3,-1,L
135869,16,BEL1,2016-09-24,Charleroi,Oostende,2,1,1,W
135870,16,BEL1,2016-09-25,Standard,Eupen,3,0,3,W
135871,16,BEL1,2016-09-25,Kortrijk,Genk,4,1,3,W
135872,16,BEL1,2016-09-25,Anderlecht,Westerlo,1,2,-1,L
135873,16,BEL1,2016-09-30,Oostende,St Truiden,2,2,0,D
135874,16,BEL1,2016-10-01,Waregem,Charleroi,1,1,0,D
135875,16,BEL1,2016-10-01,Eupen,Mouscron,1,4,-3,L
135876,16,BEL1,2016-10-01,Westerlo,Beveren,1,0,1,W
135877,16,BEL1,2016-10-01,Lokeren,Kortrijk,2,1,1,W
135878,16,BEL1,2016-10-02,Club Brugge,Gent,1,0,1,W
135879,16,BEL1,2016-10-02,Standard,Anderlecht,0,1,-1,L
135880,16,BEL1,2016-10-02,Genk,Mechelen,2,1,1,W
135881,16,BEL1,2016-10-14,Charleroi,Club Brugge,1,0,1,W
135882,16,BEL1,2016-10-15,Kortrijk,Standard,3,3,0,D
135883,16,BEL1,2016-10-15,Beveren,Eupen,4,2,2,W
135884,16,BEL1,2016-10-15,St Truiden,Westerlo,2,2,0,D
135885,16,BEL1,2016-10-15,Mouscron,Genk,2,2,0,D
135886,16,BEL1,2016-10-16,Gent,Waregem,3,0,3,W
135887,16,BEL1,2016-10-16,Anderlecht,Lokeren,1,0,1,W
135888,16,BEL1,2016-10-16,Mechelen,Oostende,2,3,-1,L
135889,16,BEL1,2016-10-21,Oostende,Kortrijk,2,2,0,D
135890,16,BEL1,2016-10-22,Waregem,Lokeren,2,0,2,W
135891,16,BEL1,2016-10-22,Mechelen,Mouscron,2,0,2,W
135892,16,BEL1,2016-10-22,Westerlo,Charleroi,0,0,0,D
135893,16,BEL1,2016-10-23,Club Brugge,Anderlecht,2,1,1,W
135894,16,BEL1,2016-10-23,Genk,St Truiden,1,0,1,W
135895,16,BEL1,2016-10-23,Standard,Beveren,5,0,5,W
135896,16,BEL1,2016-10-23,Eupen,Gent,3,2,1,W
135897,16,BEL1,2016-10-25,Lokeren,Oostende,1,2,-1,L
135898,16,BEL1,2016-10-26,Club Brugge,Westerlo,4,0,4,W
135899,16,BEL1,2016-10-26,Anderlecht,Mechelen,2,0,2,W
135900,16,BEL1,2016-10-26,Kortrijk,Eupen,1,1,0,D
135901,16,BEL1,2016-10-26,Charleroi,Genk,2,1,1,W
135902,16,BEL1,2016-10-26,St Truiden,Waregem,0,2,-2,L
135903,16,BEL1,2016-10-27,Gent,Standard,1,0,1,W
135904,16,BEL1,2016-10-27,Beveren,Mouscron,0,0,0,D
135905,16,BEL1,2016-10-29,Waregem,Club Brugge,0,0,0,D
135906,16,BEL1,2016-10-29,Genk,Westerlo,2,1,1,W
135907,16,BEL1,2016-10-29,Eupen,Lokeren,2,2,0,D
135908,16,BEL1,2016-10-29,St Truiden,Charleroi,2,2,0,D
135909,16,BEL1,2016-10-30,Oostende,Standard,3,1,2,W
135910,16,BEL1,2016-10-30,Mechelen,Gent,2,0,2,W
135911,16,BEL1,2016-10-30,Mouscron,Kortrijk,0,1,-1,L
135912,16,BEL1,2016-10-30,Beveren,Anderlecht,2,1,1,W
135913,16,BEL1,2016-11-04,Kortrijk,Charleroi,2,1,1,W
135914,16,BEL1,2016-11-05,Westerlo,Waregem,1,2,-1,L
135915,16,BEL1,2016-11-05,Eupen,St Truiden,4,2,2,W
135916,16,BEL1,2016-11-05,Lokeren,Mechelen,0,0,0,D
135917,16,BEL1,2016-11-06,Club Brugge,Genk,1,1,0,D
135918,16,BEL1,2016-11-06,Anderlecht,Oostende,1,1,0,D
135919,16,BEL1,2016-11-06,Standard,Mouscron,2,1,1,W
135920,16,BEL1,2016-11-06,Gent,Beveren,2,0,2,W
135921,16,BEL1,2016-11-18,St Truiden,Club Brugge,0,1,-1,L
135922,16,BEL1,2016-11-19,Genk,Eupen,2,0,2,W
135923,16,BEL1,2016-11-19,Oostende,Westerlo,5,0,5,W
135924,16,BEL1,2016-11-19,Beveren,Kortrijk,1,1,0,D
135925,16,BEL1,2016-11-19,Mouscron,Gent,0,2,-2,L
135926,16,BEL1,2016-11-20,Waregem,Anderlecht,3,2,1,W
135927,16,BEL1,2016-11-20,Mechelen,Standard,2,1,1,W
135928,16,BEL1,2016-11-20,Charleroi,Lokeren,2,1,1,W
135929,16,BEL1,2016-11-25,Club Brugge,Mechelen,6,1,5,W
135930,16,BEL1,2016-11-26,Beveren,Charleroi,0,1,-1,L
135931,16,BEL1,2016-11-26,Lokeren,St Truiden,1,0,1,W
135932,16,BEL1,2016-11-26,Eupen,Westerlo,3,3,0,D
135933,16,BEL1,2016-11-27,Gent,Kortrijk,3,0,3,W
135934,16,BEL1,2016-11-27,Oostende,Genk,6,0,6,W
135935,16,BEL1,2016-11-27,Standard,Waregem,4,1,3,W
135936,16,BEL1,2016-11-27,Anderlecht,Mouscron,7,0,7,W
135937,16,BEL1,2016-12-02,Mechelen,Eupen,1,0,1,W
135938,16,BEL1,2016-12-03,Club Brugge,Oostende,2,0,2,W
135939,16,BEL1,2016-12-03,Waregem,Beveren,1,1,0,D
135940,16,BEL1,2016-12-03,St Truiden,Mouscron,1,0,1,W
135941,16,BEL1,2016-12-03,Westerlo,Gent,0,0,0,D
135942,16,BEL1,2016-12-04,Kortrijk,Anderlecht,1,3,-2,L
135943,16,BEL1,2016-12-04,Charleroi,Standard,1,3,-2,L
135944,16,BEL1,2016-12-04,Genk,Lokeren,1,2,-1,L
135945,16,BEL1,2016-12-09,Lokeren,Waregem,1,1,0,D
135946,16,BEL1,2016-12-10,Eupen,Charleroi,2,2,0,D
135947,16,BEL1,2016-12-10,Kortrijk,St Truiden,0,1,-1,L
135948,16,BEL1,2016-12-10,Mouscron,Mechelen,1,4,-3,L
135949,16,BEL1,2016-12-11,Anderlecht,Club Brugge,0,0,0,D
135950,16,BEL1,2016-12-11,Gent,Oostende,1,1,0,D
135951,16,BEL1,2016-12-11,Standard,Westerlo,3,1,2,W
135952,16,BEL1,2016-12-17,Oostende,Waregem,1,1,0,D
135953,16,BEL1,2016-12-17,Mechelen,Beveren,2,0,2,W
135954,16,BEL1,2016-12-17,Charleroi,Mouscron,2,0,2,W
135955,16,BEL1,2016-12-17,Westerlo,Lokeren,1,3,-2,L
135956,16,BEL1,2016-12-17,St Truiden,Gent,3,1,2,W
135957,16,BEL1,2016-12-18,Genk,Standard,2,2,0,D
135958,16,BEL1,2016-12-18,Club Brugge,Kortrijk,5,1,4,W
135959,16,BEL1,2016-12-18,Anderlecht,Eupen,4,0,4,W
135960,16,BEL1,2016-12-20,Mouscron,Westerlo,0,0,0,D
135961,16,BEL1,2016-12-20,Mechelen,Charleroi,1,0,1,W
135962,16,BEL1,2016-12-20,Beveren,St Truiden,3,1,2,W
135963,16,BEL1,2016-12-21,Standard,Lokeren,1,1,0,D
135964,16,BEL1,2016-12-21,Kortrijk,Oostende,0,2,-2,L
135965,16,BEL1,2016-12-21,Eupen,Club Brugge,1,4,-3,L
135966,16,BEL1,2016-12-21,Waregem,Genk,1,0,1,W
135967,16,BEL1,2016-12-22,Gent,Anderlecht,2,3,-1,L
135968,16,BEL1,2016-12-26,Oostende,Eupen,1,3,-2,L
135969,16,BEL1,2016-12-26,Waregem,Mechelen,0,0,0,D
135970,16,BEL1,2016-12-26,Lokeren,Beveren,0,0,0,D
135971,16,BEL1,2016-12-26,Westerlo,Kortrijk,4,1,3,W
135972,16,BEL1,2016-12-26,Charleroi,Anderlecht,0,2,-2,L
135973,16,BEL1,2016-12-26,Club Brugge,Mouscron,2,1,1,W
135974,16,BEL1,2016-12-27,Genk,Gent,2,0,2,W
135975,16,BEL1,2016-12-27,St Truiden,Standard,2,2,0,D
135976,16,BEL1,2017-01-20,Gent,Charleroi,1,0,1,W
135977,16,BEL1,2017-01-21,Kortrijk,Waregem,2,3,-1,L
135978,16,BEL1,2017-01-21,Mouscron,Lokeren,2,1,1,W
135979,16,BEL1,2017-01-21,Beveren,Oostende,0,1,-1,L
135980,16,BEL1,2017-01-21,Eupen,Genk,0,1,-1,L
135981,16,BEL1,2017-01-22,Standard,Club Brugge,0,3,-3,L
135982,16,BEL1,2017-01-22,Anderlecht,St Truiden,3,1,2,W
135983,16,BEL1,2017-01-22,Mechelen,Westerlo,1,2,-1,L
135984,16,BEL1,2017-01-24,Genk,Kortrijk,3,0,3,W
135985,16,BEL1,2017-01-24,Oostende,Charleroi,1,2,-1,L
135986,16,BEL1,2017-01-24,Waregem,Mouscron,1,0,1,W
135987,16,BEL1,2017-01-25,Club Brugge,Beveren,2,1,1,W
135988,16,BEL1,2017-01-25,Lokeren,Gent,0,0,0,D
135989,16,BEL1,2017-01-25,Westerlo,Anderlecht,2,4,-2,L
135990,16,BEL1,2017-01-25,St Truiden,Mechelen,2,1,1,W
135991,16,BEL1,2017-01-26,Eupen,Standard,2,2,0,D
135992,16,BEL1,2017-01-27,Charleroi,Waregem,2,1,1,W
135993,16,BEL1,2017-01-28,Kortrijk,Lokeren,2,1,1,W
135994,16,BEL1,2017-01-28,Beveren,Westerlo,0,0,0,D
135995,16,BEL1,2017-01-28,St Truiden,Oostende,3,0,3,W
135996,16,BEL1,2017-01-28,Mechelen,Genk,1,0,1,W
135997,16,BEL1,2017-01-29,Gent,Club Brugge,2,0,2,W
135998,16,BEL1,2017-01-29,Anderlecht,Standard,0,0,0,D
135999,16,BEL1,2017-01-29,Mouscron,Eupen,3,0,3,W
136000,16,BEL1,2017-02-03,Lokeren,Anderlecht,0,0,0,D
136001,16,BEL1,2017-02-04,Standard,Kortrijk,0,3,-3,L
136002,16,BEL1,2017-02-04,Genk,Mouscron,1,0,1,W
136003,16,BEL1,2017-02-04,Eupen,Beveren,0,2,-2,L
136004,16,BEL1,2017-02-04,Oostende,Mechelen,2,0,2,W
136005,16,BEL1,2017-02-05,Club Brugge,Charleroi,1,0,1,W
136006,16,BEL1,2017-02-05,Waregem,Gent,1,1,0,D
136007,16,BEL1,2017-02-05,Westerlo,St Truiden,1,0,1,W
136008,16,BEL1,2017-02-07,Beveren,Genk,0,0,0,D
136009,16,BEL1,2017-02-10,St Truiden,Genk,0,3,-3,L
136010,16,BEL1,2017-02-11,Mouscron,Oostende,1,2,-1,L
136011,16,BEL1,2017-02-11,Kortrijk,Mechelen,0,2,-2,L
136012,16,BEL1,2017-02-11,Charleroi,Westerlo,2,1,1,W
136013,16,BEL1,2017-02-11,Gent,Eupen,0,1,-1,L
136014,16,BEL1,2017-02-12,Anderlecht,Waregem,4,2,2,W
136015,16,BEL1,2017-02-12,Lokeren,Club Brugge,1,0,1,W
136016,16,BEL1,2017-02-12,Beveren,Standard,0,1,-1,L
136017,16,BEL1,2017-02-17,Westerlo,Club Brugge,1,2,-1,L
136018,16,BEL1,2017-02-18,Mechelen,Lokeren,3,0,3,W
136019,16,BEL1,2017-02-18,Mouscron,Beveren,1,2,-1,L
136020,16,BEL1,2017-02-18,Eupen,Kortrijk,1,0,1,W
136021,16,BEL1,2017-02-18,Waregem,St Truiden,4,1,3,W
136022,16,BEL1,2017-02-19,Standard,Gent,1,1,0,D
136023,16,BEL1,2017-02-19,Oostende,Anderlecht,1,4,-3,L
136024,16,BEL1,2017-02-19,Genk,Charleroi,1,1,0,D
136025,16,BEL1,2017-02-24,Club Brugge,Waregem,5,0,5,W
136026,16,BEL1,2017-02-25,Charleroi,St Truiden,1,0,1,W
136027,16,BEL1,2017-02-25,Kortrijk,Beveren,1,2,-1,L
136028,16,BEL1,2017-02-25,Lokeren,Eupen,1,2,-1,L
136029,16,BEL1,2017-02-25,Westerlo,Oostende,0,4,-4,L
136030,16,BEL1,2017-02-26,Standard,Mechelen,2,2,0,D
136031,16,BEL1,2017-02-26,Anderlecht,Genk,2,0,2,W
136032,16,BEL1,2017-02-26,Gent,Mouscron,3,1,2,W
136033,16,BEL1,2017-03-04,Genk,Club Brugge,2,1,1,W
136034,16,BEL1,2017-03-04,Mouscron,Standard,1,0,1,W
136035,16,BEL1,2017-03-04,Oostende,Lokeren,0,0,0,D
136036,16,BEL1,2017-03-04,Waregem,Westerlo,2,2,0,D
136037,16,BEL1,2017-03-04,Mechelen,Anderlecht,3,2,1,W
136038,16,BEL1,2017-03-04,Charleroi,Kortrijk,1,1,0,D
136039,16,BEL1,2017-03-04,Beveren,Gent,2,3,-1,L
136040,16,BEL1,2017-03-04,St Truiden,Eupen,2,1,1,W
136041,16,BEL1,2017-03-12,Club Brugge,St Truiden,2,2,0,D
136042,16,BEL1,2017-03-12,Anderlecht,Beveren,3,0,3,W
136043,16,BEL1,2017-03-12,Standard,Oostende,2,2,0,D
136044,16,BEL1,2017-03-12,Gent,Mechelen,3,0,3,W
136045,16,BEL1,2017-03-12,Kortrijk,Mouscron,0,2,-2,L
136046,16,BEL1,2017-03-12,Eupen,Waregem,1,3,-2,L
136047,16,BEL1,2017-03-12,Lokeren,Charleroi,0,0,0,D
136048,16,BEL1,2017-03-12,Westerlo,Genk,0,4,-4,L
136049,17,BEL1,2017-07-28,Antwerp,Anderlecht,0,0,0,D
136050,17,BEL1,2017-07-29,Lokeren,Club Brugge,0,4,-4,L
136051,17,BEL1,2017-07-29,Genk,Waasland-Beveren,3,3,0,D
136052,17,BEL1,2017-07-29,Eupen,Waregem,0,5,-5,L
136053,17,BEL1,2017-07-29,Charleroi,Kortrijk,1,0,1,W
136054,17,BEL1,2017-07-30,Mechelen,Standard,1,1,0,D
136055,17,BEL1,2017-07-30,St Truiden,Gent,3,2,1,W
136056,17,BEL1,2017-07-30,Oostende,Mouscron,0,1,-1,L
136057,17,BEL1,2017-08-04,Standard,Genk,2,1,1,W
136058,17,BEL1,2017-08-05,Mouscron,Charleroi,2,5,-3,L
136059,17,BEL1,2017-08-05,Kortrijk,Lokeren,1,0,1,W
136060,17,BEL1,2017-08-05,Waasland-Beveren,Mechelen,2,2,0,D
136061,17,BEL1,2017-08-05,Waregem,St Truiden,2,0,2,W
136062,17,BEL1,2017-08-06,Gent,Antwerp,0,1,-1,L
136063,17,BEL1,2017-08-06,Anderlecht,Oostende,1,0,1,W
136064,17,BEL1,2017-08-06,Club Brugge,Eupen,3,1,2,W
136065,17,BEL1,2017-08-11,Waregem,Club Brugge,1,2,-1,L
136066,17,BEL1,2017-08-12,Mechelen,Gent,1,1,0,D
136067,17,BEL1,2017-08-12,Eupen,Kortrijk,1,2,-1,L
136068,17,BEL1,2017-08-12,Lokeren,Mouscron,0,2,-2,L
136069,17,BEL1,2017-08-12,Oostende,Waasland-Beveren,0,3,-3,L
136070,17,BEL1,2017-08-13,Antwerp,Genk,3,5,-2,L
136071,17,BEL1,2017-08-13,Charleroi,Anderlecht,2,0,2,W
136072,17,BEL1,2017-08-13,St Truiden,Standard,1,0,1,W
136073,17,BEL1,2017-08-18,Standard,Waregem,0,4,-4,L
136074,17,BEL1,2017-08-19,Genk,Charleroi,0,1,-1,L
136075,17,BEL1,2017-08-19,Waasland-Beveren,Lokeren,2,3,-1,L
136076,17,BEL1,2017-08-19,Eupen,Oostende,2,1,1,W
136077,17,BEL1,2017-08-19,Mechelen,Antwerp,1,2,-1,L
136078,17,BEL1,2017-08-20,Anderlecht,St Truiden,2,3,-1,L
136079,17,BEL1,2017-08-20,Kortrijk,Club Brugge,1,2,-1,L
136080,17,BEL1,2017-08-20,Mouscron,Gent,3,2,1,W
136081,17,BEL1,2017-08-25,Kortrijk,Mouscron,1,1,0,D
136082,17,BEL1,2017-08-26,Charleroi,Waregem,3,2,1,W
136083,17,BEL1,2017-08-26,Lokeren,Eupen,3,0,3,W
136084,17,BEL1,2017-08-26,St Truiden,Waasland-Beveren,1,0,1,W
136085,17,BEL1,2017-08-26,Genk,Mechelen,1,0,1,W
136086,17,BEL1,2017-08-27,Club Brugge,Standard,4,0,4,W
136087,17,BEL1,2017-08-27,Gent,Anderlecht,0,0,0,D
136088,17,BEL1,2017-08-27,Oostende,Antwerp,3,4,-1,L
136089,17,BEL1,2017-09-08,Anderlecht,Lokeren,3,2,1,W
136090,17,BEL1,2017-09-09,Mouscron,Club Brugge,2,1,1,W
136091,17,BEL1,2017-09-09,Antwerp,St Truiden,1,1,0,D
136092,17,BEL1,2017-09-09,Waasland-Beveren,Eupen,5,1,4,W
136093,17,BEL1,2017-09-09,Waregem,Kortrijk,2,2,0,D
136094,17,BEL1,2017-09-10,Gent,Genk,1,1,0,D
136095,17,BEL1,2017-09-10,Standard,Charleroi,0,0,0,D
136096,17,BEL1,2017-09-10,Mechelen,Oostende,1,1,0,D
136097,17,BEL1,2017-09-15,Club Brugge,Mechelen,2,0,2,W
136098,17,BEL1,2017-09-16,Kortrijk,Anderlecht,2,2,0,D
136099,17,BEL1,2017-09-16,Lokeren,Antwerp,1,1,0,D
136100,17,BEL1,2017-09-16,Charleroi,Waasland-Beveren,2,2,0,D
136101,17,BEL1,2017-09-16,St Truiden,Genk,2,1,1,W
136102,17,BEL1,2017-09-17,Waregem,Mouscron,2,1,1,W
136103,17,BEL1,2017-09-17,Oostende,Gent,0,2,-2,L
136104,17,BEL1,2017-09-17,Eupen,Standard,1,1,0,D
136105,17,BEL1,2017-09-22,Antwerp,Kortrijk,3,0,3,W
136106,17,BEL1,2017-09-23,Genk,Oostende,1,1,0,D
136107,17,BEL1,2017-09-23,Mouscron,Eupen,3,2,1,W
136108,17,BEL1,2017-09-23,Mechelen,St Truiden,2,0,2,W
136109,17,BEL1,2017-09-23,Waasland-Beveren,Anderlecht,1,2,-1,L
136110,17,BEL1,2017-09-24,Gent,Waregem,0,1,-1,L
136111,17,BEL1,2017-09-24,Charleroi,Club Brugge,1,2,-1,L
136112,17,BEL1,2017-09-24,Standard,Lokeren,2,1,1,W
136113,17,BEL1,2017-09-29,St Truiden,Charleroi,0,1,-1,L
136114,17,BEL1,2017-09-30,Eupen,Genk,3,3,0,D
136115,17,BEL1,2017-09-30,Mouscron,Mechelen,2,2,0,D
136116,17,BEL1,2017-09-30,Waasland-Beveren,Antwerp,3,0,3,W
136117,17,BEL1,2017-09-30,Kortrijk,Oostende,1,2,-1,L
136118,17,BEL1,2017-10-01,Club Brugge,Gent,2,1,1,W
136119,17,BEL1,2017-10-01,Anderlecht,Standard,1,0,1,W
136120,17,BEL1,2017-10-01,Waregem,Lokeren,1,3,-2,L
136121,17,BEL1,2017-10-13,Mechelen,Anderlecht,3,4,-1,L
136122,17,BEL1,2017-10-14,Charleroi,Eupen,2,2,0,D
136123,17,BEL1,2017-10-14,Genk,Mouscron,1,1,0,D
136124,17,BEL1,2017-10-14,Lokeren,St Truiden,1,1,0,D
136125,17,BEL1,2017-10-14,Gent,Waasland-Beveren,2,0,2,W
136126,17,BEL1,2017-10-15,Standard,Kortrijk,3,1,2,W
136127,17,BEL1,2017-10-15,Oostende,Club Brugge,2,3,-1,L
136128,17,BEL1,2017-10-15,Antwerp,Waregem,3,0,3,W
136129,17,BEL1,2017-10-20,Mouscron,Standard,1,3,-2,L
136130,17,BEL1,2017-10-21,Lokeren,Charleroi,1,1,0,D
136131,17,BEL1,2017-10-21,Eupen,Mechelen,4,1,3,W
136132,17,BEL1,2017-10-21,St Truiden,Oostende,1,0,1,W
136133,17,BEL1,2017-10-21,Kortrijk,Gent,1,1,0,D
136134,17,BEL1,2017-10-22,Club Brugge,Antwerp,1,0,1,W
136135,17,BEL1,2017-10-22,Anderlecht,Genk,0,1,-1,L
136136,17,BEL1,2017-10-22,Waregem,Waasland-Beveren,2,5,-3,L
136137,17,BEL1,2017-10-24,Gent,Eupen,3,0,3,W
136138,17,BEL1,2017-10-24,Oostende,Charleroi,3,0,3,W
136139,17,BEL1,2017-10-24,Mechelen,Lokeren,0,2,-2,L
136140,17,BEL1,2017-10-25,Anderlecht,Waregem,2,0,2,W
136141,17,BEL1,2017-10-25,Genk,Club Brugge,2,0,2,W
136142,17,BEL1,2017-10-25,Waasland-Beveren,Kortrijk,2,1,1,W
136143,17,BEL1,2017-10-26,Antwerp,Standard,0,0,0,D
136144,17,BEL1,2017-10-26,St Truiden,Mouscron,1,0,1,W
136145,17,BEL1,2017-10-27,Charleroi,Gent,2,1,1,W
136146,17,BEL1,2017-10-28,Eupen,Anderlecht,2,3,-1,L
136147,17,BEL1,2017-10-28,Waregem,Mechelen,2,1,1,W
136148,17,BEL1,2017-10-28,Lokeren,Oostende,0,3,-3,L
136149,17,BEL1,2017-10-28,Kortrijk,Genk,0,0,0,D
136150,17,BEL1,2017-10-29,Club Brugge,St Truiden,4,1,3,W
136151,17,BEL1,2017-10-29,Standard,Waasland-Beveren,3,1,2,W
136152,17,BEL1,2017-10-29,Mouscron,Antwerp,2,2,0,D
136153,17,BEL1,2017-11-03,Gent,Standard,1,0,1,W
136154,17,BEL1,2017-11-04,Genk,Lokeren,0,0,0,D
136155,17,BEL1,2017-11-04,Mechelen,Kortrijk,2,0,2,W
136156,17,BEL1,2017-11-04,St Truiden,Eupen,4,4,0,D
136157,17,BEL1,2017-11-04,Waasland-Beveren,Mouscron,2,0,2,W
136158,17,BEL1,2017-11-05,Antwerp,Charleroi,1,3,-2,L
136159,17,BEL1,2017-11-05,Anderlecht,Club Brugge,0,0,0,D
136160,17,BEL1,2017-11-05,Oostende,Waregem,4,2,2,W
136161,17,BEL1,2017-11-17,Charleroi,Mechelen,2,0,2,W
136162,17,BEL1,2017-11-18,Mouscron,Anderlecht,1,2,-1,L
136163,17,BEL1,2017-11-18,Kortrijk,St Truiden,3,2,1,W
136164,17,BEL1,2017-11-18,Eupen,Antwerp,0,1,-1,L
136165,17,BEL1,2017-11-18,Standard,Oostende,0,0,0,D
136166,17,BEL1,2017-11-19,Waregem,Genk,0,1,-1,L
136167,17,BEL1,2017-11-19,Club Brugge,Waasland-Beveren,3,0,3,W
136168,17,BEL1,2017-11-19,Lokeren,Gent,0,3,-3,L
136169,17,BEL1,2017-11-24,Gent,Mouscron,3,1,2,W
136170,17,BEL1,2017-11-25,Antwerp,Mechelen,0,0,0,D
136171,17,BEL1,2017-11-25,Oostende,Eupen,1,0,1,W
136172,17,BEL1,2017-11-25,St Truiden,Lokeren,0,0,0,D
136173,17,BEL1,2017-11-25,Waasland-Beveren,Charleroi,0,2,-2,L
136174,17,BEL1,2017-11-26,Genk,Standard,0,2,-2,L
136175,17,BEL1,2017-11-26,Anderlecht,Kortrijk,4,0,4,W
136176,17,BEL1,2017-11-26,Club Brugge,Waregem,3,2,1,W
136177,17,BEL1,2017-12-01,Charleroi,Oostende,1,1,0,D
136178,17,BEL1,2017-12-02,Lokeren,Anderlecht,1,2,-1,L
136179,17,BEL1,2017-12-02,Kortrijk,Waasland-Beveren,4,1,3,W
136180,17,BEL1,2017-12-02,Mouscron,St Truiden,1,1,0,D
136181,17,BEL1,2017-12-02,Mechelen,Genk,3,2,1,W
136182,17,BEL1,2017-12-03,Standard,Antwerp,1,1,0,D
136183,17,BEL1,2017-12-03,Eupen,Club Brugge,2,2,0,D
136184,17,BEL1,2017-12-03,Waregem,Gent,0,1,-1,L
136185,17,BEL1,2017-12-08,Waasland-Beveren,Standard,3,1,2,W
136186,17,BEL1,2017-12-09,Oostende,Mechelen,0,1,-1,L
136187,17,BEL1,2017-12-09,Genk,Eupen,1,1,0,D
136188,17,BEL1,2017-12-09,Antwerp,Mouscron,1,0,1,W
136189,17,BEL1,2017-12-09,Gent,Kortrijk,2,1,1,W
136190,17,BEL1,2017-12-10,Club Brugge,Lokeren,3,1,2,W
136191,17,BEL1,2017-12-10,Anderlecht,Charleroi,1,3,-2,L
136192,17,BEL1,2017-12-10,St Truiden,Waregem,1,1,0,D
136193,17,BEL1,2017-12-15,Mouscron,Oostende,1,0,1,W
136194,17,BEL1,2017-12-16,Standard,Gent,0,0,0,D
136195,17,BEL1,2017-12-16,Kortrijk,Mechelen,2,0,2,W
136196,17,BEL1,2017-12-16,Eupen,St Truiden,0,0,0,D
136197,17,BEL1,2017-12-16,Lokeren,Waasland-Beveren,1,1,0,D
136198,17,BEL1,2017-12-17,Club Brugge,Anderlecht,5,0,5,W
136199,17,BEL1,2017-12-17,Charleroi,Genk,1,1,0,D
136200,17,BEL1,2017-12-17,Waregem,Antwerp,1,2,-1,L
136201,17,BEL1,2017-12-20,Mechelen,Club Brugge,0,3,-3,L
136202,17,BEL1,2017-12-21,Gent,Charleroi,1,0,1,W
136203,17,BEL1,2017-12-21,Antwerp,Lokeren,1,2,-1,L
136204,17,BEL1,2017-12-22,Anderlecht,Eupen,1,0,1,W
136205,17,BEL1,2017-12-22,Waasland-Beveren,Oostende,1,3,-2,L
136206,17,BEL1,2017-12-23,Mouscron,Waregem,2,1,1,W
136207,17,BEL1,2017-12-23,Genk,Kortrijk,2,3,-1,L
136208,17,BEL1,2017-12-23,Standard,St Truiden,1,1,0,D
136209,17,BEL1,2017-12-26,Club Brugge,Mouscron,4,2,2,W
136210,17,BEL1,2017-12-26,Eupen,Waasland-Beveren,1,0,1,W
136211,17,BEL1,2017-12-26,Lokeren,Mechelen,2,0,2,W
136212,17,BEL1,2017-12-26,Waregem,Charleroi,0,4,-4,L
136213,17,BEL1,2017-12-26,Anderlecht,Gent,1,0,1,W
136214,17,BEL1,2017-12-27,Kortrijk,Standard,2,1,1,W
136215,17,BEL1,2017-12-27,St Truiden,Antwerp,0,3,-3,L
136216,17,BEL1,2018-01-16,Oostende,Genk,1,2,-1,L
136217,17,BEL1,2018-01-19,Charleroi,Mouscron,2,0,2,W
136218,17,BEL1,2018-01-20,Standard,Eupen,3,2,1,W
136219,17,BEL1,2018-01-20,Oostende,Kortrijk,2,1,1,W
136220,17,BEL1,2018-01-20,Waasland-Beveren,St Truiden,3,1,2,W
136221,17,BEL1,2018-01-20,Mechelen,Waregem,0,2,-2,L
136222,17,BEL1,2018-01-21,Antwerp,Club Brugge,2,2,0,D
136223,17,BEL1,2018-01-21,Genk,Anderlecht,0,1,-1,L
136224,17,BEL1,2018-01-21,Gent,Lokeren,3,0,3,W
136225,17,BEL1,2018-01-23,Mouscron,Kortrijk,0,3,-3,L
136226,17,BEL1,2018-01-23,Waregem,Standard,2,1,1,W
136227,17,BEL1,2018-01-23,St Truiden,Mechelen,2,0,2,W
136228,17,BEL1,2018-01-24,Anderlecht,Waasland-Beveren,2,2,0,D
136229,17,BEL1,2018-01-24,Eupen,Charleroi,1,0,1,W
136230,17,BEL1,2018-01-24,Lokeren,Genk,1,2,-1,L
136231,17,BEL1,2018-01-24,Antwerp,Gent,1,1,0,D
136232,17,BEL1,2018-01-25,Club Brugge,Oostende,3,2,1,W
136233,17,BEL1,2018-01-26,Mechelen,Mouscron,0,2,-2,L
136234,17,BEL1,2018-01-27,Charleroi,Antwerp,1,1,0,D
136235,17,BEL1,2018-01-27,Kortrijk,Eupen,0,0,0,D
136236,17,BEL1,2018-01-27,Waasland-Beveren,Waregem,2,2,0,D
136237,17,BEL1,2018-01-27,Genk,St Truiden,1,1,0,D
136238,17,BEL1,2018-01-28,Gent,Club Brugge,2,0,2,W
136239,17,BEL1,2018-01-28,Standard,Anderlecht,3,3,0,D
136240,17,BEL1,2018-01-28,Oostende,Lokeren,2,3,-1,L
136241,17,BEL1,2018-02-02,Antwerp,Waasland-Beveren,1,2,-1,L
136242,17,BEL1,2018-02-03,Lokeren,Standard,0,3,-3,L
136243,17,BEL1,2018-02-03,Eupen,Gent,1,1,0,D
136244,17,BEL1,2018-02-03,St Truiden,Kortrijk,0,2,-2,L
136245,17,BEL1,2018-02-03,Mouscron,Genk,0,1,-1,L
136246,17,BEL1,2018-02-04,Anderlecht,Mechelen,2,2,0,D
136247,17,BEL1,2018-02-04,Club Brugge,Charleroi,3,3,0,D
136248,17,BEL1,2018-02-04,Waregem,Oostende,1,1,0,D
136249,17,BEL1,2018-02-09,Genk,Waregem,3,1,2,W
136250,17,BEL1,2018-02-10,Oostende,Anderlecht,2,0,2,W
136251,17,BEL1,2018-02-10,Kortrijk,Antwerp,4,0,4,W
136252,17,BEL1,2018-02-10,Mechelen,Eupen,1,0,1,W
136253,17,BEL1,2018-02-10,Gent,St Truiden,3,0,3,W
136254,17,BEL1,2018-02-11,Waasland-Beveren,Club Brugge,1,1,0,D
136255,17,BEL1,2018-02-11,Standard,Mouscron,4,3,1,W
136256,17,BEL1,2018-02-11,Charleroi,Lokeren,1,1,0,D
136257,17,BEL1,2018-02-16,St Truiden,Anderlecht,1,0,1,W
136258,17,BEL1,2018-02-17,Antwerp,Oostende,0,0,0,D
136259,17,BEL1,2018-02-17,Waregem,Eupen,3,2,1,W
136260,17,BEL1,2018-02-17,Lokeren,Kortrijk,0,1,-1,L
136261,17,BEL1,2018-02-17,Club Brugge,Genk,2,2,0,D
136262,17,BEL1,2018-02-18,Gent,Mechelen,2,2,0,D
136263,17,BEL1,2018-02-18,Charleroi,Standard,1,1,0,D
136264,17,BEL1,2018-02-18,Mouscron,Waasland-Beveren,2,2,0,D
136265,17,BEL1,2018-02-23,Genk,Antwerp,4,0,4,W
136266,17,BEL1,2018-02-24,Mechelen,Charleroi,1,1,0,D
136267,17,BEL1,2018-02-24,Eupen,Lokeren,3,2,1,W
136268,17,BEL1,2018-02-24,Oostende,St Truiden,2,0,2,W
136269,17,BEL1,2018-02-24,Waasland-Beveren,Gent,1,2,-1,L
136270,17,BEL1,2018-02-25,Anderlecht,Mouscron,5,3,2,W
136271,17,BEL1,2018-02-25,Standard,Club Brugge,1,1,0,D
136272,17,BEL1,2018-02-25,Kortrijk,Waregem,0,1,-1,L
136273,17,BEL1,2018-03-03,Club Brugge,Kortrijk,2,1,1,W
136274,17,BEL1,2018-03-03,Standard,Mechelen,3,2,1,W
136275,17,BEL1,2018-03-03,Gent,Oostende,2,3,-1,L
136276,17,BEL1,2018-03-03,Mouscron,Lokeren,1,2,-1,L
136277,17,BEL1,2018-03-03,Waregem,Anderlecht,2,3,-1,L
136278,17,BEL1,2018-03-03,Charleroi,St Truiden,0,0,0,D
136279,17,BEL1,2018-03-03,Antwerp,Eupen,2,0,2,W
136280,17,BEL1,2018-03-03,Waasland-Beveren,Genk,0,1,-1,L
136281,17,BEL1,2018-03-11,Anderlecht,Antwerp,2,1,1,W
136282,17,BEL1,2018-03-11,Genk,Gent,1,2,-1,L
136283,17,BEL1,2018-03-11,Kortrijk,Charleroi,2,0,2,W
136284,17,BEL1,2018-03-11,Eupen,Mouscron,4,0,4,W
136285,17,BEL1,2018-03-11,Oostende,Standard,2,3,-1,L
136286,17,BEL1,2018-03-11,Mechelen,Waasland-Beveren,2,0,2,W
136287,17,BEL1,2018-03-11,Lokeren,Waregem,0,2,-2,L
136288,17,BEL1,2018-03-11,St Truiden,Club Brugge,0,1,-1,L
136289,17,BEL1,2018-03-30,Standard,Charleroi,1,0,1,W
136290,17,BEL1,2018-04-01,Anderlecht,Gent,0,2,-2,L
136291,17,BEL1,2018-04-02,Club Brugge,Genk,1,0,1,W
136292,17,BEL1,2018-04-06,Charleroi,Anderlecht,1,2,-1,L
136293,17,BEL1,2018-04-07,Genk,Standard,1,0,1,W
136294,17,BEL1,2018-04-08,Gent,Club Brugge,1,0,1,W
136295,17,BEL1,2018-04-13,Charleroi,Genk,2,2,0,D
136296,17,BEL1,2018-04-14,Standard,Gent,1,0,1,W
136297,17,BEL1,2018-04-15,Anderlecht,Club Brugge,1,0,1,W
136298,17,BEL1,2018-04-17,Gent,Genk,0,0,0,D
136299,17,BEL1,2018-04-18,Standard,Anderlecht,2,1,1,W
136300,17,BEL1,2018-04-19,Club Brugge,Charleroi,6,0,6,W
136301,17,BEL1,2018-04-21,Genk,Anderlecht,2,1,1,W
136302,17,BEL1,2018-04-22,Club Brugge,Standard,4,4,0,D
136303,17,BEL1,2018-04-22,Charleroi,Gent,2,1,1,W
136304,17,BEL1,2018-04-27,Genk,Club Brugge,1,1,0,D
136305,17,BEL1,2018-04-29,Anderlecht,Charleroi,3,1,2,W
136306,17,BEL1,2018-04-29,Gent,Standard,1,3,-2,L
136307,17,BEL1,2018-05-04,Gent,Charleroi,0,1,-1,L
136308,17,BEL1,2018-05-06,Club Brugge,Anderlecht,1,2,-1,L
136309,17,BEL1,2018-05-06,Standard,Genk,5,0,5,W
136310,17,BEL1,2018-05-10,Anderlecht,Standard,1,3,-2,L
136311,17,BEL1,2018-05-10,Charleroi,Club Brugge,1,3,-2,L
136312,17,BEL1,2018-05-10,Genk,Gent,1,1,0,D
136313,17,BEL1,2018-05-13,Gent,Anderlecht,1,0,1,W
136314,17,BEL1,2018-05-13,Standard,Club Brugge,1,1,0,D
136315,17,BEL1,2018-05-13,Genk,Charleroi,4,1,3,W
136316,17,BEL1,2018-05-20,Club Brugge,Gent,0,1,-1,L
136317,17,BEL1,2018-05-20,Charleroi,Standard,0,0,0,D
136318,17,BEL1,2018-05-20,Anderlecht,Genk,1,2,-1,L
136319,18,BEL1,2018-07-27,Standard,Gent,3,2,1,W
136320,18,BEL1,2018-07-28,Kortrijk,Anderlecht,1,4,-3,L
136321,18,BEL1,2018-07-28,Waregem,Waasland-Beveren,2,2,0,D
136322,18,BEL1,2018-07-28,St Truiden,Cercle Brugge,0,0,0,D
136323,18,BEL1,2018-07-28,Oostende,Mouscron,2,1,1,W
136324,18,BEL1,2018-07-29,Club Brugge,Eupen,5,2,3,W
136325,18,BEL1,2018-07-29,Charleroi,Antwerp,0,1,-1,L
136326,18,BEL1,2018-07-29,Lokeren,Genk,0,4,-4,L
136327,18,BEL1,2018-08-03,Waasland-Beveren,Standard,0,0,0,D
136328,18,BEL1,2018-08-04,Eupen,Charleroi,1,4,-3,L
136329,18,BEL1,2018-08-04,Cercle Brugge,Lokeren,3,2,1,W
136330,18,BEL1,2018-08-04,Antwerp,Kortrijk,0,0,0,D
136331,18,BEL1,2018-08-04,Gent,Waregem,1,1,0,D
136332,18,BEL1,2018-08-05,Anderlecht,Oostende,5,2,3,W
136333,18,BEL1,2018-08-05,Genk,St Truiden,1,1,0,D
136334,18,BEL1,2018-08-05,Mouscron,Club Brugge,0,1,-1,L
136335,18,BEL1,2018-08-10,Club Brugge,Kortrijk,3,0,3,W
136336,18,BEL1,2018-08-11,Standard,Cercle Brugge,0,0,0,D
136337,18,BEL1,2018-08-11,Waregem,Eupen,4,0,4,W
136338,18,BEL1,2018-08-11,St Truiden,Lokeren,1,1,0,D
136339,18,BEL1,2018-08-11,Mouscron,Antwerp,0,1,-1,L
136340,18,BEL1,2018-08-12,Oostende,Genk,0,2,-2,L
136341,18,BEL1,2018-08-12,Charleroi,Anderlecht,1,2,-1,L
136342,18,BEL1,2018-08-12,Gent,Waasland-Beveren,4,1,3,W
136343,18,BEL1,2018-08-17,Anderlecht,Mouscron,2,0,2,W
136344,18,BEL1,2018-08-18,Lokeren,Standard,0,3,-3,L
136345,18,BEL1,2018-08-18,Cercle Brugge,Waregem,3,1,2,W
136346,18,BEL1,2018-08-18,Waasland-Beveren,St Truiden,2,2,0,D
136347,18,BEL1,2018-08-18,Kortrijk,Oostende,1,2,-1,L
136348,18,BEL1,2018-08-19,Antwerp,Club Brugge,1,1,0,D
136349,18,BEL1,2018-08-19,Genk,Charleroi,3,1,2,W
136350,18,BEL1,2018-08-19,Eupen,Gent,2,3,-1,L
136351,18,BEL1,2018-08-24,Oostende,Waregem,3,1,2,W
136352,18,BEL1,2018-08-25,Standard,St Truiden,3,2,1,W
136353,18,BEL1,2018-08-25,Mouscron,Eupen,0,1,-1,L
136354,18,BEL1,2018-08-25,Antwerp,Cercle Brugge,1,0,1,W
136355,18,BEL1,2018-08-25,Charleroi,Kortrijk,0,2,-2,L
136356,18,BEL1,2018-08-26,Club Brugge,Anderlecht,2,1,1,W
136357,18,BEL1,2018-08-26,Gent,Lokeren,2,1,1,W
136358,18,BEL1,2018-08-26,Genk,Waasland-Beveren,3,2,1,W
136359,18,BEL1,2018-08-31,Waregem,Club Brugge,2,5,-3,L
136360,18,BEL1,2018-09-01,Eupen,Standard,2,1,1,W
136361,18,BEL1,2018-09-01,Lokeren,Waasland-Beveren,1,0,1,W
136362,18,BEL1,2018-09-01,St Truiden,Oostende,1,0,1,W
136363,18,BEL1,2018-09-01,Charleroi,Mouscron,3,1,2,W
136364,18,BEL1,2018-09-02,Anderlecht,Antwerp,1,1,0,D
136365,18,BEL1,2018-09-02,Cercle Brugge,Gent,0,3,-3,L
136366,18,BEL1,2018-09-02,Kortrijk,Genk,3,3,0,D
136367,18,BEL1,2018-09-14,Club Brugge,Lokeren,2,1,1,W
136368,18,BEL1,2018-09-15,Standard,Charleroi,0,0,0,D
136369,18,BEL1,2018-09-15,Oostende,Cercle Brugge,1,1,0,D
136370,18,BEL1,2018-09-15,Waasland-Beveren,Eupen,0,0,0,D
136371,18,BEL1,2018-09-15,Genk,Anderlecht,1,0,1,W
136372,18,BEL1,2018-09-16,Mouscron,Kortrijk,1,0,1,W
136373,18,BEL1,2018-09-16,Antwerp,Waregem,5,1,4,W
136374,18,BEL1,2018-09-16,Gent,St Truiden,1,2,-1,L
136375,18,BEL1,2018-09-21,Waregem,Kortrijk,0,2,-2,L
136376,18,BEL1,2018-09-22,Waasland-Beveren,Charleroi,1,1,0,D
136377,18,BEL1,2018-09-22,Eupen,Oostende,1,2,-1,L
136378,18,BEL1,2018-09-22,Lokeren,Mouscron,0,0,0,D
136379,18,BEL1,2018-09-22,St Truiden,Antwerp,2,0,2,W
136380,18,BEL1,2018-09-23,Gent,Club Brugge,0,4,-4,L
136381,18,BEL1,2018-09-23,Anderlecht,Standard,2,1,1,W
136382,18,BEL1,2018-09-23,Cercle Brugge,Genk,2,5,-3,L
136383,18,BEL1,2018-09-28,Kortrijk,Eupen,1,3,-2,L
136384,18,BEL1,2018-09-29,Genk,Waregem,4,0,4,W
136385,18,BEL1,2018-09-29,Mouscron,Waasland-Beveren,0,3,-3,L
136386,18,BEL1,2018-09-29,Charleroi,Lokeren,2,1,1,W
136387,18,BEL1,2018-09-29,Club Brugge,Cercle Brugge,4,0,4,W
136388,18,BEL1,2018-09-30,Anderlecht,St Truiden,0,0,0,D
136389,18,BEL1,2018-09-30,Oostende,Standard,1,3,-2,L
136390,18,BEL1,2018-09-30,Antwerp,Gent,2,2,0,D
136391,18,BEL1,2018-10-05,Cercle Brugge,Charleroi,2,1,1,W
136392,18,BEL1,2018-10-06,Eupen,Antwerp,1,2,-1,L
136393,18,BEL1,2018-10-06,Lokeren,Kortrijk,1,3,-2,L
136394,18,BEL1,2018-10-06,St Truiden,Mouscron,3,1,2,W
136395,18,BEL1,2018-10-06,Waasland-Beveren,Oostende,1,1,0,D
136396,18,BEL1,2018-10-07,Waregem,Anderlecht,1,2,-1,L
136397,18,BEL1,2018-10-07,Standard,Club Brugge,3,1,2,W
136398,18,BEL1,2018-10-07,Gent,Genk,1,5,-4,L
136399,18,BEL1,2018-10-19,Club Brugge,Waasland-Beveren,1,1,0,D
136400,18,BEL1,2018-10-20,Mouscron,Standard,0,0,0,D
136401,18,BEL1,2018-10-20,Kortrijk,St Truiden,3,1,2,W
136402,18,BEL1,2018-10-20,Antwerp,Lokeren,2,1,1,W
136403,18,BEL1,2018-10-20,Genk,Eupen,2,1,1,W
136404,18,BEL1,2018-10-21,Anderlecht,Cercle Brugge,4,2,2,W
136405,18,BEL1,2018-10-21,Oostende,Gent,0,4,-4,L
136406,18,BEL1,2018-10-21,Charleroi,Waregem,3,2,1,W
136407,18,BEL1,2018-10-26,Gent,Charleroi,2,1,1,W
136408,18,BEL1,2018-10-27,Waregem,Mouscron,2,2,0,D
136409,18,BEL1,2018-10-27,Cercle Brugge,Kortrijk,1,1,0,D
136410,18,BEL1,2018-10-27,Lokeren,Oostende,0,0,0,D
136411,18,BEL1,2018-10-27,St Truiden,Club Brugge,2,2,0,D
136412,18,BEL1,2018-10-28,Standard,Genk,1,1,0,D
136413,18,BEL1,2018-10-28,Eupen,Anderlecht,2,1,1,W
136414,18,BEL1,2018-10-28,Waasland-Beveren,Antwerp,0,1,-1,L
136415,18,BEL1,2018-10-30,Club Brugge,Oostende,4,0,4,W
136416,18,BEL1,2018-10-30,Mouscron,Gent,3,1,2,W
136417,18,BEL1,2018-10-30,Charleroi,St Truiden,1,0,1,W
136418,18,BEL1,2018-10-31,Kortrijk,Waasland-Beveren,2,2,0,D
136419,18,BEL1,2018-10-31,Eupen,Cercle Brugge,2,0,2,W
136420,18,BEL1,2018-10-31,Antwerp,Genk,2,4,-2,L
136421,18,BEL1,2018-11-01,Anderlecht,Lokeren,1,1,0,D
136422,18,BEL1,2018-11-01,Waregem,Standard,3,1,2,W
136423,18,BEL1,2018-11-02,Oostende,Charleroi,2,1,1,W
136424,18,BEL1,2018-11-03,Genk,Club Brugge,1,1,0,D
136425,18,BEL1,2018-11-03,Cercle Brugge,Mouscron,2,1,1,W
136426,18,BEL1,2018-11-03,Gent,Kortrijk,3,1,2,W
136427,18,BEL1,2018-11-04,Standard,Antwerp,0,2,-2,L
136428,18,BEL1,2018-11-04,Waasland-Beveren,Anderlecht,1,2,-1,L
136429,18,BEL1,2018-11-04,Lokeren,Eupen,2,0,2,W
136430,18,BEL1,2018-11-04,St Truiden,Waregem,2,1,1,W
136431,18,BEL1,2018-11-09,Antwerp,Oostende,2,0,2,W
136432,18,BEL1,2018-11-10,Charleroi,Club Brugge,2,1,1,W
136433,18,BEL1,2018-11-10,Eupen,St Truiden,1,4,-3,L
136434,18,BEL1,2018-11-10,Waregem,Lokeren,2,0,2,W
136435,18,BEL1,2018-11-10,Cercle Brugge,Waasland-Beveren,2,0,2,W
136436,18,BEL1,2018-11-11,Anderlecht,Gent,2,0,2,W
136437,18,BEL1,2018-11-11,Kortrijk,Standard,0,2,-2,L
136438,18,BEL1,2018-11-11,Mouscron,Genk,0,0,0,D
136439,18,BEL1,2018-11-23,Club Brugge,Waregem,1,3,-2,L
136440,18,BEL1,2018-11-24,Standard,Eupen,3,0,3,W
136441,18,BEL1,2018-11-24,Oostende,Kortrijk,1,2,-1,L
136442,18,BEL1,2018-11-24,Waasland-Beveren,Mouscron,1,2,-1,L
136443,18,BEL1,2018-11-24,Genk,Cercle Brugge,1,2,-1,L
136444,18,BEL1,2018-11-25,Gent,Antwerp,0,0,0,D
136445,18,BEL1,2018-11-25,St Truiden,Anderlecht,4,2,2,W
136446,18,BEL1,2018-11-25,Lokeren,Charleroi,2,4,-2,L
136447,18,BEL1,2018-11-30,Lokeren,Gent,2,2,0,D
136448,18,BEL1,2018-12-01,Charleroi,Cercle Brugge,3,1,2,W
136449,18,BEL1,2018-12-01,Kortrijk,Mouscron,1,0,1,W
136450,18,BEL1,2018-12-01,Waregem,Oostende,1,1,0,D
136451,18,BEL1,2018-12-01,Antwerp,St Truiden,1,3,-2,L
136452,18,BEL1,2018-12-02,Club Brugge,Standard,3,0,3,W
136453,18,BEL1,2018-12-02,Anderlecht,Genk,0,1,-1,L
136454,18,BEL1,2018-12-02,Eupen,Waasland-Beveren,1,0,1,W
136455,18,BEL1,2018-12-07,Waasland-Beveren,Club Brugge,2,1,1,W
136456,18,BEL1,2018-12-08,Genk,Kortrijk,1,1,0,D
136457,18,BEL1,2018-12-08,Mouscron,Waregem,0,0,0,D
136458,18,BEL1,2018-12-08,Oostende,Lokeren,1,0,1,W
136459,18,BEL1,2018-12-08,St Truiden,Standard,1,1,0,D
136460,18,BEL1,2018-12-09,Cercle Brugge,Antwerp,0,3,-3,L
136461,18,BEL1,2018-12-09,Anderlecht,Charleroi,1,1,0,D
136462,18,BEL1,2018-12-09,Gent,Eupen,2,0,2,W
136463,18,BEL1,2018-12-14,Charleroi,Gent,2,0,2,W
136464,18,BEL1,2018-12-15,Kortrijk,Club Brugge,0,0,0,D
136465,18,BEL1,2018-12-15,Eupen,Mouscron,1,0,1,W
136466,18,BEL1,2018-12-15,Lokeren,St Truiden,2,0,2,W
136467,18,BEL1,2018-12-15,Antwerp,Waasland-Beveren,0,2,-2,L
136468,18,BEL1,2018-12-16,Cercle Brugge,Anderlecht,2,1,1,W
136469,18,BEL1,2018-12-16,Genk,Oostende,2,0,2,W
136470,18,BEL1,2018-12-16,Standard,Waregem,4,1,3,W
136471,18,BEL1,2018-12-21,Gent,Cercle Brugge,4,1,3,W
136472,18,BEL1,2018-12-22,Mouscron,Anderlecht,3,1,2,W
136473,18,BEL1,2018-12-22,Waasland-Beveren,Lokeren,2,1,1,W
136474,18,BEL1,2018-12-22,St Truiden,Kortrijk,0,0,0,D
136475,18,BEL1,2018-12-22,Standard,Oostende,3,1,2,W
136476,18,BEL1,2018-12-23,Club Brugge,Antwerp,5,1,4,W
136477,18,BEL1,2018-12-23,Eupen,Genk,0,2,-2,L
136478,18,BEL1,2018-12-23,Waregem,Charleroi,3,1,2,W
136479,18,BEL1,2018-12-26,Kortrijk,Waregem,4,2,2,W
136480,18,BEL1,2018-12-26,Oostende,St Truiden,1,1,0,D
136481,18,BEL1,2018-12-26,Cercle Brugge,Eupen,0,1,-1,L
136482,18,BEL1,2018-12-26,Antwerp,Mouscron,2,1,1,W
136483,18,BEL1,2018-12-26,Charleroi,Standard,0,1,-1,L
136484,18,BEL1,2018-12-26,Genk,Gent,3,1,2,W
136485,18,BEL1,2018-12-27,Lokeren,Club Brugge,0,1,-1,L
136486,18,BEL1,2018-12-27,Anderlecht,Waasland-Beveren,3,0,3,W
136487,18,BEL1,2019-01-18,St Truiden,Genk,2,3,-1,L
136488,18,BEL1,2019-01-19,Standard,Kortrijk,2,1,1,W
136489,18,BEL1,2019-01-19,Eupen,Lokeren,4,1,3,W
136490,18,BEL1,2019-01-19,Waasland-Beveren,Cercle Brugge,1,1,0,D
136491,18,BEL1,2019-01-19,Waregem,Antwerp,1,2,-1,L
136492,18,BEL1,2019-01-20,Club Brugge,Charleroi,0,1,-1,L
136493,18,BEL1,2019-01-20,Gent,Anderlecht,1,0,1,W
136494,18,BEL1,2019-01-20,Mouscron,Oostende,2,1,1,W
136495,18,BEL1,2019-01-25,Antwerp,Standard,1,1,0,D
136496,18,BEL1,2019-01-26,Charleroi,Waasland-Beveren,2,2,0,D
136497,18,BEL1,2019-01-26,Cercle Brugge,St Truiden,1,2,-1,L
136498,18,BEL1,2019-01-26,Lokeren,Waregem,0,3,-3,L
136499,18,BEL1,2019-01-26,Genk,Mouscron,1,2,-1,L
136500,18,BEL1,2019-01-27,Oostende,Club Brugge,1,2,-1,L
136501,18,BEL1,2019-01-27,Anderlecht,Eupen,2,1,1,W
136502,18,BEL1,2019-01-27,Kortrijk,Gent,1,2,-1,L
136503,18,BEL1,2019-02-01,Mouscron,Charleroi,3,0,3,W
136504,18,BEL1,2019-02-02,Oostende,Antwerp,0,2,-2,L
136505,18,BEL1,2019-02-02,Kortrijk,Lokeren,2,1,1,W
136506,18,BEL1,2019-02-02,Waregem,Cercle Brugge,3,2,1,W
136507,18,BEL1,2019-02-02,Waasland-Beveren,Genk,1,2,-1,L
136508,18,BEL1,2019-02-03,Club Brugge,Gent,1,1,0,D
136509,18,BEL1,2019-02-03,Standard,Anderlecht,2,1,1,W
136510,18,BEL1,2019-02-03,St Truiden,Eupen,4,1,3,W
136511,18,BEL1,2019-02-08,Genk,Standard,2,0,2,W
136512,18,BEL1,2019-02-09,Charleroi,Oostende,1,1,0,D
136513,18,BEL1,2019-02-09,Eupen,Kortrijk,0,1,-1,L
136514,18,BEL1,2019-02-09,St Truiden,Waasland-Beveren,2,1,1,W
136515,18,BEL1,2019-02-09,Lokeren,Antwerp,2,1,1,W
136516,18,BEL1,2019-02-10,Cercle Brugge,Club Brugge,2,2,0,D
136517,18,BEL1,2019-02-10,Anderlecht,Waregem,0,0,0,D
136518,18,BEL1,2019-02-10,Gent,Mouscron,1,2,-1,L
136519,18,BEL1,2019-02-15,Standard,Lokeren,3,1,2,W
136520,18,BEL1,2019-02-16,Kortrijk,Charleroi,1,2,-1,L
136521,18,BEL1,2019-02-16,Oostende,Eupen,1,1,0,D
136522,18,BEL1,2019-02-16,Waregem,St Truiden,1,1,0,D
136523,18,BEL1,2019-02-16,Waasland-Beveren,Gent,2,1,1,W
136524,18,BEL1,2019-02-17,Club Brugge,Genk,3,1,2,W
136525,18,BEL1,2019-02-17,Antwerp,Anderlecht,0,1,-1,L
136526,18,BEL1,2019-02-17,Mouscron,Cercle Brugge,3,0,3,W
136527,18,BEL1,2019-02-22,Gent,Standard,2,1,1,W
136528,18,BEL1,2019-02-23,Eupen,Waregem,2,3,-1,L
136529,18,BEL1,2019-02-23,Cercle Brugge,Oostende,2,2,0,D
136530,18,BEL1,2019-02-23,Waasland-Beveren,Kortrijk,2,6,-4,L
136531,18,BEL1,2019-02-23,Mouscron,Lokeren,1,0,1,W
136532,18,BEL1,2019-02-24,Anderlecht,Club Brugge,2,2,0,D
136533,18,BEL1,2019-02-24,Genk,Antwerp,0,0,0,D
136534,18,BEL1,2019-02-24,St Truiden,Charleroi,3,1,2,W
136535,18,BEL1,2019-03-01,Standard,Mouscron,1,1,0,D
136536,18,BEL1,2019-03-02,Charleroi,Genk,1,1,0,D
136537,18,BEL1,2019-03-02,Kortrijk,Cercle Brugge,2,1,1,W
136538,18,BEL1,2019-03-02,Oostende,Waasland-Beveren,1,1,0,D
136539,18,BEL1,2019-03-02,Club Brugge,St Truiden,1,0,1,W
136540,18,BEL1,2019-03-03,Waregem,Gent,1,3,-2,L
136541,18,BEL1,2019-03-03,Lokeren,Anderlecht,1,2,-1,L
136542,18,BEL1,2019-03-03,Antwerp,Eupen,2,1,1,W
136543,18,BEL1,2019-03-10,Anderlecht,Kortrijk,2,0,2,W
136544,18,BEL1,2019-03-10,Gent,Oostende,2,1,1,W
136545,18,BEL1,2019-03-10,Genk,Lokeren,1,0,1,W
136546,18,BEL1,2019-03-10,Mouscron,St Truiden,1,1,0,D
136547,18,BEL1,2019-03-10,Eupen,Club Brugge,0,4,-4,L
136548,18,BEL1,2019-03-10,Cercle Brugge,Standard,1,2,-1,L
136549,18,BEL1,2019-03-10,Antwerp,Charleroi,1,2,-1,L
136550,18,BEL1,2019-03-10,Waasland-Beveren,Waregem,1,1,0,D
136551,18,BEL1,2019-03-17,Club Brugge,Mouscron,1,2,-1,L
136552,18,BEL1,2019-03-17,Standard,Waasland-Beveren,4,3,1,W
136553,18,BEL1,2019-03-17,Kortrijk,Antwerp,2,0,2,W
136554,18,BEL1,2019-03-17,Oostende,Anderlecht,0,2,-2,L
136555,18,BEL1,2019-03-17,Waregem,Genk,3,3,0,D
136556,18,BEL1,2019-03-17,Lokeren,Cercle Brugge,3,1,2,W
136557,18,BEL1,2019-03-17,Charleroi,Eupen,1,2,-1,L
136558,18,BEL1,2019-03-17,St Truiden,Gent,0,2,-2,L
136559,18,BEL1,2019-03-29,Standard,Antwerp,3,1,2,W
136560,18,BEL1,2019-03-30,Genk,Anderlecht,3,0,3,W
136561,18,BEL1,2019-03-31,Club Brugge,Gent,3,0,3,W
136562,18,BEL1,2019-04-02,Antwerp,Genk,1,0,1,W
136563,18,BEL1,2019-04-03,Gent,Standard,1,2,-1,L
136564,18,BEL1,2019-04-04,Anderlecht,Club Brugge,2,3,-1,L
136565,18,BEL1,2019-04-06,Genk,Gent,2,1,1,W
136566,18,BEL1,2019-04-07,Anderlecht,Antwerp,1,2,-1,L
136567,18,BEL1,2019-04-08,Club Brugge,Standard,4,0,4,W
136568,18,BEL1,2019-04-13,Gent,Antwerp,1,2,-1,L
136569,18,BEL1,2019-04-14,Genk,Club Brugge,3,1,2,W
136570,18,BEL1,2019-04-19,Standard,Genk,1,3,-2,L
136571,18,BEL1,2019-04-21,Anderlecht,Gent,0,0,0,D
136572,18,BEL1,2019-04-22,Antwerp,Club Brugge,0,0,0,D
136573,18,BEL1,2019-04-26,Antwerp,Standard,2,1,1,W
136574,18,BEL1,2019-04-27,Gent,Genk,0,1,-1,L
136575,18,BEL1,2019-04-28,Club Brugge,Anderlecht,1,0,1,W
136576,18,BEL1,2019-05-03,Genk,Antwerp,4,0,4,W
136577,18,BEL1,2019-05-05,Anderlecht,Standard,2,1,1,W
136578,18,BEL1,2019-05-05,Gent,Club Brugge,0,1,-1,L
136579,18,BEL1,2019-05-10,Standard,Gent,2,3,-1,L
136580,18,BEL1,2019-05-12,Antwerp,Anderlecht,1,1,0,D
136581,18,BEL1,2019-05-12,Club Brugge,Genk,3,2,1,W
136582,18,BEL1,2019-05-16,Anderlecht,Genk,1,1,0,D
136583,18,BEL1,2019-05-16,Standard,Club Brugge,2,0,2,W
136584,18,BEL1,2019-05-16,Antwerp,Gent,1,2,-1,L
136585,18,BEL1,2019-05-19,Club Brugge,Antwerp,3,2,1,W
136586,18,BEL1,2019-05-19,Gent,Anderlecht,2,1,1,W
136587,18,BEL1,2019-05-19,Genk,Standard,0,0,0,D
136588,19,BEL1,2019-07-26,Genk,Kortrijk,2,1,1,W
136589,19,BEL1,2019-07-27,Cercle Brugge,Standard,0,2,-2,L
136590,19,BEL1,2019-07-27,St Truiden,Mouscron,0,1,-1,L
136591,19,BEL1,2019-07-27,Waregem,Mechelen,0,2,-2,L
136592,19,BEL1,2019-07-27,Waasland-Beveren,Club Brugge,1,3,-2,L
136593,19,BEL1,2019-07-28,Anderlecht,Oostende,1,2,-1,L
136594,19,BEL1,2019-07-28,Charleroi,Gent,1,1,0,D
136595,19,BEL1,2019-07-28,Eupen,Antwerp,1,4,-3,L
136596,19,BEL1,2019-08-02,Club Brugge,St Truiden,6,0,6,W
136597,19,BEL1,2019-08-03,Standard,Waregem,4,0,4,W
136598,19,BEL1,2019-08-03,Kortrijk,Charleroi,1,1,0,D
136599,19,BEL1,2019-08-03,Oostende,Cercle Brugge,3,1,2,W
136600,19,BEL1,2019-08-03,Mechelen,Genk,3,1,2,W
136601,19,BEL1,2019-08-04,Gent,Eupen,6,1,5,W
136602,19,BEL1,2019-08-04,Mouscron,Anderlecht,0,0,0,D
136603,19,BEL1,2019-08-04,Antwerp,Waasland-Beveren,4,1,3,W
136604,19,BEL1,2019-08-09,Anderlecht,Mechelen,0,0,0,D
136605,19,BEL1,2019-08-10,Oostende,Club Brugge,0,2,-2,L
136606,19,BEL1,2019-08-10,Eupen,Waasland-Beveren,1,1,0,D
136607,19,BEL1,2019-08-10,Cercle Brugge,Kortrijk,1,3,-2,L
136608,19,BEL1,2019-08-10,Genk,Waregem,0,2,-2,L
136609,19,BEL1,2019-08-11,St Truiden,Standard,2,1,1,W
136610,19,BEL1,2019-08-11,Charleroi,Antwerp,2,1,1,W
136611,19,BEL1,2019-08-11,Mouscron,Gent,2,1,1,W
136612,19,BEL1,2019-08-16,Club Brugge,Eupen,0,0,0,D
136613,19,BEL1,2019-08-17,Kortrijk,Anderlecht,4,2,2,W
136614,19,BEL1,2019-08-17,Mechelen,Cercle Brugge,3,1,2,W
136615,19,BEL1,2019-08-17,Waasland-Beveren,Genk,0,4,-4,L
136616,19,BEL1,2019-08-18,Standard,Mouscron,4,1,3,W
136617,19,BEL1,2019-08-18,Antwerp,St Truiden,2,0,2,W
136618,19,BEL1,2019-08-18,Gent,Oostende,2,0,2,W
136619,19,BEL1,2019-08-19,Waregem,Charleroi,3,1,2,W
136620,19,BEL1,2019-08-23,Genk,Anderlecht,1,0,1,W
136621,19,BEL1,2019-08-24,Cercle Brugge,Waasland-Beveren,1,0,1,W
136622,19,BEL1,2019-08-24,St Truiden,Waregem,0,0,0,D
136623,19,BEL1,2019-08-24,Oostende,Mechelen,2,1,1,W
136624,19,BEL1,2019-08-25,Standard,Kortrijk,2,1,1,W
136625,19,BEL1,2019-08-25,Mouscron,Eupen,2,0,2,W
136626,19,BEL1,2019-08-30,Mechelen,Mouscron,2,2,0,D
136627,19,BEL1,2019-08-31,Eupen,St Truiden,0,2,-2,L
136628,19,BEL1,2019-08-31,Kortrijk,Oostende,2,2,0,D
136629,19,BEL1,2019-08-31,Waasland-Beveren,Charleroi,0,4,-4,L
136630,19,BEL1,2019-09-01,Club Brugge,Genk,1,1,0,D
136631,19,BEL1,2019-09-01,Anderlecht,Standard,1,0,1,W
136632,19,BEL1,2019-09-01,Gent,Cercle Brugge,3,2,1,W
136633,19,BEL1,2019-09-01,Waregem,Antwerp,2,0,2,W
136634,19,BEL1,2019-09-13,Charleroi,Genk,2,1,1,W
136635,19,BEL1,2019-09-14,Oostende,Standard,1,4,-3,L
136636,19,BEL1,2019-09-14,Eupen,Waregem,1,1,0,D
136637,19,BEL1,2019-09-14,St Truiden,Waasland-Beveren,1,1,0,D
136638,19,BEL1,2019-09-14,Cercle Brugge,Club Brugge,0,2,-2,L
136639,19,BEL1,2019-09-15,Anderlecht,Antwerp,1,2,-1,L
136640,19,BEL1,2019-09-15,Gent,Mechelen,3,0,3,W
136641,19,BEL1,2019-09-15,Mouscron,Kortrijk,2,0,2,W
136642,19,BEL1,2019-09-20,Kortrijk,Mechelen,2,3,-1,L
136643,19,BEL1,2019-09-21,Charleroi,St Truiden,0,3,-3,L
136644,19,BEL1,2019-09-21,Antwerp,Cercle Brugge,3,1,2,W
136645,19,BEL1,2019-09-21,Waasland-Beveren,Mouscron,1,1,0,D
136646,19,BEL1,2019-09-21,Genk,Oostende,3,1,2,W
136647,19,BEL1,2019-09-22,Standard,Eupen,3,0,3,W
136648,19,BEL1,2019-09-22,Club Brugge,Anderlecht,2,1,1,W
136649,19,BEL1,2019-09-22,Waregem,Gent,2,2,0,D
136650,19,BEL1,2019-09-28,Mechelen,Club Brugge,0,5,-5,L
136651,19,BEL1,2019-09-28,Gent,Kortrijk,2,0,2,W
136652,19,BEL1,2019-09-28,Mouscron,Waregem,2,2,0,D
136653,19,BEL1,2019-09-28,Cercle Brugge,Eupen,1,2,-1,L
136654,19,BEL1,2019-09-28,St Truiden,Genk,3,3,0,D
136655,19,BEL1,2019-09-29,Anderlecht,Waasland-Beveren,0,0,0,D
136656,19,BEL1,2019-09-29,Standard,Charleroi,1,1,0,D
136657,19,BEL1,2019-09-29,Oostende,Antwerp,1,1,0,D
136658,19,BEL1,2019-10-04,Charleroi,Anderlecht,1,2,-1,L
136659,19,BEL1,2019-10-05,Eupen,Mechelen,0,2,-2,L
136660,19,BEL1,2019-10-05,Waregem,Cercle Brugge,6,0,6,W
136661,19,BEL1,2019-10-05,Waasland-Beveren,Oostende,3,1,2,W
136662,19,BEL1,2019-10-05,Kortrijk,St Truiden,4,0,4,W
136663,19,BEL1,2019-10-06,Club Brugge,Gent,4,0,4,W
136664,19,BEL1,2019-10-06,Antwerp,Standard,2,2,0,D
136665,19,BEL1,2019-10-06,Genk,Mouscron,2,1,1,W
136666,19,BEL1,2019-10-18,Mouscron,Club Brugge,0,1,-1,L
136667,19,BEL1,2019-10-19,Standard,Genk,1,0,1,W
136668,19,BEL1,2019-10-19,Kortrijk,Waregem,2,0,2,W
136669,19,BEL1,2019-10-19,Oostende,Eupen,2,3,-1,L
136670,19,BEL1,2019-10-19,Gent,Waasland-Beveren,2,0,2,W
136671,19,BEL1,2019-10-20,Mechelen,Antwerp,3,1,2,W
136672,19,BEL1,2019-10-20,Anderlecht,St Truiden,4,1,3,W
136673,19,BEL1,2019-10-20,Cercle Brugge,Charleroi,0,3,-3,L
136674,19,BEL1,2019-10-25,Eupen,Anderlecht,0,0,0,D
136675,19,BEL1,2019-10-26,Charleroi,Mouscron,1,0,1,W
136676,19,BEL1,2019-10-26,Waregem,Oostende,2,0,2,W
136677,19,BEL1,2019-10-26,Antwerp,Kortrijk,3,1,2,W
136678,19,BEL1,2019-10-26,Genk,Cercle Brugge,1,0,1,W
136679,19,BEL1,2019-10-27,Club Brugge,Standard,1,1,0,D
136680,19,BEL1,2019-10-27,St Truiden,Gent,0,0,0,D
136681,19,BEL1,2019-10-27,Waasland-Beveren,Mechelen,1,3,-2,L
136682,19,BEL1,2019-10-29,Kortrijk,Eupen,1,2,-1,L
136683,19,BEL1,2019-10-29,Oostende,Charleroi,0,1,-1,L
136684,19,BEL1,2019-10-29,Cercle Brugge,Mouscron,2,2,0,D
136685,19,BEL1,2019-10-30,Standard,Waasland-Beveren,2,0,2,W
136686,19,BEL1,2019-10-30,Genk,Antwerp,2,2,0,D
136687,19,BEL1,2019-10-30,Waregem,Club Brugge,0,2,-2,L
136688,19,BEL1,2019-10-30,Mechelen,St Truiden,1,2,-1,L
136689,19,BEL1,2019-10-31,Anderlecht,Gent,3,3,0,D
136690,19,BEL1,2019-11-02,Eupen,Genk,2,0,2,W
136691,19,BEL1,2019-11-02,Mouscron,Antwerp,3,1,2,W
136692,19,BEL1,2019-11-02,Waasland-Beveren,Waregem,1,2,-1,L
136693,19,BEL1,2019-11-02,St Truiden,Oostende,1,0,1,W
136694,19,BEL1,2019-11-02,Club Brugge,Kortrijk,3,0,3,W
136695,19,BEL1,2019-11-03,Anderlecht,Cercle Brugge,2,1,1,W
136696,19,BEL1,2019-11-03,Gent,Standard,3,1,2,W
136697,19,BEL1,2019-11-03,Mechelen,Charleroi,2,2,0,D
136698,19,BEL1,2019-11-08,Waregem,Anderlecht,1,2,-1,L
136699,19,BEL1,2019-11-09,Charleroi,Eupen,1,0,1,W
136700,19,BEL1,2019-11-09,Kortrijk,Waasland-Beveren,1,3,-2,L
136701,19,BEL1,2019-11-09,Cercle Brugge,St Truiden,2,1,1,W
136702,19,BEL1,2019-11-09,Oostende,Mouscron,2,2,0,D
136703,19,BEL1,2019-11-10,Antwerp,Club Brugge,2,1,1,W
136704,19,BEL1,2019-11-10,Genk,Gent,0,2,-2,L
136705,19,BEL1,2019-11-10,Standard,Mechelen,1,2,-1,L
136706,19,BEL1,2019-11-21,Antwerp,Gent,3,2,1,W
136707,19,BEL1,2019-11-22,Club Brugge,Oostende,2,0,2,W
136708,19,BEL1,2019-11-23,Eupen,Standard,1,2,-1,L
136709,19,BEL1,2019-11-23,Mechelen,Waregem,0,2,-2,L
136710,19,BEL1,2019-11-23,Waasland-Beveren,Cercle Brugge,1,1,0,D
136711,19,BEL1,2019-11-23,Mouscron,Genk,2,2,0,D
136712,19,BEL1,2019-11-24,Gent,Antwerp,1,1,0,D
136713,19,BEL1,2019-11-24,Anderlecht,Kortrijk,0,0,0,D
136714,19,BEL1,2019-11-24,St Truiden,Charleroi,1,3,-2,L
136715,19,BEL1,2019-11-29,Antwerp,Mechelen,1,0,1,W
136716,19,BEL1,2019-11-30,Club Brugge,Mouscron,1,0,1,W
136717,19,BEL1,2019-11-30,Waregem,Eupen,1,0,1,W
136718,19,BEL1,2019-11-30,Charleroi,Waasland-Beveren,2,0,2,W
136719,19,BEL1,2019-11-30,Genk,St Truiden,1,2,-1,L
136720,19,BEL1,2019-12-01,Oostende,Anderlecht,3,2,1,W
136721,19,BEL1,2019-12-01,Standard,Cercle Brugge,2,1,1,W
136722,19,BEL1,2019-12-01,Kortrijk,Gent,0,2,-2,L
136723,19,BEL1,2019-12-06,Waasland-Beveren,Antwerp,0,4,-4,L
136724,19,BEL1,2019-12-07,Mechelen,Kortrijk,1,1,0,D
136725,19,BEL1,2019-12-07,Gent,Waregem,2,0,2,W
136726,19,BEL1,2019-12-07,Cercle Brugge,Genk,1,2,-1,L
136727,19,BEL1,2019-12-07,St Truiden,Club Brugge,1,2,-1,L
136728,19,BEL1,2019-12-08,Mouscron,Standard,2,2,0,D
136729,19,BEL1,2019-12-08,Anderlecht,Charleroi,0,0,0,D
136730,19,BEL1,2019-12-08,Eupen,Oostende,1,0,1,W
136731,19,BEL1,2019-12-13,Kortrijk,Mouscron,1,2,-1,L
136732,19,BEL1,2019-12-14,Antwerp,Eupen,1,0,1,W
136733,19,BEL1,2019-12-14,Waregem,St Truiden,5,1,4,W
136734,19,BEL1,2019-12-14,Charleroi,Cercle Brugge,3,0,3,W
136735,19,BEL1,2019-12-14,Genk,Waasland-Beveren,4,1,3,W
136736,19,BEL1,2019-12-15,Standard,Anderlecht,1,1,0,D
136737,19,BEL1,2019-12-15,Club Brugge,Mechelen,3,0,3,W
136738,19,BEL1,2019-12-15,Oostende,Gent,2,1,1,W
136739,19,BEL1,2019-12-20,Mechelen,Oostende,1,0,1,W
136740,19,BEL1,2019-12-21,Mouscron,Charleroi,1,1,0,D
136741,19,BEL1,2019-12-21,Eupen,Kortrijk,1,2,-1,L
136742,19,BEL1,2019-12-21,Cercle Brugge,Waregem,2,0,2,W
136743,19,BEL1,2019-12-21,Waasland-Beveren,Standard,2,1,1,W
136744,19,BEL1,2019-12-22,Gent,Club Brugge,1,1,0,D
136745,19,BEL1,2019-12-22,St Truiden,Antwerp,1,1,0,D
136746,19,BEL1,2019-12-22,Anderlecht,Genk,2,0,2,W
136747,19,BEL1,2019-12-26,Genk,Eupen,2,1,1,W
136748,19,BEL1,2019-12-26,Kortrijk,Cercle Brugge,1,0,1,W
136749,19,BEL1,2019-12-26,Mouscron,Mechelen,1,2,-1,L
136750,19,BEL1,2019-12-26,Waasland-Beveren,St Truiden,1,0,1,W
136751,19,BEL1,2019-12-26,Club Brugge,Waregem,4,0,4,W
136752,19,BEL1,2019-12-26,Standard,Gent,0,1,-1,L
136753,19,BEL1,2019-12-27,Charleroi,Oostende,5,0,5,W
136754,19,BEL1,2019-12-27,Antwerp,Anderlecht,0,0,0,D
136755,19,BEL1,2020-01-17,Mechelen,Standard,2,3,-1,L
136756,19,BEL1,2020-01-18,Eupen,Charleroi,1,1,0,D
136757,19,BEL1,2020-01-18,Oostende,Waasland-Beveren,0,1,-1,L
136758,19,BEL1,2020-01-18,St Truiden,Kortrijk,2,0,2,W
136759,19,BEL1,2020-01-18,Gent,Mouscron,3,1,2,W
136760,19,BEL1,2020-01-19,Cercle Brugge,Antwerp,1,2,-1,L
136761,19,BEL1,2020-01-19,Anderlecht,Club Brugge,1,2,-1,L
136762,19,BEL1,2020-01-19,Waregem,Genk,0,3,-3,L
136763,19,BEL1,2020-01-24,Standard,Oostende,2,1,1,W
136764,19,BEL1,2020-01-25,Mouscron,St Truiden,1,3,-2,L
136765,19,BEL1,2020-01-25,Waasland-Beveren,Eupen,0,1,-1,L
136766,19,BEL1,2020-01-25,Gent,Genk,4,1,3,W
136767,19,BEL1,2020-01-26,Cercle Brugge,Anderlecht,1,2,-1,L
136768,19,BEL1,2020-01-26,Kortrijk,Club Brugge,2,2,0,D
136769,19,BEL1,2020-01-26,Antwerp,Waregem,2,1,1,W
136770,19,BEL1,2020-01-29,Charleroi,Club Brugge,0,0,0,D
136771,19,BEL1,2020-01-31,Kortrijk,Standard,3,1,2,W
136772,19,BEL1,2020-02-01,Genk,Charleroi,1,0,1,W
136773,19,BEL1,2020-02-01,Eupen,Cercle Brugge,1,0,1,W
136774,19,BEL1,2020-02-01,Oostende,St Truiden,1,0,1,W
136775,19,BEL1,2020-02-01,Mechelen,Gent,0,3,-3,L
136776,19,BEL1,2020-02-02,Club Brugge,Antwerp,1,0,1,W
136777,19,BEL1,2020-02-02,Anderlecht,Mouscron,1,0,1,W
136778,19,BEL1,2020-02-02,Waregem,Waasland-Beveren,5,0,5,W
136779,19,BEL1,2020-02-07,Gent,Anderlecht,1,1,0,D
136780,19,BEL1,2020-02-08,Charleroi,Waregem,4,0,4,W
136781,19,BEL1,2020-02-08,Cercle Brugge,Mechelen,3,2,1,W
136782,19,BEL1,2020-02-08,St Truiden,Eupen,5,2,3,W
136783,19,BEL1,2020-02-08,Mouscron,Oostende,3,1,2,W
136784,19,BEL1,2020-02-11,Charleroi,Mechelen,2,1,1,W
136785,19,BEL1,2020-02-12,Standard,Club Brugge,0,0,0,D
136786,19,BEL1,2020-02-12,Waasland-Beveren,Kortrijk,1,2,-1,L
136787,19,BEL1,2020-02-13,Antwerp,Genk,1,1,0,D
136788,19,BEL1,2020-02-14,Eupen,Gent,2,3,-1,L
136789,19,BEL1,2020-02-15,Club Brugge,Waasland-Beveren,2,1,1,W
136790,19,BEL1,2020-02-15,Oostende,Kortrijk,0,3,-3,L
136791,19,BEL1,2020-02-15,St Truiden,Cercle Brugge,0,1,-1,L
136792,19,BEL1,2020-02-15,Mechelen,Anderlecht,2,0,2,W
136793,19,BEL1,2020-02-16,Antwerp,Charleroi,1,1,0,D
136794,19,BEL1,2020-02-16,Genk,Standard,1,3,-2,L
136795,19,BEL1,2020-02-16,Waregem,Mouscron,1,2,-1,L
136796,19,BEL1,2020-02-21,Kortrijk,Genk,0,1,-1,L
136797,19,BEL1,2020-02-22,Standard,Antwerp,1,0,1,W
136798,19,BEL1,2020-02-22,Mouscron,Cercle Brugge,0,1,-1,L
136799,19,BEL1,2020-02-22,Oostende,Waregem,1,1,0,D
136800,19,BEL1,2020-02-22,Mechelen,Waasland-Beveren,4,0,4,W
136801,19,BEL1,2020-02-23,Club Brugge,Charleroi,1,0,1,W
136802,19,BEL1,2020-02-23,Anderlecht,Eupen,6,1,5,W
136803,19,BEL1,2020-02-23,Gent,St Truiden,4,1,3,W
136804,19,BEL1,2020-02-28,St Truiden,Mechelen,0,3,-3,L
136805,19,BEL1,2020-02-29,Waasland-Beveren,Anderlecht,0,3,-3,L
136806,19,BEL1,2020-02-29,Eupen,Mouscron,2,1,1,W
136807,19,BEL1,2020-02-29,Waregem,Kortrijk,2,2,0,D
136808,19,BEL1,2020-02-29,Antwerp,Oostende,3,1,2,W
136809,19,BEL1,2020-03-01,Genk,Club Brugge,1,2,-1,L
136810,19,BEL1,2020-03-01,Charleroi,Standard,2,0,2,W
136811,19,BEL1,2020-03-01,Cercle Brugge,Gent,1,0,1,W
136812,19,BEL1,2020-03-07,Club Brugge,Cercle Brugge,2,1,1,W
136813,19,BEL1,2020-03-07,Anderlecht,Waregem,7,0,7,W
136814,19,BEL1,2020-03-07,Standard,St Truiden,0,0,0,D
136815,19,BEL1,2020-03-07,Gent,Charleroi,1,4,-3,L
136816,19,BEL1,2020-03-07,Kortrijk,Antwerp,0,1,-1,L
136817,19,BEL1,2020-03-07,Mouscron,Waasland-Beveren,1,0,1,W
136818,19,BEL1,2020-03-07,Oostende,Genk,2,4,-2,L
136819,19,BEL1,2020-03-07,Mechelen,Eupen,1,1,0,D
136820,20,BEL1,2020-08-08,Club Brugge,Charleroi,0,1,-1,L
136821,20,BEL1,2020-08-08,Antwerp,Mouscron,1,1,0,D
136822,20,BEL1,2020-08-08,Standard,Cercle Brugge,1,0,1,W
136823,20,BEL1,2020-08-09,St Truiden,Gent,2,1,1,W
136824,20,BEL1,2020-08-09,Waregem,Genk,1,2,-1,L
136825,20,BEL1,2020-08-09,Mechelen,Anderlecht,2,2,0,D
136826,20,BEL1,2020-08-09,Kortrijk,Waasland-Beveren,1,3,-2,L
136827,20,BEL1,2020-08-10,Oostende,K Beerschot VA,1,2,-1,L
136828,20,BEL1,2020-08-10,Oud-Heverlee Leuven,Eupen,1,1,0,D
136829,20,BEL1,2020-08-14,Mouscron,Mechelen,0,1,-1,L
136830,20,BEL1,2020-08-15,Genk,Oud-Heverlee Leuven,1,1,0,D
136831,20,BEL1,2020-08-15,Gent,Kortrijk,1,2,-1,L
136832,20,BEL1,2020-08-15,Charleroi,Oostende,1,0,1,W
136833,20,BEL1,2020-08-16,Cercle Brugge,Antwerp,2,1,1,W
136834,20,BEL1,2020-08-16,K Beerschot VA,Waregem,3,1,2,W
136835,20,BEL1,2020-08-16,Eupen,Club Brugge,0,4,-4,L
136836,20,BEL1,2020-08-16,Anderlecht,St Truiden,3,1,2,W
136837,20,BEL1,2020-08-17,Waasland-Beveren,Standard,1,2,-1,L
136838,20,BEL1,2020-08-21,Kortrijk,Eupen,0,0,0,D
136839,20,BEL1,2020-08-22,Waregem,Waasland-Beveren,4,1,3,W
136840,20,BEL1,2020-08-22,Mechelen,Cercle Brugge,2,3,-1,L
136841,20,BEL1,2020-08-22,Oud-Heverlee Leuven,Charleroi,1,3,-2,L
136842,20,BEL1,2020-08-22,Antwerp,Gent,1,0,1,W
136843,20,BEL1,2020-08-23,Standard,Genk,0,0,0,D
136844,20,BEL1,2020-08-23,Club Brugge,K Beerschot VA,0,1,-1,L
136845,20,BEL1,2020-08-23,Anderlecht,Mouscron,1,1,0,D
136846,20,BEL1,2020-08-24,St Truiden,Oostende,0,0,0,D
136847,20,BEL1,2020-08-28,Oostende,Anderlecht,2,2,0,D
136848,20,BEL1,2020-08-29,Eupen,St Truiden,1,1,0,D
136849,20,BEL1,2020-08-29,Cercle Brugge,Kortrijk,0,1,-1,L
136850,20,BEL1,2020-08-29,Waasland-Beveren,Oud-Heverlee Leuven,1,3,-2,L
136851,20,BEL1,2020-08-29,Mouscron,Waregem,0,1,-1,L
136852,20,BEL1,2020-08-30,Genk,Club Brugge,1,2,-1,L
136853,20,BEL1,2020-08-30,K Beerschot VA,Standard,0,3,-3,L
136854,20,BEL1,2020-08-30,Charleroi,Antwerp,2,0,2,W
136855,20,BEL1,2020-08-30,Gent,Mechelen,1,0,1,W
136856,20,BEL1,2020-09-11,Eupen,Gent,2,1,1,W
136857,20,BEL1,2020-09-12,Mechelen,Oostende,0,1,-1,L
136858,20,BEL1,2020-09-12,Oud-Heverlee Leuven,Standard,1,0,1,W
136859,20,BEL1,2020-09-12,Club Brugge,Waasland-Beveren,4,1,3,W
136860,20,BEL1,2020-09-13,Anderlecht,Cercle Brugge,2,0,2,W
136861,20,BEL1,2020-09-13,St Truiden,Antwerp,2,3,-1,L
136862,20,BEL1,2020-09-13,Waregem,Charleroi,0,2,-2,L
136863,20,BEL1,2020-09-13,Kortrijk,Mouscron,3,0,3,W
136864,20,BEL1,2020-09-14,K Beerschot VA,Genk,5,2,3,W
136865,20,BEL1,2020-09-18,Charleroi,K Beerschot VA,3,1,2,W
136866,20,BEL1,2020-09-19,Oostende,Oud-Heverlee Leuven,3,1,2,W
136867,20,BEL1,2020-09-19,Mouscron,Gent,0,1,-1,L
136868,20,BEL1,2020-09-19,Waasland-Beveren,Anderlecht,2,4,-2,L
136869,20,BEL1,2020-09-20,Waregem,Club Brugge,0,6,-6,L
136870,20,BEL1,2020-09-20,Standard,Kortrijk,2,1,1,W
136871,20,BEL1,2020-09-20,Genk,Mechelen,3,1,2,W
136872,20,BEL1,2020-09-20,Antwerp,Eupen,2,2,0,D
136873,20,BEL1,2020-09-21,Cercle Brugge,St Truiden,3,0,3,W
136874,20,BEL1,2020-09-25,Kortrijk,Antwerp,1,3,-2,L
136875,20,BEL1,2020-09-26,K Beerschot VA,Waasland-Beveren,3,2,1,W
136876,20,BEL1,2020-09-26,Mechelen,St Truiden,2,0,2,W
136877,20,BEL1,2020-09-26,Gent,Oud-Heverlee Leuven,2,3,-1,L
136878,20,BEL1,2020-09-27,Standard,Waregem,2,2,0,D
136879,20,BEL1,2020-09-27,Anderlecht,Eupen,1,1,0,D
136880,20,BEL1,2020-09-27,Club Brugge,Cercle Brugge,2,1,1,W
136881,20,BEL1,2020-09-27,Mouscron,Charleroi,1,1,0,D
136882,20,BEL1,2020-09-28,Genk,Oostende,2,2,0,D
136883,20,BEL1,2020-10-02,Antwerp,Mechelen,4,1,3,W
136884,20,BEL1,2020-10-03,Waasland-Beveren,Genk,1,1,0,D
136885,20,BEL1,2020-10-03,Eupen,Cercle Brugge,1,2,-1,L
136886,20,BEL1,2020-10-03,Oud-Heverlee Leuven,Waregem,2,1,1,W
136887,20,BEL1,2020-10-03,St Truiden,Kortrijk,0,0,0,D
136888,20,BEL1,2020-10-04,Club Brugge,Anderlecht,3,0,3,W
136889,20,BEL1,2020-10-04,Gent,K Beerschot VA,5,1,4,W
136890,20,BEL1,2020-10-04,Charleroi,Standard,1,2,-1,L
136891,20,BEL1,2020-10-04,Oostende,Mouscron,3,0,3,W
136892,20,BEL1,2020-10-17,Cercle Brugge,Gent,5,2,3,W
136893,20,BEL1,2020-10-17,K Beerschot VA,St Truiden,6,3,3,W
136894,20,BEL1,2020-10-17,Mechelen,Kortrijk,1,2,-1,L
136895,20,BEL1,2020-10-17,Standard,Club Brugge,1,1,0,D
136896,20,BEL1,2020-10-18,Waregem,Antwerp,1,3,-2,L
136897,20,BEL1,2020-10-18,Mouscron,Eupen,0,2,-2,L
136898,20,BEL1,2020-10-18,Genk,Charleroi,2,1,1,W
136899,20,BEL1,2020-10-18,Anderlecht,Oud-Heverlee Leuven,2,2,0,D
136900,20,BEL1,2020-10-23,Kortrijk,Anderlecht,1,3,-2,L
136901,20,BEL1,2020-10-24,Oud-Heverlee Leuven,Club Brugge,2,1,1,W
136902,20,BEL1,2020-10-25,Antwerp,K Beerschot VA,3,2,1,W
136903,20,BEL1,2020-10-25,Oostende,Waregem,3,0,3,W
136904,20,BEL1,2020-10-25,St Truiden,Standard,2,0,2,W
136905,20,BEL1,2020-10-26,Gent,Genk,1,2,-1,L
136906,20,BEL1,2020-10-30,Genk,Eupen,4,0,4,W
136907,20,BEL1,2020-10-31,K Beerschot VA,Oud-Heverlee Leuven,4,2,2,W
136908,20,BEL1,2020-10-31,Charleroi,Cercle Brugge,3,0,3,W
136909,20,BEL1,2020-10-31,Club Brugge,Mechelen,2,2,0,D
136910,20,BEL1,2020-11-01,Anderlecht,Antwerp,1,0,1,W
136911,20,BEL1,2020-11-01,Standard,Oostende,1,0,1,W
136912,20,BEL1,2020-11-01,Waasland-Beveren,Gent,1,4,-3,L
136913,20,BEL1,2020-11-02,Waregem,Kortrijk,1,1,0,D
136914,20,BEL1,2020-11-06,Mechelen,Charleroi,3,3,0,D
136915,20,BEL1,2020-11-07,Kortrijk,K Beerschot VA,5,5,0,D
136916,20,BEL1,2020-11-07,Eupen,Waasland-Beveren,1,1,0,D
136917,20,BEL1,2020-11-07,St Truiden,Genk,1,2,-1,L
136918,20,BEL1,2020-11-08,Antwerp,Standard,1,1,0,D
136919,20,BEL1,2020-11-08,Oostende,Club Brugge,1,3,-2,L
136920,20,BEL1,2020-11-08,Gent,Anderlecht,1,1,0,D
136921,20,BEL1,2020-11-08,Cercle Brugge,Waregem,1,3,-2,L
136922,20,BEL1,2020-11-21,Standard,Eupen,2,2,0,D
136923,20,BEL1,2020-11-21,Oostende,Antwerp,1,1,0,D
136924,20,BEL1,2020-11-21,Waasland-Beveren,Cercle Brugge,0,2,-2,L
136925,20,BEL1,2020-11-21,Club Brugge,Kortrijk,1,0,1,W
136926,20,BEL1,2020-11-22,K Beerschot VA,Anderlecht,2,1,1,W
136927,20,BEL1,2020-11-22,Waregem,Mechelen,1,2,-1,L
136928,20,BEL1,2020-11-22,Charleroi,Gent,0,1,-1,L
136929,20,BEL1,2020-11-22,Genk,Mouscron,4,1,3,W
136930,20,BEL1,2020-11-23,Oud-Heverlee Leuven,St Truiden,2,2,0,D
136931,20,BEL1,2020-11-24,Waasland-Beveren,Oostende,2,0,2,W
136932,20,BEL1,2020-11-25,Cercle Brugge,Mouscron,1,2,-1,L
136933,20,BEL1,2020-11-27,Eupen,Charleroi,3,1,2,W
136934,20,BEL1,2020-11-28,St Truiden,Waasland-Beveren,1,1,0,D
136935,20,BEL1,2020-11-28,Cercle Brugge,Genk,1,5,-4,L
136936,20,BEL1,2020-11-28,Mouscron,Club Brugge,0,0,0,D
136937,20,BEL1,2020-11-29,Mechelen,K Beerschot VA,2,3,-1,L
136938,20,BEL1,2020-11-29,Gent,Waregem,0,3,-3,L
136939,20,BEL1,2020-11-29,Anderlecht,Standard,0,0,0,D
136940,20,BEL1,2020-11-29,Kortrijk,Oostende,3,1,2,W
136941,20,BEL1,2020-11-30,Antwerp,Oud-Heverlee Leuven,3,2,1,W
136942,20,BEL1,2020-12-01,Mouscron,St Truiden,3,2,1,W
136943,20,BEL1,2020-12-02,Charleroi,Waasland-Beveren,0,2,-2,L
136944,20,BEL1,2020-12-03,Eupen,Mechelen,1,1,0,D
136945,20,BEL1,2020-12-04,Waregem,Anderlecht,2,2,0,D
136946,20,BEL1,2020-12-05,Waasland-Beveren,Mouscron,2,0,2,W
136947,20,BEL1,2020-12-05,Oud-Heverlee Leuven,Cercle Brugge,2,1,1,W
136948,20,BEL1,2020-12-05,Club Brugge,St Truiden,1,0,1,W
136949,20,BEL1,2020-12-06,Genk,Antwerp,4,2,2,W
136950,20,BEL1,2020-12-06,K Beerschot VA,Eupen,0,1,-1,L
136951,20,BEL1,2020-12-06,Standard,Mechelen,2,2,0,D
136952,20,BEL1,2020-12-06,Oostende,Gent,2,1,1,W
136953,20,BEL1,2020-12-07,Charleroi,Kortrijk,0,0,0,D
136954,20,BEL1,2020-12-08,Oud-Heverlee Leuven,Mouscron,2,0,2,W
136955,20,BEL1,2020-12-11,Anderlecht,Genk,1,0,1,W
136956,20,BEL1,2020-12-12,Mouscron,K Beerschot VA,3,1,2,W
136957,20,BEL1,2020-12-12,Cercle Brugge,Oostende,0,1,-1,L
136958,20,BEL1,2020-12-12,Kortrijk,Oud-Heverlee Leuven,0,3,-3,L
136959,20,BEL1,2020-12-12,St Truiden,Charleroi,1,2,-1,L
136960,20,BEL1,2020-12-13,Antwerp,Club Brugge,0,2,-2,L
136961,20,BEL1,2020-12-13,Gent,Standard,2,1,1,W
136962,20,BEL1,2020-12-13,Mechelen,Waasland-Beveren,2,3,-1,L
136963,20,BEL1,2020-12-15,Cercle Brugge,Charleroi,3,4,-1,L
136964,20,BEL1,2020-12-15,Mouscron,Oud-Heverlee Leuven,2,2,0,D
136965,20,BEL1,2020-12-15,Anderlecht,Oostende,2,1,1,W
136966,20,BEL1,2020-12-16,Antwerp,Waregem,0,1,-1,L
136967,20,BEL1,2020-12-16,Gent,Waasland-Beveren,3,0,3,W
136968,20,BEL1,2020-12-16,Kortrijk,Standard,2,1,1,W
136969,20,BEL1,2020-12-17,Mechelen,Club Brugge,0,3,-3,L
136970,20,BEL1,2020-12-18,Charleroi,Anderlecht,1,0,1,W
136971,20,BEL1,2020-12-19,Waregem,St Truiden,0,2,-2,L
136972,20,BEL1,2020-12-19,Genk,Kortrijk,2,0,2,W
136973,20,BEL1,2020-12-20,Club Brugge,Gent,0,1,-1,L
136974,20,BEL1,2020-12-20,Oud-Heverlee Leuven,Mechelen,1,2,-1,L
136975,20,BEL1,2020-12-20,Standard,Mouscron,0,1,-1,L
136976,20,BEL1,2020-12-20,Waasland-Beveren,Antwerp,0,3,-3,L
136977,20,BEL1,2020-12-26,Club Brugge,Eupen,3,0,3,W
136978,20,BEL1,2020-12-26,Waregem,Cercle Brugge,1,0,1,W
136979,20,BEL1,2020-12-26,Oud-Heverlee Leuven,Oostende,1,2,-1,L
136980,20,BEL1,2020-12-26,Kortrijk,Gent,1,0,1,W
136981,20,BEL1,2020-12-26,Standard,St Truiden,1,2,-1,L
136982,20,BEL1,2020-12-27,Antwerp,Charleroi,2,1,1,W
136983,20,BEL1,2020-12-27,Genk,Waasland-Beveren,1,1,0,D
136984,20,BEL1,2020-12-27,Anderlecht,K Beerschot VA,2,0,2,W
136985,20,BEL1,2020-12-27,Mechelen,Mouscron,2,1,1,W
136986,20,BEL1,2020-12-29,Eupen,Waregem,2,3,-1,L
136987,20,BEL1,2020-12-30,St Truiden,K Beerschot VA,1,0,1,W
136988,20,BEL1,2021-01-06,Eupen,Genk,1,4,-3,L
136989,20,BEL1,2021-01-09,Waregem,Mouscron,1,0,1,W
136990,20,BEL1,2021-01-09,Cercle Brugge,Eupen,1,2,-1,L
136991,20,BEL1,2021-01-09,Kortrijk,Genk,2,1,1,W
136992,20,BEL1,2021-01-09,Oostende,Charleroi,3,2,1,W
136993,20,BEL1,2021-01-10,Mechelen,Antwerp,3,0,3,W
136994,20,BEL1,2021-01-10,K Beerschot VA,Gent,1,1,0,D
136995,20,BEL1,2021-01-10,Oud-Heverlee Leuven,Anderlecht,1,0,1,W
136996,20,BEL1,2021-01-10,St Truiden,Club Brugge,1,2,-1,L
136997,20,BEL1,2021-01-11,Standard,Waasland-Beveren,3,1,2,W
136998,20,BEL1,2021-01-12,Oostende,Eupen,1,1,0,D
136999,20,BEL1,2021-01-13,K Beerschot VA,Cercle Brugge,1,1,0,D
137000,20,BEL1,2021-01-15,Eupen,Anderlecht,2,0,2,W
137001,20,BEL1,2021-01-16,Oostende,Kortrijk,2,1,1,W
137002,20,BEL1,2021-01-16,Mouscron,Genk,2,0,2,W
137003,20,BEL1,2021-01-16,Waasland-Beveren,Waregem,1,5,-4,L
137004,20,BEL1,2021-01-16,Charleroi,Mechelen,0,1,-1,L
137005,20,BEL1,2021-01-17,Gent,Antwerp,0,1,-1,L
137006,20,BEL1,2021-01-17,Cercle Brugge,Standard,0,1,-1,L
137007,20,BEL1,2021-01-17,K Beerschot VA,Club Brugge,0,3,-3,L
137008,20,BEL1,2021-01-17,St Truiden,Oud-Heverlee Leuven,3,1,2,W
137009,20,BEL1,2021-01-19,Mouscron,Waasland-Beveren,1,1,0,D
137010,20,BEL1,2021-01-19,Anderlecht,Charleroi,3,0,3,W
137011,20,BEL1,2021-01-20,Kortrijk,St Truiden,0,2,-2,L
137012,20,BEL1,2021-01-20,Eupen,K Beerschot VA,3,1,2,W
137013,20,BEL1,2021-01-20,Mechelen,Standard,0,4,-4,L
137014,20,BEL1,2021-01-20,Antwerp,Cercle Brugge,1,0,1,W
137015,20,BEL1,2021-01-20,Club Brugge,Oostende,2,1,1,W
137016,20,BEL1,2021-01-21,Waregem,Oud-Heverlee Leuven,2,3,-1,L
137017,20,BEL1,2021-01-21,Genk,Gent,1,1,0,D
137018,20,BEL1,2021-01-22,Anderlecht,Waasland-Beveren,0,0,0,D
137019,20,BEL1,2021-01-23,Mechelen,Eupen,3,0,3,W
137020,20,BEL1,2021-01-23,Kortrijk,Cercle Brugge,1,2,-1,L
137021,20,BEL1,2021-01-23,St Truiden,Mouscron,0,2,-2,L
137022,20,BEL1,2021-01-23,Antwerp,Oostende,1,2,-1,L
137023,20,BEL1,2021-01-24,Club Brugge,Genk,3,2,1,W
137024,20,BEL1,2021-01-24,Waregem,K Beerschot VA,0,3,-3,L
137025,20,BEL1,2021-01-24,Standard,Charleroi,3,2,1,W
137026,20,BEL1,2021-01-24,Oud-Heverlee Leuven,Gent,0,3,-3,L
137027,20,BEL1,2021-01-26,Eupen,Antwerp,0,2,-2,L
137028,20,BEL1,2021-01-26,Waasland-Beveren,Mechelen,2,3,-1,L
137029,20,BEL1,2021-01-26,Mouscron,Anderlecht,1,1,0,D
137030,20,BEL1,2021-01-27,K Beerschot VA,Kortrijk,0,0,0,D
137031,20,BEL1,2021-01-27,Genk,Waregem,3,2,1,W
137032,20,BEL1,2021-01-27,Gent,St Truiden,1,1,0,D
137033,20,BEL1,2021-01-27,Charleroi,Oud-Heverlee Leuven,1,1,0,D
137034,20,BEL1,2021-01-28,Cercle Brugge,Club Brugge,1,2,-1,L
137035,20,BEL1,2021-01-28,Oostende,Standard,2,2,0,D
137036,20,BEL1,2021-01-29,Antwerp,Waasland-Beveren,3,2,1,W
137037,20,BEL1,2021-01-30,Mechelen,Genk,0,0,0,D
137038,20,BEL1,2021-01-30,Eupen,Mouscron,1,1,0,D
137039,20,BEL1,2021-01-30,Oud-Heverlee Leuven,K Beerschot VA,0,1,-1,L
137040,20,BEL1,2021-01-30,Kortrijk,Charleroi,1,3,-2,L
137041,20,BEL1,2021-01-31,Club Brugge,Standard,3,1,2,W
137042,20,BEL1,2021-01-31,Waregem,Oostende,2,1,1,W
137043,20,BEL1,2021-01-31,Anderlecht,Gent,0,0,0,D
137044,20,BEL1,2021-01-31,St Truiden,Cercle Brugge,3,0,3,W
137045,20,BEL1,2021-02-05,Mouscron,Kortrijk,0,3,-3,L
137046,20,BEL1,2021-02-06,Oostende,St Truiden,3,1,2,W
137047,20,BEL1,2021-02-06,Cercle Brugge,Mechelen,0,1,-1,L
137048,20,BEL1,2021-02-06,Waasland-Beveren,Club Brugge,0,2,-2,L
137049,20,BEL1,2021-02-06,Standard,Oud-Heverlee Leuven,1,1,0,D
137050,20,BEL1,2021-02-07,K Beerschot VA,Antwerp,1,2,-1,L
137051,20,BEL1,2021-02-07,Charleroi,Waregem,1,1,0,D
137052,20,BEL1,2021-02-07,Genk,Anderlecht,1,2,-1,L
137053,20,BEL1,2021-02-07,Gent,Eupen,2,2,0,D
137054,20,BEL1,2021-02-12,Oud-Heverlee Leuven,Kortrijk,3,1,2,W
137055,20,BEL1,2021-02-13,St Truiden,Waregem,1,2,-1,L
137056,20,BEL1,2021-02-14,Standard,Antwerp,1,1,0,D
137057,20,BEL1,2021-02-14,K Beerschot VA,Mechelen,1,2,-1,L
137058,20,BEL1,2021-02-14,Cercle Brugge,Anderlecht,0,0,0,D
137059,20,BEL1,2021-02-15,Gent,Mouscron,4,0,4,W
137060,20,BEL1,2021-02-17,Waasland-Beveren,Eupen,1,0,1,W
137061,20,BEL1,2021-02-17,Oostende,Genk,3,1,2,W
137062,20,BEL1,2021-02-19,Mechelen,Gent,1,1,0,D
137063,20,BEL1,2021-02-20,Eupen,Oostende,1,1,0,D
137064,20,BEL1,2021-02-20,Mouscron,Cercle Brugge,1,2,-1,L
137065,20,BEL1,2021-02-20,Waasland-Beveren,Charleroi,1,1,0,D
137066,20,BEL1,2021-02-21,Anderlecht,Kortrijk,0,2,-2,L
137067,20,BEL1,2021-02-21,Waregem,Standard,3,2,1,W
137068,20,BEL1,2021-02-21,Genk,K Beerschot VA,1,2,-1,L
137069,20,BEL1,2021-02-21,Antwerp,St Truiden,0,0,0,D
137070,20,BEL1,2021-02-22,Club Brugge,Oud-Heverlee Leuven,3,0,3,W
137071,20,BEL1,2021-02-26,Charleroi,Genk,1,2,-1,L
137072,20,BEL1,2021-02-27,Cercle Brugge,Waasland-Beveren,2,0,2,W
137073,20,BEL1,2021-02-27,Oostende,Mechelen,2,0,2,W
137074,20,BEL1,2021-02-27,Kortrijk,Waregem,1,2,-1,L
137075,20,BEL1,2021-02-28,Standard,Anderlecht,1,3,-2,L
137076,20,BEL1,2021-02-28,K Beerschot VA,Mouscron,2,2,0,D
137077,20,BEL1,2021-02-28,St Truiden,Eupen,0,2,-2,L
137078,20,BEL1,2021-03-01,Oud-Heverlee Leuven,Antwerp,2,0,2,W
137079,20,BEL1,2021-03-05,Charleroi,St Truiden,0,0,0,D
137080,20,BEL1,2021-03-06,Eupen,Oud-Heverlee Leuven,3,3,0,D
137081,20,BEL1,2021-03-06,Waasland-Beveren,K Beerschot VA,1,2,-1,L
137082,20,BEL1,2021-03-06,Antwerp,Kortrijk,4,2,2,W
137083,20,BEL1,2021-03-07,Mouscron,Standard,1,0,1,W
137084,20,BEL1,2021-03-07,Club Brugge,Waregem,3,0,3,W
137085,20,BEL1,2021-03-07,Anderlecht,Mechelen,1,1,0,D
137086,20,BEL1,2021-03-07,Genk,Cercle Brugge,2,0,2,W
137087,20,BEL1,2021-03-08,Gent,Oostende,1,0,1,W
137088,20,BEL1,2021-03-12,Charleroi,Club Brugge,1,1,0,D
137089,20,BEL1,2021-03-15,Gent,Club Brugge,0,4,-4,L
137090,20,BEL1,2021-03-19,Genk,Standard,2,2,0,D
137091,20,BEL1,2021-03-20,Mouscron,Oostende,0,1,-1,L
137092,20,BEL1,2021-03-20,Eupen,Kortrijk,2,0,2,W
137093,20,BEL1,2021-03-21,Club Brugge,Antwerp,0,2,-2,L
137094,20,BEL1,2021-03-21,Mechelen,Oud-Heverlee Leuven,2,2,0,D
137095,20,BEL1,2021-03-21,Anderlecht,Waregem,4,1,3,W
137096,20,BEL1,2021-03-21,Gent,Cercle Brugge,1,0,1,W
137097,20,BEL1,2021-04-03,Oostende,Waasland-Beveren,0,2,-2,L
137098,20,BEL1,2021-04-03,St Truiden,Mechelen,2,1,1,W
137099,20,BEL1,2021-04-03,Kortrijk,Club Brugge,1,2,-1,L
137100,20,BEL1,2021-04-04,Cercle Brugge,K Beerschot VA,2,1,1,W
137101,20,BEL1,2021-04-04,Standard,Gent,2,1,1,W
137102,20,BEL1,2021-04-04,Charleroi,Mouscron,1,1,0,D
137103,20,BEL1,2021-04-05,Oud-Heverlee Leuven,Genk,2,3,-1,L
137104,20,BEL1,2021-04-05,Waregem,Eupen,2,1,1,W
137105,20,BEL1,2021-04-05,Antwerp,Anderlecht,1,4,-3,L
137106,20,BEL1,2021-04-06,Waasland-Beveren,St Truiden,2,4,-2,L
137107,20,BEL1,2021-04-07,K Beerschot VA,Charleroi,2,1,1,W
137108,20,BEL1,2021-04-09,Eupen,Standard,0,4,-4,L
137109,20,BEL1,2021-04-10,Cercle Brugge,Oud-Heverlee Leuven,3,0,3,W
137110,20,BEL1,2021-04-10,Mechelen,Waregem,4,2,2,W
137111,20,BEL1,2021-04-10,Gent,Charleroi,4,0,4,W
137112,20,BEL1,2021-04-11,Genk,St Truiden,4,0,4,W
137113,20,BEL1,2021-04-11,Waasland-Beveren,Kortrijk,3,4,-1,L
137114,20,BEL1,2021-04-11,Anderlecht,Club Brugge,2,1,1,W
137115,20,BEL1,2021-04-11,K Beerschot VA,Oostende,1,2,-1,L
137116,20,BEL1,2021-04-12,Mouscron,Antwerp,2,3,-1,L
137117,20,BEL1,2021-04-17,Charleroi,Eupen,2,3,-1,L
137118,20,BEL1,2021-04-17,Antwerp,Genk,3,2,1,W
137119,20,BEL1,2021-04-18,Club Brugge,Mouscron,4,2,2,W
137120,20,BEL1,2021-04-18,Kortrijk,Mechelen,1,4,-3,L
137121,20,BEL1,2021-04-18,Oostende,Cercle Brugge,1,1,0,D
137122,20,BEL1,2021-04-18,Oud-Heverlee Leuven,Waasland-Beveren,1,2,-1,L
137123,20,BEL1,2021-04-18,Standard,K Beerschot VA,3,0,3,W
137124,20,BEL1,2021-04-18,Waregem,Gent,2,7,-5,L
137125,20,BEL1,2021-04-18,St Truiden,Anderlecht,0,1,-1,L
137126,20,BEL1,2021-04-30,Antwerp,Genk,2,3,-1,L
137127,20,BEL1,2021-05-01,Oostende,Standard,6,2,4,W
137128,20,BEL1,2021-05-02,Club Brugge,Anderlecht,2,2,0,D
137129,20,BEL1,2021-05-02,Gent,Mechelen,2,2,0,D
137130,20,BEL1,2021-05-07,Genk,Club Brugge,3,0,3,W
137131,20,BEL1,2021-05-08,Anderlecht,Antwerp,2,2,0,D
137132,20,BEL1,2021-05-08,Standard,Gent,2,1,1,W
137133,20,BEL1,2021-05-09,Mechelen,Oostende,5,3,2,W
137134,20,BEL1,2021-05-12,Genk,Anderlecht,1,1,0,D
137135,20,BEL1,2021-05-13,Antwerp,Club Brugge,0,0,0,D
137136,20,BEL1,2021-05-13,Gent,Oostende,2,1,1,W
137137,20,BEL1,2021-05-13,Standard,Mechelen,1,2,-1,L
137138,20,BEL1,2021-05-15,Anderlecht,Genk,1,2,-1,L
137139,20,BEL1,2021-05-16,Club Brugge,Antwerp,2,1,1,W
137140,20,BEL1,2021-05-16,Oostende,Gent,0,4,-4,L
137141,20,BEL1,2021-05-16,Mechelen,Standard,3,1,2,W
137142,20,BEL1,2021-05-19,Oostende,Mechelen,2,2,0,D
137143,20,BEL1,2021-05-19,Gent,Standard,2,0,2,W
137144,20,BEL1,2021-05-20,Genk,Antwerp,4,0,4,W
137145,20,BEL1,2021-05-20,Anderlecht,Club Brugge,3,3,0,D
137146,20,BEL1,2021-05-22,Mechelen,Gent,1,2,-1,L
137147,20,BEL1,2021-05-22,Standard,Oostende,1,3,-2,L
137148,20,BEL1,2021-05-23,Antwerp,Anderlecht,1,0,1,W
137149,20,BEL1,2021-05-23,Club Brugge,Genk,1,2,-1,L
137150,21,BEL1,2021-07-23,Standard,Genk,1,1,0,D
137151,21,BEL1,2021-07-24,Oud-Heverlee Leuven,Waregem,1,1,0,D
137152,21,BEL1,2021-07-24,Kortrijk,RFC Seraing,2,0,2,W
137153,21,BEL1,2021-07-24,Oostende,Charleroi,0,3,-3,L
137154,21,BEL1,2021-07-25,Mechelen,Antwerp,3,2,1,W
137155,21,BEL1,2021-07-25,Club Brugge,Eupen,2,2,0,D
137156,21,BEL1,2021-07-25,Anderlecht,Union Saint-Gilloise,1,3,-2,L
137157,21,BEL1,2021-07-25,St Truiden,Gent,2,1,1,W
137158,21,BEL1,2021-07-27,K Beerschot VA,Cercle Brugge,0,1,-1,L
137159,21,BEL1,2021-07-30,Genk,Oostende,3,4,-1,L
137160,21,BEL1,2021-07-31,Charleroi,St Truiden,0,0,0,D
137161,21,BEL1,2021-07-31,Cercle Brugge,Oud-Heverlee Leuven,1,1,0,D
137162,21,BEL1,2021-07-31,RFC Seraing,Mechelen,1,0,1,W
137163,21,BEL1,2021-07-31,Eupen,Anderlecht,1,1,0,D
137164,21,BEL1,2021-08-01,Union Saint-Gilloise,Club Brugge,0,1,-1,L
137165,21,BEL1,2021-08-01,Waregem,Standard,1,2,-1,L
137166,21,BEL1,2021-08-01,Gent,K Beerschot VA,2,2,0,D
137167,21,BEL1,2021-08-01,Antwerp,Kortrijk,0,1,-1,L
137168,21,BEL1,2021-08-06,Club Brugge,Cercle Brugge,1,1,0,D
137169,21,BEL1,2021-08-07,K Beerschot VA,Union Saint-Gilloise,0,3,-3,L
137170,21,BEL1,2021-08-07,Mechelen,Eupen,1,3,-2,L
137171,21,BEL1,2021-08-07,St Truiden,Waregem,1,3,-2,L
137172,21,BEL1,2021-08-07,Kortrijk,Genk,1,2,-1,L
137173,21,BEL1,2021-08-08,Standard,Antwerp,2,5,-3,L
137174,21,BEL1,2021-08-08,Oud-Heverlee Leuven,Charleroi,1,1,0,D
137175,21,BEL1,2021-08-08,Anderlecht,RFC Seraing,3,0,3,W
137176,21,BEL1,2021-08-08,Oostende,Gent,1,0,1,W
137177,21,BEL1,2021-08-13,Charleroi,Antwerp,1,1,0,D
137178,21,BEL1,2021-08-14,Union Saint-Gilloise,Kortrijk,2,0,2,W
137179,21,BEL1,2021-08-14,Eupen,St Truiden,2,1,1,W
137180,21,BEL1,2021-08-14,RFC Seraing,Oostende,2,3,-1,L
137181,21,BEL1,2021-08-14,Genk,Oud-Heverlee Leuven,4,0,4,W
137182,21,BEL1,2021-08-15,K Beerschot VA,Standard,0,1,-1,L
137183,21,BEL1,2021-08-15,Gent,Mechelen,2,0,2,W
137184,21,BEL1,2021-08-15,Cercle Brugge,Anderlecht,1,2,-1,L
137185,21,BEL1,2021-08-15,Waregem,Club Brugge,0,4,-4,L
137186,21,BEL1,2021-08-20,Standard,Oostende,1,0,1,W
137187,21,BEL1,2021-08-21,RFC Seraing,Cercle Brugge,2,1,1,W
137188,21,BEL1,2021-08-21,Oud-Heverlee Leuven,Eupen,1,4,-3,L
137189,21,BEL1,2021-08-21,St Truiden,Kortrijk,0,2,-2,L
137190,21,BEL1,2021-08-22,Waregem,Charleroi,2,2,0,D
137191,21,BEL1,2021-08-22,Club Brugge,K Beerschot VA,3,2,1,W
137192,21,BEL1,2021-08-22,Mechelen,Union Saint-Gilloise,3,1,2,W
137193,21,BEL1,2021-08-27,Kortrijk,Mechelen,2,2,0,D
137194,21,BEL1,2021-08-28,Charleroi,K Beerschot VA,5,2,3,W
137195,21,BEL1,2021-08-28,Cercle Brugge,St Truiden,0,1,-1,L
137196,21,BEL1,2021-08-28,Eupen,RFC Seraing,1,2,-1,L
137197,21,BEL1,2021-08-28,Union Saint-Gilloise,Standard,4,0,4,W
137198,21,BEL1,2021-08-29,Gent,Club Brugge,6,1,5,W
137199,21,BEL1,2021-08-29,Antwerp,Oud-Heverlee Leuven,2,2,0,D
137200,21,BEL1,2021-08-29,Genk,Anderlecht,1,0,1,W
137201,21,BEL1,2021-08-29,Oostende,Waregem,0,2,-2,L
137202,21,BEL1,2021-09-10,Club Brugge,Oostende,3,0,3,W
137203,21,BEL1,2021-09-11,Eupen,Antwerp,0,1,-1,L
137204,21,BEL1,2021-09-11,Waregem,Cercle Brugge,2,4,-2,L
137205,21,BEL1,2021-09-12,Anderlecht,Mechelen,7,2,5,W
137206,21,BEL1,2021-09-12,Gent,Charleroi,2,3,-1,L
137207,21,BEL1,2021-09-12,RFC Seraing,Standard,0,1,-1,L
137208,21,BEL1,2021-09-12,Genk,Union Saint-Gilloise,1,1,0,D
137209,21,BEL1,2021-09-12,Oud-Heverlee Leuven,Kortrijk,2,1,1,W
137210,21,BEL1,2021-09-13,K Beerschot VA,St Truiden,0,1,-1,L
137211,21,BEL1,2021-09-17,Cercle Brugge,Eupen,1,2,-1,L
137212,21,BEL1,2021-09-18,Oostende,K Beerschot VA,3,1,2,W
137213,21,BEL1,2021-09-18,Mechelen,Oud-Heverlee Leuven,2,0,2,W
137214,21,BEL1,2021-09-18,Union Saint-Gilloise,Waregem,2,1,1,W
137215,21,BEL1,2021-09-18,Charleroi,Club Brugge,0,1,-1,L
137216,21,BEL1,2021-09-19,St Truiden,Genk,1,2,-1,L
137217,21,BEL1,2021-09-19,Antwerp,RFC Seraing,2,1,1,W
137218,21,BEL1,2021-09-19,Standard,Anderlecht,0,1,-1,L
137219,21,BEL1,2021-09-19,Kortrijk,Gent,1,0,1,W
137220,21,BEL1,2021-09-22,Antwerp,Genk,4,2,2,W
137221,21,BEL1,2021-09-23,Anderlecht,Gent,1,1,0,D
137222,21,BEL1,2021-09-24,Club Brugge,Oud-Heverlee Leuven,1,1,0,D
137223,21,BEL1,2021-09-25,K Beerschot VA,Eupen,0,3,-3,L
137224,21,BEL1,2021-09-25,Waregem,Kortrijk,2,2,0,D
137225,21,BEL1,2021-09-25,Standard,St Truiden,1,2,-1,L
137226,21,BEL1,2021-09-26,Union Saint-Gilloise,Antwerp,1,2,-1,L
137227,21,BEL1,2021-09-26,Gent,Cercle Brugge,2,1,1,W
137228,21,BEL1,2021-09-26,Oostende,Anderlecht,2,2,0,D
137229,21,BEL1,2021-09-26,Genk,RFC Seraing,3,0,3,W
137230,21,BEL1,2021-09-26,Charleroi,Mechelen,0,2,-2,L
137231,21,BEL1,2021-10-01,Mechelen,Standard,3,1,2,W
137232,21,BEL1,2021-10-02,Kortrijk,Charleroi,2,2,0,D
137233,21,BEL1,2021-10-02,Cercle Brugge,Union Saint-Gilloise,0,3,-3,L
137234,21,BEL1,2021-10-02,St Truiden,Oostende,1,1,0,D
137235,21,BEL1,2021-10-02,Oud-Heverlee Leuven,K Beerschot VA,0,0,0,D
137236,21,BEL1,2021-10-03,Anderlecht,Club Brugge,1,1,0,D
137237,21,BEL1,2021-10-03,RFC Seraing,Waregem,5,1,4,W
137238,21,BEL1,2021-10-03,Antwerp,Gent,1,0,1,W
137239,21,BEL1,2021-10-03,Eupen,Genk,3,2,1,W
137240,21,BEL1,2021-10-15,Club Brugge,Kortrijk,2,0,2,W
137241,21,BEL1,2021-10-16,Union Saint-Gilloise,RFC Seraing,4,2,2,W
137242,21,BEL1,2021-10-16,Oostende,Cercle Brugge,2,1,1,W
137243,21,BEL1,2021-10-16,Waregem,Antwerp,2,1,1,W
137244,21,BEL1,2021-10-16,Standard,Oud-Heverlee Leuven,2,2,0,D
137245,21,BEL1,2021-10-17,St Truiden,Anderlecht,2,2,0,D
137246,21,BEL1,2021-10-17,K Beerschot VA,Mechelen,0,1,-1,L
137247,21,BEL1,2021-10-17,Charleroi,Genk,2,0,2,W
137248,21,BEL1,2021-10-17,Gent,Eupen,2,0,2,W
137249,21,BEL1,2021-10-22,RFC Seraing,Charleroi,1,3,-2,L
137250,21,BEL1,2021-10-23,Cercle Brugge,Standard,1,1,0,D
137251,21,BEL1,2021-10-23,Kortrijk,Oostende,1,0,1,W
137252,21,BEL1,2021-10-23,Mechelen,Waregem,2,2,0,D
137253,21,BEL1,2021-10-23,Eupen,Union Saint-Gilloise,2,3,-1,L
137254,21,BEL1,2021-10-24,Antwerp,Club Brugge,1,1,0,D
137255,21,BEL1,2021-10-24,Anderlecht,K Beerschot VA,4,2,2,W
137256,21,BEL1,2021-10-24,Genk,Gent,0,3,-3,L
137257,21,BEL1,2021-10-24,Oud-Heverlee Leuven,St Truiden,4,1,3,W
137258,21,BEL1,2021-10-29,Oostende,Mechelen,2,4,-2,L
137259,21,BEL1,2021-10-30,Charleroi,Eupen,3,0,3,W
137260,21,BEL1,2021-10-30,K Beerschot VA,RFC Seraing,3,0,3,W
137261,21,BEL1,2021-10-30,Standard,Kortrijk,1,1,0,D
137262,21,BEL1,2021-10-30,St Truiden,Club Brugge,1,2,-1,L
137263,21,BEL1,2021-10-31,Waregem,Genk,2,6,-4,L
137264,21,BEL1,2021-10-31,Cercle Brugge,Antwerp,0,1,-1,L
137265,21,BEL1,2021-10-31,Anderlecht,Oud-Heverlee Leuven,2,2,0,D
137266,21,BEL1,2021-10-31,Gent,Union Saint-Gilloise,0,2,-2,L
137267,21,BEL1,2021-11-05,Oud-Heverlee Leuven,Oostende,1,0,1,W
137268,21,BEL1,2021-11-06,Eupen,Waregem,1,1,0,D
137269,21,BEL1,2021-11-06,Kortrijk,K Beerschot VA,1,1,0,D
137270,21,BEL1,2021-11-06,Mechelen,St Truiden,0,1,-1,L
137271,21,BEL1,2021-11-06,Union Saint-Gilloise,Charleroi,4,0,4,W
137272,21,BEL1,2021-11-07,Club Brugge,Standard,2,2,0,D
137273,21,BEL1,2021-11-07,RFC Seraing,Gent,0,0,0,D
137274,21,BEL1,2021-11-07,Antwerp,Anderlecht,2,0,2,W
137275,21,BEL1,2021-11-07,Genk,Cercle Brugge,1,1,0,D
137276,21,BEL1,2021-11-19,Mechelen,Club Brugge,2,1,1,W
137277,21,BEL1,2021-11-20,Cercle Brugge,Charleroi,1,2,-1,L
137278,21,BEL1,2021-11-20,Oud-Heverlee Leuven,RFC Seraing,1,3,-2,L
137279,21,BEL1,2021-11-20,Waregem,Gent,1,2,-1,L
137280,21,BEL1,2021-11-20,Standard,Eupen,1,0,1,W
137281,21,BEL1,2021-11-21,Anderlecht,Kortrijk,1,1,0,D
137282,21,BEL1,2021-11-21,St Truiden,Antwerp,2,1,1,W
137283,21,BEL1,2021-11-21,Oostende,Union Saint-Gilloise,1,7,-6,L
137284,21,BEL1,2021-11-21,K Beerschot VA,Genk,2,0,2,W
137285,21,BEL1,2021-11-26,Union Saint-Gilloise,Oud-Heverlee Leuven,1,3,-2,L
137286,21,BEL1,2021-11-27,RFC Seraing,St Truiden,2,0,2,W
137287,21,BEL1,2021-11-27,Cercle Brugge,Mechelen,3,1,2,W
137288,21,BEL1,2021-11-27,Eupen,Kortrijk,2,2,0,D
137289,21,BEL1,2021-11-27,Charleroi,Anderlecht,1,3,-2,L
137290,21,BEL1,2021-11-28,Genk,Club Brugge,2,3,-1,L
137291,21,BEL1,2021-11-28,Waregem,K Beerschot VA,2,0,2,W
137292,21,BEL1,2021-11-28,Gent,Standard,3,1,2,W
137293,21,BEL1,2021-11-28,Antwerp,Oostende,3,0,3,W
137294,21,BEL1,2021-12-03,St Truiden,Union Saint-Gilloise,1,2,-1,L
137295,21,BEL1,2021-12-04,Oud-Heverlee Leuven,Gent,0,1,-1,L
137296,21,BEL1,2021-12-04,Kortrijk,Cercle Brugge,0,2,-2,L
137297,21,BEL1,2021-12-04,Oostende,Eupen,2,1,1,W
137298,21,BEL1,2021-12-04,Club Brugge,RFC Seraing,3,2,1,W
137299,21,BEL1,2021-12-05,K Beerschot VA,Antwerp,0,1,-1,L
137300,21,BEL1,2021-12-05,Anderlecht,Waregem,3,2,1,W
137301,21,BEL1,2021-12-05,Standard,Charleroi,0,3,-3,L
137302,21,BEL1,2021-12-05,Mechelen,Genk,1,1,0,D
137303,21,BEL1,2021-12-10,Charleroi,Oostende,1,0,1,W
137304,21,BEL1,2021-12-11,Kortrijk,Oud-Heverlee Leuven,2,1,1,W
137305,21,BEL1,2021-12-11,Eupen,K Beerschot VA,1,0,1,W
137306,21,BEL1,2021-12-11,St Truiden,Cercle Brugge,1,2,-1,L
137307,21,BEL1,2021-12-11,RFC Seraing,Anderlecht,0,5,-5,L
137308,21,BEL1,2021-12-12,Antwerp,Standard,2,3,-1,L
137309,21,BEL1,2021-12-12,Union Saint-Gilloise,Mechelen,2,0,2,W
137310,21,BEL1,2021-12-12,Gent,Genk,1,0,1,W
137311,21,BEL1,2021-12-12,Club Brugge,Waregem,3,0,3,W
137312,21,BEL1,2021-12-14,Cercle Brugge,RFC Seraing,2,0,2,W
137313,21,BEL1,2021-12-14,Oostende,Kortrijk,0,2,-2,L
137314,21,BEL1,2021-12-14,Anderlecht,St Truiden,2,0,2,W
137315,21,BEL1,2021-12-15,Mechelen,Gent,4,3,1,W
137316,21,BEL1,2021-12-15,Waregem,Union Saint-Gilloise,0,2,-2,L
137317,21,BEL1,2021-12-15,Oud-Heverlee Leuven,Club Brugge,1,4,-3,L
137318,21,BEL1,2021-12-16,Antwerp,Eupen,4,2,2,W
137319,21,BEL1,2021-12-16,Genk,Charleroi,4,2,2,W
137320,21,BEL1,2021-12-17,RFC Seraing,Kortrijk,0,2,-2,L
137321,21,BEL1,2021-12-18,K Beerschot VA,Oostende,0,2,-2,L
137322,21,BEL1,2021-12-18,Union Saint-Gilloise,Cercle Brugge,3,2,1,W
137323,21,BEL1,2021-12-18,Waregem,Mechelen,3,2,1,W
137324,21,BEL1,2021-12-18,Gent,St Truiden,2,1,1,W
137325,21,BEL1,2021-12-19,Club Brugge,Anderlecht,2,2,0,D
137326,21,BEL1,2021-12-19,Eupen,Charleroi,0,4,-4,L
137327,21,BEL1,2021-12-19,Genk,Antwerp,1,1,0,D
137328,21,BEL1,2021-12-19,Oud-Heverlee Leuven,Standard,2,1,1,W
137329,21,BEL1,2021-12-26,Cercle Brugge,Club Brugge,2,0,2,W
137330,21,BEL1,2021-12-26,Standard,Waregem,0,1,-1,L
137331,21,BEL1,2021-12-26,Union Saint-Gilloise,Gent,0,0,0,D
137332,21,BEL1,2021-12-26,Oostende,Genk,0,4,-4,L
137333,21,BEL1,2021-12-27,Mechelen,RFC Seraing,2,0,2,W
137334,21,BEL1,2021-12-27,Charleroi,Oud-Heverlee Leuven,0,3,-3,L
137335,21,BEL1,2021-12-27,K Beerschot VA,Anderlecht,0,7,-7,L
137336,21,BEL1,2021-12-27,St Truiden,Eupen,2,0,2,W
137337,21,BEL1,2022-01-14,Gent,Kortrijk,2,2,0,D
137338,21,BEL1,2022-01-15,Club Brugge,St Truiden,2,0,2,W
137339,21,BEL1,2022-01-16,Antwerp,Charleroi,3,0,3,W
137340,21,BEL1,2022-01-16,Eupen,Cercle Brugge,0,2,-2,L
137341,21,BEL1,2022-01-16,Anderlecht,Standard,1,1,0,D
137342,21,BEL1,2022-01-16,Genk,K Beerschot VA,4,1,3,W
137343,21,BEL1,2022-01-18,RFC Seraing,Union Saint-Gilloise,0,4,-4,L
137344,21,BEL1,2022-01-21,Oostende,Antwerp,1,2,-1,L
137345,21,BEL1,2022-01-22,Kortrijk,Eupen,1,1,0,D
137346,21,BEL1,2022-01-22,K Beerschot VA,Oud-Heverlee Leuven,3,1,2,W
137347,21,BEL1,2022-01-22,St Truiden,RFC Seraing,3,1,2,W
137348,21,BEL1,2022-01-22,Charleroi,Gent,0,0,0,D
137349,21,BEL1,2022-01-23,Standard,Club Brugge,2,2,0,D
137350,21,BEL1,2022-01-23,Union Saint-Gilloise,Genk,2,1,1,W
137351,21,BEL1,2022-01-23,Mechelen,Anderlecht,0,1,-1,L
137352,21,BEL1,2022-01-23,Cercle Brugge,Waregem,3,1,2,W
137353,21,BEL1,2022-01-25,Antwerp,St Truiden,1,1,0,D
137354,21,BEL1,2022-01-25,Gent,Oostende,1,1,0,D
137355,21,BEL1,2022-01-25,Charleroi,Kortrijk,1,1,0,D
137356,21,BEL1,2022-01-26,Eupen,Standard,0,2,-2,L
137357,21,BEL1,2022-01-26,Waregem,Oud-Heverlee Leuven,1,1,0,D
137358,21,BEL1,2022-01-26,Anderlecht,Cercle Brugge,0,2,-2,L
137359,21,BEL1,2022-01-26,RFC Seraing,K Beerschot VA,2,1,1,W
137360,21,BEL1,2022-01-27,Club Brugge,Union Saint-Gilloise,0,0,0,D
137361,21,BEL1,2022-01-28,St Truiden,Charleroi,0,1,-1,L
137362,21,BEL1,2022-01-29,K Beerschot VA,Waregem,3,3,0,D
137363,21,BEL1,2022-01-29,RFC Seraing,Eupen,0,0,0,D
137364,21,BEL1,2022-01-29,Cercle Brugge,Oostende,0,1,-1,L
137365,21,BEL1,2022-01-30,Union Saint-Gilloise,Anderlecht,1,0,1,W
137366,21,BEL1,2022-01-30,Gent,Antwerp,0,1,-1,L
137367,21,BEL1,2022-01-30,Standard,Mechelen,1,2,-1,L
137368,21,BEL1,2022-01-30,Kortrijk,Club Brugge,0,1,-1,L
137369,21,BEL1,2022-02-02,Kortrijk,Antwerp,0,2,-2,L
137370,21,BEL1,2022-02-04,Charleroi,RFC Seraing,2,0,2,W
137371,21,BEL1,2022-02-05,Kortrijk,St Truiden,1,3,-2,L
137372,21,BEL1,2022-02-05,Oostende,Oud-Heverlee Leuven,1,3,-2,L
137373,21,BEL1,2022-02-05,Standard,Cercle Brugge,1,1,0,D
137374,21,BEL1,2022-02-05,Antwerp,Union Saint-Gilloise,0,2,-2,L
137375,21,BEL1,2022-02-06,Club Brugge,Gent,1,2,-1,L
137376,21,BEL1,2022-02-06,Mechelen,K Beerschot VA,3,2,1,W
137377,21,BEL1,2022-02-06,Anderlecht,Eupen,4,1,3,W
137378,21,BEL1,2022-02-06,Genk,Waregem,2,0,2,W
137379,21,BEL1,2022-02-09,Waregem,Oostende,0,0,0,D
137380,21,BEL1,2022-02-09,Oud-Heverlee Leuven,Genk,2,1,1,W
137381,21,BEL1,2022-02-11,RFC Seraing,Antwerp,0,1,-1,L
137382,21,BEL1,2022-02-12,Eupen,Gent,0,1,-1,L
137383,21,BEL1,2022-02-12,Mechelen,Oostende,3,0,3,W
137384,21,BEL1,2022-02-12,Oud-Heverlee Leuven,Cercle Brugge,3,2,1,W
137385,21,BEL1,2022-02-12,Waregem,Anderlecht,1,2,-1,L
137386,21,BEL1,2022-02-13,Genk,Standard,2,0,2,W
137387,21,BEL1,2022-02-13,Union Saint-Gilloise,St Truiden,0,1,-1,L
137388,21,BEL1,2022-02-13,Club Brugge,Charleroi,2,0,2,W
137389,21,BEL1,2022-02-13,K Beerschot VA,Kortrijk,2,1,1,W
137390,21,BEL1,2022-02-16,Genk,Mechelen,4,1,3,W
137391,21,BEL1,2022-02-19,Cercle Brugge,K Beerschot VA,2,0,2,W
137392,21,BEL1,2022-02-19,Kortrijk,Waregem,5,0,5,W
137393,21,BEL1,2022-02-19,Oostende,Standard,1,0,1,W
137394,21,BEL1,2022-02-19,Charleroi,Union Saint-Gilloise,0,3,-3,L
137395,21,BEL1,2022-02-20,Antwerp,Mechelen,1,2,-1,L
137396,21,BEL1,2022-02-20,Eupen,Club Brugge,1,3,-2,L
137397,21,BEL1,2022-02-20,Anderlecht,Genk,2,0,2,W
137398,21,BEL1,2022-02-20,St Truiden,Oud-Heverlee Leuven,2,0,2,W
137399,21,BEL1,2022-02-23,Gent,RFC Seraing,4,0,4,W
137400,21,BEL1,2022-02-25,K Beerschot VA,Charleroi,2,3,-1,L
137401,21,BEL1,2022-02-26,Union Saint-Gilloise,Eupen,0,0,0,D
137402,21,BEL1,2022-02-26,Mechelen,Cercle Brugge,2,2,0,D
137403,21,BEL1,2022-02-26,Oostende,St Truiden,0,0,0,D
137404,21,BEL1,2022-02-26,Oud-Heverlee Leuven,Anderlecht,0,0,0,D
137405,21,BEL1,2022-02-27,Club Brugge,Antwerp,4,1,3,W
137406,21,BEL1,2022-02-27,Genk,Kortrijk,2,0,2,W
137407,21,BEL1,2022-02-27,Standard,Gent,0,1,-1,L
137408,21,BEL1,2022-02-27,Waregem,RFC Seraing,1,0,1,W
137409,21,BEL1,2022-03-02,Standard,K Beerschot VA,1,0,1,W
137410,21,BEL1,2022-03-04,St Truiden,Mechelen,1,1,0,D
137411,21,BEL1,2022-03-05,Cercle Brugge,Genk,2,2,0,D
137412,21,BEL1,2022-03-05,Kortrijk,Union Saint-Gilloise,2,3,-1,L
137413,21,BEL1,2022-03-05,RFC Seraing,Club Brugge,0,5,-5,L
137414,21,BEL1,2022-03-06,Antwerp,K Beerschot VA,2,1,1,W
137415,21,BEL1,2022-03-06,Anderlecht,Oostende,3,0,3,W
137416,21,BEL1,2022-03-06,Charleroi,Standard,0,0,0,D
137417,21,BEL1,2022-03-06,Gent,Waregem,2,1,1,W
137418,21,BEL1,2022-03-06,Eupen,Oud-Heverlee Leuven,3,1,2,W
137419,21,BEL1,2022-03-11,Oud-Heverlee Leuven,Union Saint-Gilloise,1,4,-3,L
137420,21,BEL1,2022-03-12,Mechelen,Charleroi,2,2,0,D
137421,21,BEL1,2022-03-12,Cercle Brugge,Kortrijk,2,0,2,W
137422,21,BEL1,2022-03-12,Waregem,Eupen,3,0,3,W
137423,21,BEL1,2022-03-12,Oostende,Club Brugge,1,3,-2,L
137424,21,BEL1,2022-03-13,Anderlecht,Antwerp,2,1,1,W
137425,21,BEL1,2022-03-13,Genk,St Truiden,0,1,-1,L
137426,21,BEL1,2022-03-13,K Beerschot VA,Gent,0,2,-2,L
137427,21,BEL1,2022-03-13,Standard,RFC Seraing,0,1,-1,L
137428,21,BEL1,2022-03-18,Union Saint-Gilloise,Oostende,1,1,0,D
137429,21,BEL1,2022-03-19,Eupen,Mechelen,1,1,0,D
137430,21,BEL1,2022-03-19,Charleroi,Cercle Brugge,5,0,5,W
137431,21,BEL1,2022-03-19,RFC Seraing,Oud-Heverlee Leuven,1,1,0,D
137432,21,BEL1,2022-03-19,Antwerp,Waregem,1,0,1,W
137433,21,BEL1,2022-03-20,Club Brugge,Genk,3,1,2,W
137434,21,BEL1,2022-03-20,Kortrijk,Standard,0,1,-1,L
137435,21,BEL1,2022-03-20,Gent,Anderlecht,1,0,1,W
137436,21,BEL1,2022-03-20,St Truiden,K Beerschot VA,3,2,1,W
137437,21,BEL1,2022-04-01,K Beerschot VA,Club Brugge,1,3,-2,L
137438,21,BEL1,2022-04-02,Waregem,St Truiden,0,2,-2,L
137439,21,BEL1,2022-04-02,Mechelen,Kortrijk,3,2,1,W
137440,21,BEL1,2022-04-02,Oostende,RFC Seraing,2,2,0,D
137441,21,BEL1,2022-04-02,Oud-Heverlee Leuven,Antwerp,0,1,-1,L
137442,21,BEL1,2022-04-03,Standard,Union Saint-Gilloise,1,3,-2,L
137443,21,BEL1,2022-04-03,Cercle Brugge,Gent,2,2,0,D
137444,21,BEL1,2022-04-03,Anderlecht,Charleroi,4,0,4,W
137445,21,BEL1,2022-04-03,Genk,Eupen,5,0,5,W
137446,21,BEL1,2022-04-09,Eupen,Oostende,0,2,-2,L
137447,21,BEL1,2022-04-09,Antwerp,Cercle Brugge,1,1,0,D
137448,21,BEL1,2022-04-10,Club Brugge,Mechelen,2,0,2,W
137449,21,BEL1,2022-04-10,Gent,Oud-Heverlee Leuven,5,0,5,W
137450,21,BEL1,2022-04-10,Kortrijk,Anderlecht,2,3,-1,L
137451,21,BEL1,2022-04-10,Charleroi,Waregem,3,0,3,W
137452,21,BEL1,2022-04-10,RFC Seraing,Genk,0,2,-2,L
137453,21,BEL1,2022-04-10,St Truiden,Standard,3,0,3,W
137454,21,BEL1,2022-04-23,Mechelen,Charleroi,1,0,1,W
137455,21,BEL1,2022-04-24,Club Brugge,Antwerp,1,0,1,W
137456,21,BEL1,2022-04-24,Union Saint-Gilloise,Anderlecht,3,1,2,W
137457,21,BEL1,2022-04-24,Gent,Genk,0,1,-1,L
137458,21,BEL1,2022-04-29,Genk,Mechelen,4,2,2,W
137459,21,BEL1,2022-04-30,Charleroi,Gent,1,3,-2,L
137460,21,BEL1,2022-05-01,Antwerp,Union Saint-Gilloise,0,0,0,D
137461,21,BEL1,2022-05-01,Anderlecht,Club Brugge,0,0,0,D
137462,21,BEL1,2022-05-06,Charleroi,Genk,2,2,0,D
137463,21,BEL1,2022-05-07,Gent,Mechelen,1,0,1,W
137464,21,BEL1,2022-05-08,Union Saint-Gilloise,Club Brugge,0,2,-2,L
137465,21,BEL1,2022-05-08,Antwerp,Anderlecht,0,4,-4,L
137466,21,BEL1,2022-05-10,Mechelen,Gent,1,2,-1,L
137467,21,BEL1,2022-05-10,Genk,Charleroi,3,2,1,W
137468,21,BEL1,2022-05-11,Club Brugge,Union Saint-Gilloise,1,0,1,W
137469,21,BEL1,2022-05-12,Anderlecht,Antwerp,2,1,1,W
137470,21,BEL1,2022-05-14,Charleroi,Mechelen,3,2,1,W
137471,21,BEL1,2022-05-15,Antwerp,Club Brugge,1,3,-2,L
137472,21,BEL1,2022-05-15,Anderlecht,Union Saint-Gilloise,0,2,-2,L
137473,21,BEL1,2022-05-15,Genk,Gent,0,2,-2,L
137474,21,BEL1,2022-05-21,Gent,Charleroi,1,2,-1,L
137475,21,BEL1,2022-05-21,Mechelen,Genk,0,0,0,D
137476,21,BEL1,2022-05-22,Union Saint-Gilloise,Antwerp,0,1,-1,L
137477,21,BEL1,2022-05-22,Club Brugge,Anderlecht,1,1,0,D
137478,22,BEL1,2022-07-22,Standard,Gent,2,2,0,D
137479,22,BEL1,2022-07-23,Charleroi,Eupen,3,1,2,W
137480,22,BEL1,2022-07-23,Kortrijk,Oud-Heverlee Leuven,0,2,-2,L
137481,22,BEL1,2022-07-23,Waregem,RFC Seraing,2,0,2,W
137482,22,BEL1,2022-07-23,St Truiden,Union Saint-Gilloise,1,1,0,D
137483,22,BEL1,2022-07-24,Club Brugge,Genk,3,2,1,W
137484,22,BEL1,2022-07-24,Mechelen,Antwerp,0,2,-2,L
137485,22,BEL1,2022-07-24,Anderlecht,Oostende,2,0,2,W
137486,22,BEL1,2022-07-24,Westerlo,Cercle Brugge,2,0,2,W
137487,22,BEL1,2022-07-29,Union Saint-Gilloise,Charleroi,1,0,1,W
137488,22,BEL1,2022-07-30,Cercle Brugge,Anderlecht,1,0,1,W
137489,22,BEL1,2022-07-30,Oostende,Mechelen,2,1,1,W
137490,22,BEL1,2022-07-30,Oud-Heverlee Leuven,Westerlo,2,0,2,W
137491,22,BEL1,2022-07-30,Gent,St Truiden,1,1,0,D
137492,22,BEL1,2022-07-31,Genk,Standard,3,1,2,W
137493,22,BEL1,2022-07-31,Eupen,Club Brugge,2,1,1,W
137494,22,BEL1,2022-07-31,RFC Seraing,Kortrijk,0,1,-1,L
137495,22,BEL1,2022-07-31,Antwerp,Waregem,1,0,1,W
137496,22,BEL1,2022-08-05,Club Brugge,Waregem,1,1,0,D
137497,22,BEL1,2022-08-06,Genk,Eupen,4,2,2,W
137498,22,BEL1,2022-08-06,Kortrijk,St Truiden,0,0,0,D
137499,22,BEL1,2022-08-06,Charleroi,Oostende,1,3,-2,L
137500,22,BEL1,2022-08-06,Mechelen,Union Saint-Gilloise,3,0,3,W
137501,22,BEL1,2022-08-07,Standard,Cercle Brugge,2,0,2,W
137502,22,BEL1,2022-08-07,Gent,Westerlo,2,1,1,W
137503,22,BEL1,2022-08-07,Anderlecht,RFC Seraing,3,1,2,W
137504,22,BEL1,2022-08-07,Antwerp,Oud-Heverlee Leuven,4,2,2,W
137505,22,BEL1,2022-08-12,Oostende,Gent,1,3,-2,L
137506,22,BEL1,2022-08-13,Westerlo,Standard,4,2,2,W
137507,22,BEL1,2022-08-13,Cercle Brugge,Mechelen,0,0,0,D
137508,22,BEL1,2022-08-13,RFC Seraing,Charleroi,0,1,-1,L
137509,22,BEL1,2022-08-13,Union Saint-Gilloise,Kortrijk,2,1,1,W
137510,22,BEL1,2022-08-14,St Truiden,Anderlecht,0,3,-3,L
137511,22,BEL1,2022-08-14,Eupen,Antwerp,0,1,-1,L
137512,22,BEL1,2022-08-14,Oud-Heverlee Leuven,Club Brugge,0,3,-3,L
137513,22,BEL1,2022-08-14,Waregem,Genk,1,4,-3,L
137514,22,BEL1,2022-08-19,Eupen,RFC Seraing,1,3,-2,L
137515,22,BEL1,2022-08-20,Oostende,St Truiden,0,1,-1,L
137516,22,BEL1,2022-08-20,Genk,Cercle Brugge,2,1,1,W
137517,22,BEL1,2022-08-21,Club Brugge,Kortrijk,2,1,1,W
137518,22,BEL1,2022-08-21,Waregem,Charleroi,1,3,-2,L
137519,22,BEL1,2022-08-21,Standard,Oud-Heverlee Leuven,1,3,-2,L
137520,22,BEL1,2022-08-21,Mechelen,Westerlo,5,4,1,W
137521,22,BEL1,2022-08-26,Charleroi,Club Brugge,1,3,-2,L
137522,22,BEL1,2022-08-27,RFC Seraing,Genk,0,4,-4,L
137523,22,BEL1,2022-08-27,Cercle Brugge,Waregem,1,1,0,D
137524,22,BEL1,2022-08-27,Oud-Heverlee Leuven,Oostende,2,1,1,W
137525,22,BEL1,2022-08-27,St Truiden,Mechelen,3,1,2,W
137526,22,BEL1,2022-08-28,Gent,Antwerp,1,2,-1,L
137527,22,BEL1,2022-08-28,Kortrijk,Standard,0,1,-1,L
137528,22,BEL1,2022-08-28,Union Saint-Gilloise,Anderlecht,2,1,1,W
137529,22,BEL1,2022-08-28,Westerlo,Eupen,0,1,-1,L
137530,22,BEL1,2022-08-31,Antwerp,Union Saint-Gilloise,4,2,2,W
137531,22,BEL1,2022-09-01,Anderlecht,Gent,0,1,-1,L
137532,22,BEL1,2022-09-02,Club Brugge,Cercle Brugge,4,0,4,W
137533,22,BEL1,2022-09-03,Genk,St Truiden,0,0,0,D
137534,22,BEL1,2022-09-03,Eupen,Kortrijk,0,1,-1,L
137535,22,BEL1,2022-09-03,Mechelen,RFC Seraing,2,3,-1,L
137536,22,BEL1,2022-09-03,Standard,Oostende,1,0,1,W
137537,22,BEL1,2022-09-04,Anderlecht,Oud-Heverlee Leuven,2,2,0,D
137538,22,BEL1,2022-09-04,Antwerp,Westerlo,3,0,3,W
137539,22,BEL1,2022-09-04,Charleroi,Gent,2,1,1,W
137540,22,BEL1,2022-09-04,Waregem,Union Saint-Gilloise,1,3,-2,L
137541,22,BEL1,2022-09-09,St Truiden,Standard,1,2,-1,L
137542,22,BEL1,2022-09-10,Kortrijk,Mechelen,1,4,-3,L
137543,22,BEL1,2022-09-10,Oostende,Eupen,1,0,1,W
137544,22,BEL1,2022-09-10,RFC Seraing,Club Brugge,0,2,-2,L
137545,22,BEL1,2022-09-10,Oud-Heverlee Leuven,Charleroi,3,2,1,W
137546,22,BEL1,2022-09-11,Westerlo,Anderlecht,2,1,1,W
137547,22,BEL1,2022-09-11,Cercle Brugge,Antwerp,0,2,-2,L
137548,22,BEL1,2022-09-11,Union Saint-Gilloise,Genk,1,2,-1,L
137549,22,BEL1,2022-09-11,Gent,Waregem,2,0,2,W
137550,22,BEL1,2022-09-16,Antwerp,RFC Seraing,2,1,1,W
137551,22,BEL1,2022-09-17,Mechelen,Oud-Heverlee Leuven,0,0,0,D
137552,22,BEL1,2022-09-17,Cercle Brugge,Oostende,2,2,0,D
137553,22,BEL1,2022-09-17,Waregem,St Truiden,0,3,-3,L
137554,22,BEL1,2022-09-17,Charleroi,Westerlo,2,3,-1,L
137555,22,BEL1,2022-09-18,Genk,Gent,1,0,1,W
137556,22,BEL1,2022-09-18,Eupen,Union Saint-Gilloise,1,2,-1,L
137557,22,BEL1,2022-09-18,Standard,Club Brugge,3,0,3,W
137558,22,BEL1,2022-09-18,Anderlecht,Kortrijk,4,1,3,W
137559,22,BEL1,2022-09-30,Standard,RFC Seraing,0,2,-2,L
137560,22,BEL1,2022-10-01,Oud-Heverlee Leuven,Union Saint-Gilloise,0,3,-3,L
137561,22,BEL1,2022-10-01,Oostende,Genk,1,2,-1,L
137562,22,BEL1,2022-10-01,Westerlo,Waregem,2,0,2,W
137563,22,BEL1,2022-10-01,Club Brugge,Mechelen,3,0,3,W
137564,22,BEL1,2022-10-02,Anderlecht,Charleroi,0,1,-1,L
137565,22,BEL1,2022-10-02,Gent,Cercle Brugge,3,4,-1,L
137566,22,BEL1,2022-10-02,Kortrijk,Antwerp,2,1,1,W
137567,22,BEL1,2022-10-02,St Truiden,Eupen,0,1,-1,L
137568,22,BEL1,2022-10-07,Antwerp,St Truiden,2,0,2,W
137569,22,BEL1,2022-10-08,Genk,Kortrijk,2,1,1,W
137570,22,BEL1,2022-10-08,RFC Seraing,Oostende,1,1,0,D
137571,22,BEL1,2022-10-08,Waregem,Oud-Heverlee Leuven,2,5,-3,L
137572,22,BEL1,2022-10-08,Club Brugge,Westerlo,0,2,-2,L
137573,22,BEL1,2022-10-09,Mechelen,Anderlecht,1,3,-2,L
137574,22,BEL1,2022-10-09,Eupen,Gent,0,4,-4,L
137575,22,BEL1,2022-10-09,Charleroi,Standard,0,1,-1,L
137576,22,BEL1,2022-10-09,Union Saint-Gilloise,Cercle Brugge,2,1,1,W
137577,22,BEL1,2022-10-14,Westerlo,RFC Seraing,2,2,0,D
137578,22,BEL1,2022-10-15,Kortrijk,Waregem,1,3,-2,L
137579,22,BEL1,2022-10-15,Cercle Brugge,Eupen,5,1,4,W
137580,22,BEL1,2022-10-15,St Truiden,Charleroi,2,1,1,W
137581,22,BEL1,2022-10-15,Oud-Heverlee Leuven,Genk,0,1,-1,L
137582,22,BEL1,2022-10-16,Standard,Antwerp,3,0,3,W
137583,22,BEL1,2022-10-16,Gent,Mechelen,3,0,3,W
137584,22,BEL1,2022-10-16,Anderlecht,Club Brugge,0,1,-1,L
137585,22,BEL1,2022-10-16,Oostende,Union Saint-Gilloise,1,6,-5,L
137586,22,BEL1,2022-10-18,Eupen,Oud-Heverlee Leuven,4,2,2,W
137587,22,BEL1,2022-10-18,Charleroi,Kortrijk,2,2,0,D
137588,22,BEL1,2022-10-18,Genk,Westerlo,6,1,5,W
137589,22,BEL1,2022-10-18,RFC Seraing,Cercle Brugge,0,1,-1,L
137590,22,BEL1,2022-10-19,Union Saint-Gilloise,Gent,2,0,2,W
137591,22,BEL1,2022-10-19,Club Brugge,St Truiden,3,0,3,W
137592,22,BEL1,2022-10-19,Mechelen,Standard,2,0,2,W
137593,22,BEL1,2022-10-20,Antwerp,Oostende,3,0,3,W
137594,22,BEL1,2022-10-20,Waregem,Anderlecht,3,2,1,W
137595,22,BEL1,2022-10-21,Cercle Brugge,Charleroi,4,1,3,W
137596,22,BEL1,2022-10-22,Kortrijk,Westerlo,0,2,-2,L
137597,22,BEL1,2022-10-22,Mechelen,Eupen,2,1,1,W
137598,22,BEL1,2022-10-22,St Truiden,Oud-Heverlee Leuven,0,0,0,D
137599,22,BEL1,2022-10-22,Union Saint-Gilloise,Club Brugge,2,2,0,D
137600,22,BEL1,2022-10-23,Antwerp,Genk,1,3,-2,L
137601,22,BEL1,2022-10-23,Gent,RFC Seraing,2,1,1,W
137602,22,BEL1,2022-10-23,Oostende,Waregem,2,1,1,W
137603,22,BEL1,2022-10-28,Genk,Mechelen,3,1,2,W
137604,22,BEL1,2022-10-29,Waregem,Standard,0,3,-3,L
137605,22,BEL1,2022-10-29,Kortrijk,Cercle Brugge,1,1,0,D
137606,22,BEL1,2022-10-29,Westerlo,St Truiden,2,3,-1,L
137607,22,BEL1,2022-10-29,Club Brugge,Oostende,4,2,2,W
137608,22,BEL1,2022-10-30,Anderlecht,Eupen,4,2,2,W
137609,22,BEL1,2022-10-30,RFC Seraing,Union Saint-Gilloise,1,2,-1,L
137610,22,BEL1,2022-10-30,Oud-Heverlee Leuven,Gent,1,1,0,D
137611,22,BEL1,2022-10-30,Charleroi,Antwerp,1,0,1,W
137612,22,BEL1,2022-11-04,Genk,Charleroi,4,1,3,W
137613,22,BEL1,2022-11-05,Mechelen,Waregem,2,2,0,D
137614,22,BEL1,2022-11-05,Cercle Brugge,Oud-Heverlee Leuven,2,1,1,W
137615,22,BEL1,2022-11-05,RFC Seraing,St Truiden,1,2,-1,L
137616,22,BEL1,2022-11-05,Eupen,Standard,2,0,2,W
137617,22,BEL1,2022-11-06,Gent,Club Brugge,2,0,2,W
137618,22,BEL1,2022-11-06,Union Saint-Gilloise,Westerlo,1,1,0,D
137619,22,BEL1,2022-11-06,Antwerp,Anderlecht,0,0,0,D
137620,22,BEL1,2022-11-06,Oostende,Kortrijk,3,1,2,W
137621,22,BEL1,2022-11-11,Oud-Heverlee Leuven,RFC Seraing,5,0,5,W
137622,22,BEL1,2022-11-12,Westerlo,Oostende,6,0,6,W
137623,22,BEL1,2022-11-12,Waregem,Eupen,5,5,0,D
137624,22,BEL1,2022-11-12,St Truiden,Cercle Brugge,0,1,-1,L
137625,22,BEL1,2022-11-13,Club Brugge,Antwerp,2,2,0,D
137626,22,BEL1,2022-11-13,Standard,Union Saint-Gilloise,2,3,-1,L
137627,22,BEL1,2022-11-13,Anderlecht,Genk,0,2,-2,L
137628,22,BEL1,2022-11-13,Kortrijk,Gent,0,4,-4,L
137629,22,BEL1,2022-12-23,RFC Seraing,Eupen,0,1,-1,L
137630,22,BEL1,2022-12-23,Gent,Standard,0,0,0,D
137631,22,BEL1,2022-12-23,Mechelen,Cercle Brugge,1,1,0,D
137632,22,BEL1,2022-12-26,Club Brugge,Oud-Heverlee Leuven,1,1,0,D
137633,22,BEL1,2022-12-26,Union Saint-Gilloise,Oostende,3,0,3,W
137634,22,BEL1,2022-12-26,Kortrijk,Genk,1,0,1,W
137635,22,BEL1,2022-12-26,Charleroi,Anderlecht,0,1,-1,L
137636,22,BEL1,2022-12-27,Westerlo,Antwerp,3,3,0,D
137637,22,BEL1,2022-12-27,St Truiden,Waregem,2,0,2,W
137638,22,BEL1,2023-01-06,Standard,St Truiden,1,1,0,D
137639,22,BEL1,2023-01-07,Eupen,Charleroi,1,2,-1,L
137640,22,BEL1,2023-01-07,Cercle Brugge,Westerlo,0,1,-1,L
137641,22,BEL1,2023-01-07,Oostende,RFC Seraing,1,2,-1,L
137642,22,BEL1,2023-01-07,Antwerp,Gent,2,0,2,W
137643,22,BEL1,2023-01-08,Genk,Club Brugge,3,1,2,W
137644,22,BEL1,2023-01-08,Waregem,Mechelen,2,0,2,W
137645,22,BEL1,2023-01-08,Anderlecht,Union Saint-Gilloise,1,3,-2,L
137646,22,BEL1,2023-01-08,Oud-Heverlee Leuven,Kortrijk,2,3,-1,L
137647,22,BEL1,2023-01-13,Westerlo,Oud-Heverlee Leuven,1,2,-1,L
137648,22,BEL1,2023-01-14,RFC Seraing,Standard,1,1,0,D
137649,22,BEL1,2023-01-14,Eupen,St Truiden,0,2,-2,L
137650,22,BEL1,2023-01-14,Mechelen,Oostende,2,1,1,W
137651,22,BEL1,2023-01-14,Genk,Waregem,1,0,1,W
137652,22,BEL1,2023-01-15,Club Brugge,Anderlecht,1,1,0,D
137653,22,BEL1,2023-01-15,Gent,Kortrijk,2,1,1,W
137654,22,BEL1,2023-01-15,Union Saint-Gilloise,Antwerp,2,0,2,W
137655,22,BEL1,2023-01-15,Charleroi,Cercle Brugge,2,1,1,W
137656,22,BEL1,2023-01-17,Oud-Heverlee Leuven,Eupen,1,1,0,D
137657,22,BEL1,2023-01-17,Westerlo,Genk,2,3,-1,L
137658,22,BEL1,2023-01-17,Standard,Mechelen,2,0,2,W
137659,22,BEL1,2023-01-18,Cercle Brugge,Union Saint-Gilloise,1,1,0,D
137660,22,BEL1,2023-01-18,Oostende,Antwerp,0,3,-3,L
137661,22,BEL1,2023-01-18,Kortrijk,RFC Seraing,3,2,1,W
137662,22,BEL1,2023-01-18,Anderlecht,Waregem,2,3,-1,L
137663,22,BEL1,2023-01-19,Gent,Charleroi,0,0,0,D
137664,22,BEL1,2023-01-19,St Truiden,Club Brugge,1,1,0,D
137665,22,BEL1,2023-01-21,Waregem,Westerlo,1,1,0,D
137666,22,BEL1,2023-01-21,Mechelen,Kortrijk,3,2,1,W
137667,22,BEL1,2023-01-21,Oostende,Cercle Brugge,1,2,-1,L
137668,22,BEL1,2023-01-21,Union Saint-Gilloise,Oud-Heverlee Leuven,1,0,1,W
137669,22,BEL1,2023-01-22,Antwerp,Standard,4,1,3,W
137670,22,BEL1,2023-01-22,RFC Seraing,Anderlecht,0,1,-1,L
137671,22,BEL1,2023-01-22,Club Brugge,Charleroi,2,2,0,D
137672,22,BEL1,2023-01-22,St Truiden,Gent,0,3,-3,L
137673,22,BEL1,2023-01-27,Standard,Eupen,3,1,2,W
137674,22,BEL1,2023-01-28,Westerlo,Mechelen,2,0,2,W
137675,22,BEL1,2023-01-28,Kortrijk,Oostende,2,2,0,D
137676,22,BEL1,2023-01-28,Oud-Heverlee Leuven,St Truiden,1,1,0,D
137677,22,BEL1,2023-01-28,Charleroi,Union Saint-Gilloise,0,1,-1,L
137678,22,BEL1,2023-01-29,Anderlecht,Antwerp,0,0,0,D
137679,22,BEL1,2023-01-29,Cercle Brugge,Gent,3,2,1,W
137680,22,BEL1,2023-01-29,Waregem,Club Brugge,1,2,-1,L
137681,22,BEL1,2023-01-29,Genk,RFC Seraing,4,0,4,W
137682,22,BEL1,2023-02-01,Eupen,Genk,1,1,0,D
137683,22,BEL1,2023-02-03,Oostende,Anderlecht,0,2,-2,L
137684,22,BEL1,2023-02-04,Cercle Brugge,Standard,1,1,0,D
137685,22,BEL1,2023-02-04,Eupen,Westerlo,1,1,0,D
137686,22,BEL1,2023-02-04,RFC Seraing,Oud-Heverlee Leuven,2,1,1,W
137687,22,BEL1,2023-02-04,St Truiden,Kortrijk,1,0,1,W
137688,22,BEL1,2023-02-05,Antwerp,Club Brugge,0,0,0,D
137689,22,BEL1,2023-02-05,Mechelen,Charleroi,2,2,0,D
137690,22,BEL1,2023-02-05,Gent,Genk,2,3,-1,L
137691,22,BEL1,2023-02-05,Union Saint-Gilloise,Waregem,4,0,4,W
137692,22,BEL1,2023-02-10,Oud-Heverlee Leuven,Cercle Brugge,0,0,0,D
137693,22,BEL1,2023-02-10,Club Brugge,Union Saint-Gilloise,1,1,0,D
137694,22,BEL1,2023-02-10,Eupen,Mechelen,2,1,1,W
137695,22,BEL1,2023-02-11,Westerlo,Gent,3,3,0,D
137696,22,BEL1,2023-02-11,Charleroi,RFC Seraing,3,0,3,W
137697,22,BEL1,2023-02-12,Genk,Antwerp,0,1,-1,L
137698,22,BEL1,2023-02-12,Anderlecht,St Truiden,3,1,2,W
137699,22,BEL1,2023-02-12,Standard,Kortrijk,0,2,-2,L
137700,22,BEL1,2023-02-12,Waregem,Oostende,1,1,0,D
137701,22,BEL1,2023-02-17,Mechelen,Genk,2,2,0,D
137702,22,BEL1,2023-02-18,Antwerp,Eupen,2,0,2,W
137703,22,BEL1,2023-02-18,Oostende,Charleroi,0,0,0,D
137704,22,BEL1,2023-02-18,RFC Seraing,Waregem,1,1,0,D
137705,22,BEL1,2023-02-18,Union Saint-Gilloise,Standard,2,4,-2,L
137706,22,BEL1,2023-02-19,Cercle Brugge,Club Brugge,2,2,0,D
137707,22,BEL1,2023-02-19,Gent,Oud-Heverlee Leuven,2,0,2,W
137708,22,BEL1,2023-02-19,Kortrijk,Anderlecht,2,2,0,D
137709,22,BEL1,2023-02-19,St Truiden,Westerlo,0,1,-1,L
137710,22,BEL1,2023-02-24,Waregem,Kortrijk,3,3,0,D
137711,22,BEL1,2023-02-25,RFC Seraing,Mechelen,0,2,-2,L
137712,22,BEL1,2023-02-25,Eupen,Cercle Brugge,2,2,0,D
137713,22,BEL1,2023-02-25,Genk,Oostende,3,0,3,W
137714,22,BEL1,2023-02-25,Westerlo,Union Saint-Gilloise,4,2,2,W
137715,22,BEL1,2023-02-26,Club Brugge,Gent,2,0,2,W
137716,22,BEL1,2023-02-26,Oud-Heverlee Leuven,Antwerp,1,1,0,D
137717,22,BEL1,2023-02-26,Anderlecht,Standard,2,2,0,D
137718,22,BEL1,2023-02-26,Charleroi,St Truiden,1,0,1,W
137719,22,BEL1,2023-03-03,Oostende,Club Brugge,3,0,3,W
137720,22,BEL1,2023-03-04,Kortrijk,Charleroi,0,1,-1,L
137721,22,BEL1,2023-03-04,Cercle Brugge,RFC Seraing,3,1,2,W
137722,22,BEL1,2023-03-04,Oud-Heverlee Leuven,Waregem,4,2,2,W
137723,22,BEL1,2023-03-04,Standard,Westerlo,2,0,2,W
137724,22,BEL1,2023-03-05,St Truiden,Genk,2,2,0,D
137725,22,BEL1,2023-03-05,Antwerp,Mechelen,5,0,5,W
137726,22,BEL1,2023-03-05,Gent,Anderlecht,1,0,1,W
137727,22,BEL1,2023-03-05,Union Saint-Gilloise,Eupen,2,1,1,W
137728,22,BEL1,2023-03-10,Charleroi,Oud-Heverlee Leuven,0,1,-1,L
137729,22,BEL1,2023-03-11,Mechelen,St Truiden,1,0,1,W
137730,22,BEL1,2023-03-11,Eupen,Oostende,4,4,0,D
137731,22,BEL1,2023-03-11,Westerlo,Kortrijk,3,1,2,W
137732,22,BEL1,2023-03-11,RFC Seraing,Antwerp,0,2,-2,L
137733,22,BEL1,2023-03-12,Club Brugge,Standard,2,0,2,W
137734,22,BEL1,2023-03-12,Waregem,Gent,2,6,-4,L
137735,22,BEL1,2023-03-12,Genk,Union Saint-Gilloise,1,2,-1,L
137736,22,BEL1,2023-03-12,Anderlecht,Cercle Brugge,2,0,2,W
137737,22,BEL1,2023-03-17,Cercle Brugge,Genk,1,1,0,D
137738,22,BEL1,2023-03-18,Kortrijk,Club Brugge,1,0,1,W
137739,22,BEL1,2023-03-18,Oostende,Westerlo,1,2,-1,L
137740,22,BEL1,2023-03-18,St Truiden,RFC Seraing,2,1,1,W
137741,22,BEL1,2023-03-18,Standard,Waregem,2,2,0,D
137742,22,BEL1,2023-03-19,Antwerp,Charleroi,0,1,-1,L
137743,22,BEL1,2023-03-19,Oud-Heverlee Leuven,Anderlecht,0,2,-2,L
137744,22,BEL1,2023-03-19,Union Saint-Gilloise,Mechelen,2,1,1,W
137745,22,BEL1,2023-03-19,Gent,Eupen,3,0,3,W
137746,22,BEL1,2023-03-31,Waregem,Antwerp,0,2,-2,L
137747,22,BEL1,2023-04-01,Cercle Brugge,Kortrijk,2,0,2,W
137748,22,BEL1,2023-04-01,Westerlo,Charleroi,2,3,-1,L
137749,22,BEL1,2023-04-01,RFC Seraing,Gent,0,5,-5,L
137750,22,BEL1,2023-04-01,Oostende,Standard,1,3,-2,L
137751,22,BEL1,2023-04-02,Genk,Oud-Heverlee Leuven,2,1,1,W
137752,22,BEL1,2023-04-02,Eupen,Anderlecht,0,1,-1,L
137753,22,BEL1,2023-04-02,Mechelen,Club Brugge,0,3,-3,L
137754,22,BEL1,2023-04-02,Union Saint-Gilloise,St Truiden,2,1,1,W
