,Sea,Lge,Date,HT,AT,HS,AS,GD,WDL
183366,0,DNK1,2000-07-22,Brondby,Aarhus,1,2,-1,L
183367,0,DNK1,2000-07-23,Akademisk,Silkeborg,1,1,0,D
183368,0,DNK1,2000-07-23,FC Kobenhavn,SonderjyskE,5,1,4,W
183369,0,DNK1,2000-07-23,Midtjylland,Lyngby,4,0,4,W
183370,0,DNK1,2000-07-24,Odense,Viborg,0,1,-1,L
183371,0,DNK1,2000-07-26,Herfolge,Aalborg,2,3,-1,L
183372,0,DNK1,2000-07-29,Brondby,Odense,0,0,0,D
183373,0,DNK1,2000-07-30,Aarhus,FC Kobenhavn,1,0,1,W
183374,0,DNK1,2000-07-30,SonderjyskE,Aalborg,1,2,-1,L
183375,0,DNK1,2000-07-30,Lyngby,Herfolge,3,1,2,W
183376,0,DNK1,2000-07-30,Viborg,Akademisk,1,1,0,D
183377,0,DNK1,2000-07-31,Silkeborg,Midtjylland,2,1,1,W
183378,0,DNK1,2000-08-04,Herfolge,Viborg,1,5,-4,L
183379,0,DNK1,2000-08-05,Midtjylland,Brondby,2,2,0,D
183380,0,DNK1,2000-08-06,Akademisk,SonderjyskE,4,0,4,W
183381,0,DNK1,2000-08-06,Odense,Aarhus,4,0,4,W
183382,0,DNK1,2000-08-06,FC Kobenhavn,Lyngby,1,2,-1,L
183383,0,DNK1,2000-08-07,Aalborg,Silkeborg,1,2,-1,L
183384,0,DNK1,2000-08-13,Aalborg,Akademisk,2,2,0,D
183385,0,DNK1,2000-08-13,Aarhus,Midtjylland,3,0,3,W
183386,0,DNK1,2000-08-13,SonderjyskE,Herfolge,1,2,-1,L
183387,0,DNK1,2000-08-13,Lyngby,Odense,0,2,-2,L
183388,0,DNK1,2000-08-13,Silkeborg,Brondby,1,7,-6,L
183389,0,DNK1,2000-08-13,Viborg,FC Kobenhavn,0,0,0,D
183390,0,DNK1,2000-08-19,Brondby,Herfolge,5,0,5,W
183391,0,DNK1,2000-08-20,Aarhus,Akademisk,1,3,-2,L
183392,0,DNK1,2000-08-20,Silkeborg,Odense,2,1,1,W
183393,0,DNK1,2000-08-20,Viborg,SonderjyskE,2,1,1,W
183394,0,DNK1,2000-08-20,Lyngby,Aalborg,2,1,1,W
183395,0,DNK1,2000-08-21,Midtjylland,FC Kobenhavn,1,0,1,W
183396,0,DNK1,2000-08-27,Aalborg,Viborg,1,0,1,W
183397,0,DNK1,2000-08-27,SonderjyskE,Silkeborg,1,1,0,D
183398,0,DNK1,2000-08-27,Herfolge,Aarhus,3,1,2,W
183399,0,DNK1,2000-08-27,Odense,Midtjylland,1,2,-1,L
183400,0,DNK1,2000-08-27,FC Kobenhavn,Brondby,2,1,1,W
183401,0,DNK1,2000-08-28,Akademisk,Lyngby,0,1,-1,L
183402,0,DNK1,2000-09-06,Aarhus,Lyngby,1,4,-3,L
183403,0,DNK1,2000-09-06,Brondby,Viborg,2,0,2,W
183404,0,DNK1,2000-09-06,Herfolge,Silkeborg,0,0,0,D
183405,0,DNK1,2000-09-06,Midtjylland,SonderjyskE,5,1,4,W
183406,0,DNK1,2000-09-06,Odense,Aalborg,2,0,2,W
183407,0,DNK1,2000-09-06,FC Kobenhavn,Akademisk,1,0,1,W
183408,0,DNK1,2000-09-10,Akademisk,Herfolge,1,3,-2,L
183409,0,DNK1,2000-09-10,SonderjyskE,Odense,1,4,-3,L
183410,0,DNK1,2000-09-10,Lyngby,Brondby,1,3,-2,L
183411,0,DNK1,2000-09-10,Silkeborg,Aarhus,2,1,1,W
183412,0,DNK1,2000-09-10,Viborg,Midtjylland,0,0,0,D
183413,0,DNK1,2000-09-11,Aalborg,FC Kobenhavn,1,2,-1,L
183414,0,DNK1,2000-09-17,Aalborg,Aarhus,2,1,1,W
183415,0,DNK1,2000-09-17,SonderjyskE,Lyngby,2,4,-2,L
183416,0,DNK1,2000-09-17,Herfolge,Midtjylland,0,1,-1,L
183417,0,DNK1,2000-09-17,FC Kobenhavn,Odense,1,0,1,W
183418,0,DNK1,2000-09-17,Viborg,Silkeborg,1,1,0,D
183419,0,DNK1,2000-09-18,Akademisk,Brondby,0,4,-4,L
183420,0,DNK1,2000-09-22,Lyngby,Viborg,1,0,1,W
183421,0,DNK1,2000-09-24,Brondby,Aalborg,2,1,1,W
183422,0,DNK1,2000-09-24,Midtjylland,Akademisk,1,1,0,D
183423,0,DNK1,2000-09-24,Odense,Herfolge,3,1,2,W
183424,0,DNK1,2000-09-24,Silkeborg,FC Kobenhavn,0,0,0,D
183425,0,DNK1,2000-09-25,Aarhus,SonderjyskE,1,1,0,D
183426,0,DNK1,2000-10-01,Aalborg,Midtjylland,1,2,-1,L
183427,0,DNK1,2000-10-01,Brondby,SonderjyskE,6,1,5,W
183428,0,DNK1,2000-10-01,Akademisk,Odense,3,1,2,W
183429,0,DNK1,2000-10-01,Silkeborg,Lyngby,3,0,3,W
183430,0,DNK1,2000-10-01,Viborg,Aarhus,2,0,2,W
183431,0,DNK1,2000-10-02,Herfolge,FC Kobenhavn,0,2,-2,L
183432,0,DNK1,2000-10-15,Aalborg,Herfolge,2,2,0,D
183433,0,DNK1,2000-10-15,Akademisk,Silkeborg,0,1,-1,L
183434,0,DNK1,2000-10-15,SonderjyskE,Viborg,0,4,-4,L
183435,0,DNK1,2000-10-15,FC Kobenhavn,Aarhus,4,0,4,W
183436,0,DNK1,2000-10-15,Lyngby,Brondby,3,0,3,W
183437,0,DNK1,2000-10-16,Odense,Midtjylland,1,2,-1,L
183438,0,DNK1,2000-10-22,Aarhus,Lyngby,5,2,3,W
183439,0,DNK1,2000-10-22,Brondby,Akademisk,4,2,2,W
183440,0,DNK1,2000-10-22,Herfolge,Odense,1,1,0,D
183441,0,DNK1,2000-10-22,Silkeborg,SonderjyskE,0,0,0,D
183442,0,DNK1,2000-10-22,Viborg,Aalborg,1,2,-1,L
183443,0,DNK1,2000-10-23,Midtjylland,FC Kobenhavn,2,2,0,D
183444,0,DNK1,2000-10-29,Aalborg,Silkeborg,4,4,0,D
183445,0,DNK1,2000-10-29,SonderjyskE,Akademisk,1,1,0,D
183446,0,DNK1,2000-10-29,Odense,Viborg,2,1,1,W
183447,0,DNK1,2000-10-29,FC Kobenhavn,Herfolge,1,1,0,D
183448,0,DNK1,2000-10-29,Aarhus,Brondby,2,0,2,W
183449,0,DNK1,2000-10-30,Lyngby,Midtjylland,1,1,0,D
183450,0,DNK1,2000-11-03,Herfolge,Lyngby,2,3,-1,L
183451,0,DNK1,2000-11-05,Brondby,SonderjyskE,4,2,2,W
183452,0,DNK1,2000-11-05,Akademisk,Aalborg,1,1,0,D
183453,0,DNK1,2000-11-05,Midtjylland,Aarhus,1,4,-3,L
183454,0,DNK1,2000-11-05,Viborg,FC Kobenhavn,2,1,1,W
183455,0,DNK1,2000-11-06,Silkeborg,Odense,0,1,-1,L
183456,0,DNK1,2000-11-12,Aalborg,SonderjyskE,1,0,1,W
183457,0,DNK1,2000-11-12,Aarhus,Herfolge,1,1,0,D
183458,0,DNK1,2000-11-12,Midtjylland,Brondby,1,1,0,D
183459,0,DNK1,2000-11-12,Lyngby,Viborg,0,2,-2,L
183460,0,DNK1,2000-11-12,Odense,Akademisk,2,1,1,W
183461,0,DNK1,2000-11-12,FC Kobenhavn,Silkeborg,2,2,0,D
183462,0,DNK1,2000-11-19,Brondby,Aalborg,2,0,2,W
183463,0,DNK1,2000-11-19,SonderjyskE,Odense,4,2,2,W
183464,0,DNK1,2000-11-19,Herfolge,Midtjylland,0,2,-2,L
183465,0,DNK1,2000-11-19,Silkeborg,Lyngby,3,1,2,W
183466,0,DNK1,2000-11-19,Viborg,Aarhus,4,2,2,W
183467,0,DNK1,2000-11-20,Akademisk,FC Kobenhavn,2,2,0,D
183468,0,DNK1,2000-11-26,Aarhus,Silkeborg,1,2,-1,L
183469,0,DNK1,2000-11-26,Midtjylland,Viborg,3,5,-2,L
183470,0,DNK1,2000-11-26,Lyngby,Akademisk,2,1,1,W
183471,0,DNK1,2000-11-26,Odense,Aalborg,2,3,-1,L
183472,0,DNK1,2000-11-26,FC Kobenhavn,SonderjyskE,4,0,4,W
183473,0,DNK1,2000-11-27,Herfolge,Brondby,3,2,1,W
183474,0,DNK1,2001-03-11,FC Kobenhavn,Aalborg,1,1,0,D
183475,0,DNK1,2001-03-11,Brondby,Odense,1,2,-1,L
183476,0,DNK1,2001-03-11,SonderjyskE,Lyngby,1,3,-2,L
183477,0,DNK1,2001-03-11,Silkeborg,Midtjylland,3,1,2,W
183478,0,DNK1,2001-03-11,Viborg,Herfolge,3,0,3,W
183479,0,DNK1,2001-03-12,Akademisk,Aarhus,2,0,2,W
183480,0,DNK1,2001-03-18,Aarhus,SonderjyskE,1,0,1,W
183481,0,DNK1,2001-03-18,Herfolge,Silkeborg,0,2,-2,L
183482,0,DNK1,2001-03-18,Lyngby,Aalborg,0,0,0,D
183483,0,DNK1,2001-03-18,FC Kobenhavn,Odense,2,1,1,W
183484,0,DNK1,2001-03-18,Viborg,Brondby,1,3,-2,L
183485,0,DNK1,2001-03-19,Midtjylland,Akademisk,4,2,2,W
183486,0,DNK1,2001-04-01,Aalborg,Aarhus,5,1,4,W
183487,0,DNK1,2001-04-01,Akademisk,Herfolge,0,0,0,D
183488,0,DNK1,2001-04-01,SonderjyskE,Midtjylland,2,3,-1,L
183489,0,DNK1,2001-04-01,Odense,Lyngby,1,1,0,D
183490,0,DNK1,2001-04-01,Brondby,FC Kobenhavn,1,2,-1,L
183491,0,DNK1,2001-04-02,Silkeborg,Viborg,2,0,2,W
183492,0,DNK1,2001-04-08,Aarhus,Odense,4,1,3,W
183493,0,DNK1,2001-04-08,Brondby,Silkeborg,1,0,1,W
183494,0,DNK1,2001-04-08,Herfolge,SonderjyskE,3,0,3,W
183495,0,DNK1,2001-04-08,Midtjylland,Aalborg,1,0,1,W
183496,0,DNK1,2001-04-08,Viborg,Akademisk,0,0,0,D
183497,0,DNK1,2001-04-09,Lyngby,FC Kobenhavn,0,0,0,D
183498,0,DNK1,2001-04-12,Aarhus,Akademisk,0,0,0,D
183499,0,DNK1,2001-04-12,Herfolge,Viborg,1,1,0,D
183500,0,DNK1,2001-04-12,Midtjylland,Silkeborg,0,0,0,D
183501,0,DNK1,2001-04-12,Lyngby,SonderjyskE,1,1,0,D
183502,0,DNK1,2001-04-12,Aalborg,FC Kobenhavn,1,1,0,D
183503,0,DNK1,2001-04-12,Odense,Brondby,1,2,-1,L
183504,0,DNK1,2001-04-16,Aalborg,Odense,1,1,0,D
183505,0,DNK1,2001-04-16,Brondby,Herfolge,2,2,0,D
183506,0,DNK1,2001-04-16,Akademisk,Lyngby,4,0,4,W
183507,0,DNK1,2001-04-16,SonderjyskE,FC Kobenhavn,1,2,-1,L
183508,0,DNK1,2001-04-16,Silkeborg,Aarhus,2,2,0,D
183509,0,DNK1,2001-04-16,Viborg,Midtjylland,1,2,-1,L
183510,0,DNK1,2001-04-22,Aalborg,Brondby,2,2,0,D
183511,0,DNK1,2001-04-22,Aarhus,Viborg,3,4,-1,L
183512,0,DNK1,2001-04-22,Midtjylland,Herfolge,2,0,2,W
183513,0,DNK1,2001-04-22,Lyngby,Silkeborg,0,2,-2,L
183514,0,DNK1,2001-04-22,Odense,SonderjyskE,3,1,2,W
183515,0,DNK1,2001-04-22,FC Kobenhavn,Akademisk,0,0,0,D
183516,0,DNK1,2001-04-29,Brondby,Midtjylland,1,1,0,D
183517,0,DNK1,2001-04-29,Akademisk,Odense,0,0,0,D
183518,0,DNK1,2001-04-29,SonderjyskE,Aalborg,1,1,0,D
183519,0,DNK1,2001-04-29,Herfolge,Aarhus,1,2,-1,L
183520,0,DNK1,2001-04-29,Viborg,Lyngby,3,0,3,W
183521,0,DNK1,2001-04-30,Silkeborg,FC Kobenhavn,1,1,0,D
183522,0,DNK1,2001-05-06,Aalborg,Akademisk,4,1,3,W
183523,0,DNK1,2001-05-06,SonderjyskE,Brondby,0,4,-4,L
183524,0,DNK1,2001-05-06,Odense,Silkeborg,1,0,1,W
183525,0,DNK1,2001-05-06,FC Kobenhavn,Viborg,1,0,1,W
183526,0,DNK1,2001-05-07,Aarhus,Midtjylland,2,0,2,W
183527,0,DNK1,2001-05-09,Lyngby,Herfolge,1,1,0,D
183528,0,DNK1,2001-05-13,Brondby,Aarhus,2,1,1,W
183529,0,DNK1,2001-05-13,Akademisk,SonderjyskE,1,1,0,D
183530,0,DNK1,2001-05-13,Herfolge,FC Kobenhavn,3,4,-1,L
183531,0,DNK1,2001-05-13,Midtjylland,Lyngby,0,0,0,D
183532,0,DNK1,2001-05-13,Viborg,Odense,1,1,0,D
183533,0,DNK1,2001-05-14,Silkeborg,Aalborg,3,0,3,W
183534,0,DNK1,2001-05-17,Aalborg,Viborg,2,1,1,W
183535,0,DNK1,2001-05-17,SonderjyskE,Silkeborg,0,1,-1,L
183536,0,DNK1,2001-05-17,Lyngby,Aarhus,0,1,-1,L
183537,0,DNK1,2001-05-17,Odense,Herfolge,4,2,2,W
183538,0,DNK1,2001-05-17,FC Kobenhavn,Midtjylland,3,0,3,W
183539,0,DNK1,2001-05-17,Akademisk,Brondby,1,1,0,D
183540,0,DNK1,2001-05-20,Aarhus,FC Kobenhavn,0,3,-3,L
183541,0,DNK1,2001-05-20,Herfolge,Aalborg,1,2,-1,L
183542,0,DNK1,2001-05-20,Midtjylland,Odense,1,1,0,D
183543,0,DNK1,2001-05-20,Silkeborg,Akademisk,1,2,-1,L
183544,0,DNK1,2001-05-20,Viborg,SonderjyskE,3,1,2,W
183545,0,DNK1,2001-05-21,Brondby,Lyngby,1,2,-1,L
183546,0,DNK1,2001-05-27,Aalborg,Midtjylland,2,1,1,W
183547,0,DNK1,2001-05-27,Akademisk,Viborg,2,0,2,W
183548,0,DNK1,2001-05-27,SonderjyskE,Herfolge,1,2,-1,L
183549,0,DNK1,2001-05-27,Odense,Aarhus,0,4,-4,L
183550,0,DNK1,2001-05-27,FC Kobenhavn,Lyngby,1,1,0,D
183551,0,DNK1,2001-05-27,Silkeborg,Brondby,0,1,-1,L
183552,0,DNK1,2001-06-10,Aarhus,Aalborg,4,0,4,W
183553,0,DNK1,2001-06-10,Herfolge,Akademisk,0,3,-3,L
183554,0,DNK1,2001-06-10,Midtjylland,SonderjyskE,6,0,6,W
183555,0,DNK1,2001-06-10,Lyngby,Odense,1,3,-2,L
183556,0,DNK1,2001-06-10,FC Kobenhavn,Brondby,3,1,2,W
183557,0,DNK1,2001-06-10,Viborg,Silkeborg,2,4,-2,L
183558,0,DNK1,2001-06-13,Aalborg,Lyngby,2,0,2,W
183559,0,DNK1,2001-06-13,Brondby,Viborg,2,1,1,W
183560,0,DNK1,2001-06-13,Akademisk,Midtjylland,1,1,0,D
183561,0,DNK1,2001-06-13,SonderjyskE,Aarhus,2,2,0,D
183562,0,DNK1,2001-06-13,Odense,FC Kobenhavn,0,1,-1,L
183563,0,DNK1,2001-06-13,Silkeborg,Herfolge,1,2,-1,L
183564,1,DNK1,2001-07-21,FC Kobenhavn,Viborg,2,1,1,W
183565,1,DNK1,2001-07-22,Brondby,Aarhus,5,0,5,W
183566,1,DNK1,2001-07-22,Silkeborg,Akademisk,1,1,0,D
183567,1,DNK1,2001-07-22,Vejle,Lyngby,2,2,0,D
183568,1,DNK1,2001-07-23,Aalborg,Midtjylland,2,1,1,W
183569,1,DNK1,2001-07-29,FC Kobenhavn,Vejle,4,1,3,W
183570,1,DNK1,2001-07-29,Lyngby,Esbjerg fB,2,0,2,W
183571,1,DNK1,2001-07-29,Akademisk,Brondby,1,3,-2,L
183572,1,DNK1,2001-07-29,Aarhus,Aalborg,1,3,-2,L
183573,1,DNK1,2001-07-29,Midtjylland,Viborg,1,1,0,D
183574,1,DNK1,2001-07-30,Odense,Silkeborg,3,1,2,W
183575,1,DNK1,2001-08-05,Midtjylland,FC Kobenhavn,0,0,0,D
183576,1,DNK1,2001-08-05,Viborg,Aarhus,0,0,0,D
183577,1,DNK1,2001-08-05,Aalborg,Akademisk,0,2,-2,L
183578,1,DNK1,2001-08-05,Brondby,Odense,2,0,2,W
183579,1,DNK1,2001-08-05,Esbjerg fB,Vejle,1,1,0,D
183580,1,DNK1,2001-08-06,Silkeborg,Lyngby,0,0,0,D
183581,1,DNK1,2001-08-12,Aarhus,Midtjylland,0,1,-1,L
183582,1,DNK1,2001-08-12,Vejle,Silkeborg,3,0,3,W
183583,1,DNK1,2001-08-12,Lyngby,Brondby,1,0,1,W
183584,1,DNK1,2001-08-12,Odense,Aalborg,0,2,-2,L
183585,1,DNK1,2001-08-12,Akademisk,Viborg,1,2,-1,L
183586,1,DNK1,2001-08-12,Esbjerg fB,FC Kobenhavn,2,1,1,W
183587,1,DNK1,2001-08-17,FC Kobenhavn,Akademisk,0,2,-2,L
183588,1,DNK1,2001-08-19,Aarhus,Odense,0,1,-1,L
183589,1,DNK1,2001-08-19,Midtjylland,Lyngby,0,0,0,D
183590,1,DNK1,2001-08-19,Viborg,Vejle,1,2,-1,L
183591,1,DNK1,2001-08-19,Brondby,Silkeborg,4,0,4,W
183592,1,DNK1,2001-08-20,Aalborg,Esbjerg fB,2,1,1,W
183593,1,DNK1,2001-08-26,Odense,Midtjylland,0,2,-2,L
183594,1,DNK1,2001-08-26,Akademisk,Aarhus,0,0,0,D
183595,1,DNK1,2001-08-26,Esbjerg fB,Brondby,0,7,-7,L
183596,1,DNK1,2001-08-26,Vejle,Aalborg,1,3,-2,L
183597,1,DNK1,2001-08-26,Lyngby,Viborg,2,2,0,D
183598,1,DNK1,2001-08-26,Silkeborg,FC Kobenhavn,0,2,-2,L
183599,1,DNK1,2001-09-09,FC Kobenhavn,Odense,1,1,0,D
183600,1,DNK1,2001-09-09,Akademisk,Lyngby,3,1,2,W
183601,1,DNK1,2001-09-09,Midtjylland,Esbjerg fB,0,2,-2,L
183602,1,DNK1,2001-09-09,Aalborg,Brondby,1,3,-2,L
183603,1,DNK1,2001-09-09,Viborg,Silkeborg,2,0,2,W
183604,1,DNK1,2001-09-10,Aarhus,Vejle,3,0,3,W
183605,1,DNK1,2001-09-12,Esbjerg fB,Odense,2,0,2,W
183606,1,DNK1,2001-09-16,Vejle,Midtjylland,1,1,0,D
183607,1,DNK1,2001-09-16,Odense,Akademisk,2,2,0,D
183608,1,DNK1,2001-09-16,Silkeborg,Aalborg,1,2,-1,L
183609,1,DNK1,2001-09-16,Viborg,Esbjerg fB,0,2,-2,L
183610,1,DNK1,2001-09-16,Brondby,FC Kobenhavn,2,0,2,W
183611,1,DNK1,2001-09-17,Lyngby,Aarhus,1,1,0,D
183612,1,DNK1,2001-09-23,Silkeborg,Midtjylland,0,1,-1,L
183613,1,DNK1,2001-09-23,Vejle,Akademisk,1,1,0,D
183614,1,DNK1,2001-09-23,Lyngby,Odense,2,2,0,D
183615,1,DNK1,2001-09-23,Brondby,Viborg,0,0,0,D
183616,1,DNK1,2001-09-23,Aalborg,FC Kobenhavn,1,1,0,D
183617,1,DNK1,2001-09-24,Esbjerg fB,Aarhus,4,1,3,W
183618,1,DNK1,2001-09-30,FC Kobenhavn,Lyngby,1,0,1,W
183619,1,DNK1,2001-09-30,Odense,Vejle,5,1,4,W
183620,1,DNK1,2001-09-30,Akademisk,Esbjerg fB,2,0,2,W
183621,1,DNK1,2001-09-30,Aarhus,Silkeborg,2,2,0,D
183622,1,DNK1,2001-09-30,Midtjylland,Brondby,1,1,0,D
183623,1,DNK1,2001-09-30,Viborg,Aalborg,2,3,-1,L
183624,1,DNK1,2001-10-10,FC Kobenhavn,Aarhus,3,0,3,W
183625,1,DNK1,2001-10-10,Midtjylland,Akademisk,2,2,0,D
183626,1,DNK1,2001-10-10,Viborg,Odense,2,2,0,D
183627,1,DNK1,2001-10-10,Aalborg,Lyngby,2,1,1,W
183628,1,DNK1,2001-10-10,Brondby,Vejle,2,1,1,W
183629,1,DNK1,2001-10-10,Silkeborg,Esbjerg fB,3,4,-1,L
183630,1,DNK1,2001-10-14,Silkeborg,FC Kobenhavn,0,1,-1,L
183631,1,DNK1,2001-10-14,Esbjerg fB,Odense,2,0,2,W
183632,1,DNK1,2001-10-14,Aarhus,Akademisk,1,1,0,D
183633,1,DNK1,2001-10-14,Lyngby,Midtjylland,0,4,-4,L
183634,1,DNK1,2001-10-14,Brondby,Aalborg,0,0,0,D
183635,1,DNK1,2001-10-21,Midtjylland,Brondby,1,3,-2,L
183636,1,DNK1,2001-10-21,Akademisk,Vejle,4,0,4,W
183637,1,DNK1,2001-10-21,Viborg,Esbjerg fB,0,1,-1,L
183638,1,DNK1,2001-10-21,Odense,Silkeborg,2,1,1,W
183639,1,DNK1,2001-10-21,FC Kobenhavn,Lyngby,4,1,3,W
183640,1,DNK1,2001-10-22,Aalborg,Aarhus,1,4,-3,L
183641,1,DNK1,2001-10-28,Vejle,Aalborg,4,2,2,W
183642,1,DNK1,2001-10-28,Aarhus,Brondby,1,2,-1,L
183643,1,DNK1,2001-10-28,Lyngby,Odense,2,3,-1,L
183644,1,DNK1,2001-10-28,Silkeborg,Viborg,1,1,0,D
183645,1,DNK1,2001-10-28,FC Kobenhavn,Midtjylland,1,1,0,D
183646,1,DNK1,2001-10-29,Esbjerg fB,Akademisk,1,2,-1,L
183647,1,DNK1,2001-11-04,Midtjylland,Aarhus,2,0,2,W
183648,1,DNK1,2001-11-04,Brondby,Vejle,6,1,5,W
183649,1,DNK1,2001-11-04,Akademisk,Silkeborg,1,0,1,W
183650,1,DNK1,2001-11-04,Viborg,Lyngby,1,1,0,D
183651,1,DNK1,2001-11-04,Odense,FC Kobenhavn,1,1,0,D
183652,1,DNK1,2001-11-05,Aalborg,Esbjerg fB,0,0,0,D
183653,1,DNK1,2001-11-12,Vejle,Viborg,1,2,-1,L
183654,1,DNK1,2001-11-18,Silkeborg,Aalborg,2,0,2,W
183655,1,DNK1,2001-11-18,Esbjerg fB,Brondby,0,2,-2,L
183656,1,DNK1,2001-11-18,Vejle,Aarhus,0,3,-3,L
183657,1,DNK1,2001-11-18,FC Kobenhavn,Viborg,2,1,1,W
183658,1,DNK1,2001-11-18,Lyngby,Akademisk,0,1,-1,L
183659,1,DNK1,2001-11-19,Odense,Midtjylland,2,1,1,W
183660,1,DNK1,2001-11-25,Midtjylland,Vejle,5,0,5,W
183661,1,DNK1,2001-11-25,Brondby,Silkeborg,0,1,-1,L
183662,1,DNK1,2001-11-25,Aalborg,Lyngby,4,0,4,W
183663,1,DNK1,2001-11-25,Akademisk,FC Kobenhavn,2,2,0,D
183664,1,DNK1,2001-11-25,Viborg,Odense,1,1,0,D
183665,1,DNK1,2001-11-26,Aarhus,Esbjerg fB,1,6,-5,L
183666,1,DNK1,2001-12-01,FC Kobenhavn,Aalborg,3,0,3,W
183667,1,DNK1,2001-12-02,Esbjerg fB,Vejle,0,2,-2,L
183668,1,DNK1,2001-12-02,Odense,Akademisk,2,2,0,D
183669,1,DNK1,2001-12-02,Viborg,Midtjylland,2,1,1,W
183670,1,DNK1,2001-12-02,Lyngby,Brondby,2,2,0,D
183671,1,DNK1,2001-12-03,Silkeborg,Aarhus,1,0,1,W
183672,1,DNK1,2001-12-09,Midtjylland,Esbjerg fB,1,1,0,D
183673,1,DNK1,2001-12-09,Vejle,Silkeborg,0,4,-4,L
183674,1,DNK1,2001-12-09,Aarhus,Lyngby,7,0,7,W
183675,1,DNK1,2001-12-09,Brondby,FC Kobenhavn,1,0,1,W
183676,1,DNK1,2001-12-09,Akademisk,Viborg,1,2,-1,L
183677,1,DNK1,2001-12-10,Aalborg,Odense,1,1,0,D
183678,1,DNK1,2002-03-03,FC Kobenhavn,Aarhus,0,0,0,D
183679,1,DNK1,2002-03-03,Lyngby,Vejle,2,5,-3,L
183680,1,DNK1,2002-03-03,Odense,Brondby,4,3,1,W
183681,1,DNK1,2002-03-04,Viborg,Aalborg,0,1,-1,L
183682,1,DNK1,2002-03-10,Midtjylland,Silkeborg,1,0,1,W
183683,1,DNK1,2002-03-10,Esbjerg fB,Lyngby,5,0,5,W
183684,1,DNK1,2002-03-10,Vejle,FC Kobenhavn,1,3,-2,L
183685,1,DNK1,2002-03-10,Aarhus,Odense,1,3,-2,L
183686,1,DNK1,2002-03-10,Brondby,Viborg,2,2,0,D
183687,1,DNK1,2002-03-11,Aalborg,Akademisk,2,1,1,W
183688,1,DNK1,2002-03-13,Silkeborg,Esbjerg fB,0,0,0,D
183689,1,DNK1,2002-03-14,Akademisk,Midtjylland,0,1,-1,L
183690,1,DNK1,2002-03-17,Akademisk,Brondby,1,2,-1,L
183691,1,DNK1,2002-03-17,Viborg,Aarhus,0,0,0,D
183692,1,DNK1,2002-03-17,Odense,Vejle,1,0,1,W
183693,1,DNK1,2002-03-17,FC Kobenhavn,Esbjerg fB,6,0,6,W
183694,1,DNK1,2002-03-17,Lyngby,Silkeborg,0,5,-5,L
183695,1,DNK1,2002-03-18,Midtjylland,Aalborg,0,1,-1,L
183696,1,DNK1,2002-03-24,Vejle,Midtjylland,0,0,0,D
183697,1,DNK1,2002-03-24,Esbjerg fB,Aarhus,2,0,2,W
183698,1,DNK1,2002-03-24,Silkeborg,Brondby,1,2,-1,L
183699,1,DNK1,2002-03-24,Lyngby,Aalborg,0,7,-7,L
183700,1,DNK1,2002-03-24,FC Kobenhavn,Akademisk,0,0,0,D
183701,1,DNK1,2002-03-24,Odense,Viborg,0,1,-1,L
183702,1,DNK1,2002-04-01,Aalborg,Silkeborg,0,2,-2,L
183703,1,DNK1,2002-04-01,Brondby,Esbjerg fB,1,0,1,W
183704,1,DNK1,2002-04-01,Aarhus,Vejle,0,0,0,D
183705,1,DNK1,2002-04-01,Viborg,FC Kobenhavn,0,2,-2,L
183706,1,DNK1,2002-04-01,Akademisk,Lyngby,3,0,3,W
183707,1,DNK1,2002-04-01,Midtjylland,Odense,0,1,-1,L
183708,1,DNK1,2002-04-07,Aarhus,Midtjylland,2,3,-1,L
183709,1,DNK1,2002-04-07,Vejle,Brondby,1,1,0,D
183710,1,DNK1,2002-04-07,Esbjerg fB,Aalborg,0,1,-1,L
183711,1,DNK1,2002-04-07,Silkeborg,Akademisk,1,1,0,D
183712,1,DNK1,2002-04-07,Lyngby,Viborg,1,5,-4,L
183713,1,DNK1,2002-04-07,FC Kobenhavn,Odense,4,0,4,W
183714,1,DNK1,2002-04-10,Aalborg,Vejle,2,2,0,D
183715,1,DNK1,2002-04-10,Brondby,Aarhus,2,2,0,D
183716,1,DNK1,2002-04-10,Odense,Lyngby,4,0,4,W
183717,1,DNK1,2002-04-10,Viborg,Silkeborg,3,2,1,W
183718,1,DNK1,2002-04-10,Akademisk,Esbjerg fB,0,0,0,D
183719,1,DNK1,2002-04-10,Midtjylland,FC Kobenhavn,0,1,-1,L
183720,1,DNK1,2002-04-14,Aarhus,Aalborg,2,2,0,D
183721,1,DNK1,2002-04-14,Vejle,Akademisk,0,4,-4,L
183722,1,DNK1,2002-04-14,Esbjerg fB,Viborg,1,0,1,W
183723,1,DNK1,2002-04-14,Silkeborg,Odense,2,2,0,D
183724,1,DNK1,2002-04-14,Lyngby,FC Kobenhavn,0,3,-3,L
183725,1,DNK1,2002-04-14,Brondby,Midtjylland,1,2,-1,L
183726,1,DNK1,2002-04-21,FC Kobenhavn,Silkeborg,2,1,1,W
183727,1,DNK1,2002-04-21,Odense,Esbjerg fB,2,1,1,W
183728,1,DNK1,2002-04-21,Viborg,Vejle,4,1,3,W
183729,1,DNK1,2002-04-21,Midtjylland,Lyngby,4,0,4,W
183730,1,DNK1,2002-04-21,Aalborg,Brondby,1,2,-1,L
183731,1,DNK1,2002-04-22,Akademisk,Aarhus,1,0,1,W
183732,1,DNK1,2002-04-28,Aalborg,Midtjylland,0,1,-1,L
183733,1,DNK1,2002-04-28,Brondby,Akademisk,5,0,5,W
183734,1,DNK1,2002-04-28,Aarhus,Viborg,4,3,1,W
183735,1,DNK1,2002-04-28,Vejle,Odense,1,1,0,D
183736,1,DNK1,2002-04-28,Esbjerg fB,FC Kobenhavn,1,3,-2,L
183737,1,DNK1,2002-04-28,Silkeborg,Lyngby,5,2,3,W
183738,1,DNK1,2002-05-01,Silkeborg,Midtjylland,2,3,-1,L
183739,1,DNK1,2002-05-01,FC Kobenhavn,Vejle,2,1,1,W
183740,1,DNK1,2002-05-01,Odense,Aarhus,5,0,5,W
183741,1,DNK1,2002-05-01,Viborg,Brondby,1,1,0,D
183742,1,DNK1,2002-05-01,Akademisk,Aalborg,1,0,1,W
183743,1,DNK1,2002-05-01,Lyngby,Esbjerg fB,0,2,-2,L
183744,1,DNK1,2002-05-05,Aalborg,Viborg,2,1,1,W
183745,1,DNK1,2002-05-05,Brondby,Odense,4,1,3,W
183746,1,DNK1,2002-05-05,Aarhus,FC Kobenhavn,1,2,-1,L
183747,1,DNK1,2002-05-05,Vejle,Lyngby,2,2,0,D
183748,1,DNK1,2002-05-05,Midtjylland,Akademisk,2,0,2,W
183749,1,DNK1,2002-05-06,Esbjerg fB,Silkeborg,1,1,0,D
183750,1,DNK1,2002-05-12,Esbjerg fB,Midtjylland,0,1,-1,L
183751,1,DNK1,2002-05-12,Silkeborg,Vejle,1,0,1,W
183752,1,DNK1,2002-05-12,Lyngby,Aarhus,0,1,-1,L
183753,1,DNK1,2002-05-12,FC Kobenhavn,Brondby,1,1,0,D
183754,1,DNK1,2002-05-12,Odense,Aalborg,1,2,-1,L
183755,1,DNK1,2002-05-12,Viborg,Akademisk,2,1,1,W
183756,1,DNK1,2002-05-16,Aalborg,FC Kobenhavn,2,4,-2,L
183757,1,DNK1,2002-05-16,Brondby,Lyngby,2,0,2,W
183758,1,DNK1,2002-05-16,Aarhus,Silkeborg,4,0,4,W
183759,1,DNK1,2002-05-16,Vejle,Esbjerg fB,2,0,2,W
183760,1,DNK1,2002-05-16,Akademisk,Odense,4,3,1,W
183761,1,DNK1,2002-05-16,Midtjylland,Viborg,3,1,2,W
183762,2,DNK1,2002-07-27,Silkeborg,Brondby,0,3,-3,L
183763,2,DNK1,2002-07-28,Esbjerg fB,Aalborg,1,2,-1,L
183764,2,DNK1,2002-07-28,Akademisk,HB Koge,2,2,0,D
183765,2,DNK1,2002-07-28,Odense,Midtjylland,2,0,2,W
183766,2,DNK1,2002-07-28,FC Kobenhavn,Viborg,2,2,0,D
183767,2,DNK1,2002-07-28,Aarhus,Nordsjalland,2,0,2,W
183768,2,DNK1,2002-08-03,Brondby,Akademisk,1,3,-2,L
183769,2,DNK1,2002-08-04,Nordsjalland,Viborg,3,2,1,W
183770,2,DNK1,2002-08-04,Midtjylland,Aalborg,2,0,2,W
183771,2,DNK1,2002-08-04,HB Koge,FC Kobenhavn,1,3,-2,L
183772,2,DNK1,2002-08-04,Odense,Silkeborg,2,2,0,D
183773,2,DNK1,2002-08-04,Aarhus,Esbjerg fB,2,2,0,D
183774,2,DNK1,2002-08-10,Aalborg,Brondby,3,1,2,W
183775,2,DNK1,2002-08-11,Esbjerg fB,HB Koge,3,4,-1,L
183776,2,DNK1,2002-08-11,Akademisk,Odense,0,4,-4,L
183777,2,DNK1,2002-08-11,FC Kobenhavn,Nordsjalland,2,1,1,W
183778,2,DNK1,2002-08-11,Silkeborg,Aarhus,1,0,1,W
183779,2,DNK1,2002-08-11,Viborg,Midtjylland,1,1,0,D
183780,2,DNK1,2002-08-17,Nordsjalland,Esbjerg fB,3,4,-1,L
183781,2,DNK1,2002-08-18,Aalborg,Akademisk,1,0,1,W
183782,2,DNK1,2002-08-18,Brondby,Viborg,4,0,4,W
183783,2,DNK1,2002-08-18,Midtjylland,FC Kobenhavn,2,2,0,D
183784,2,DNK1,2002-08-18,HB Koge,Silkeborg,0,4,-4,L
183785,2,DNK1,2002-08-18,Aarhus,Odense,3,2,1,W
183786,2,DNK1,2002-08-24,FC Kobenhavn,Brondby,2,1,1,W
183787,2,DNK1,2002-08-25,Esbjerg fB,Midtjylland,3,2,1,W
183788,2,DNK1,2002-08-25,Akademisk,Aarhus,2,2,0,D
183789,2,DNK1,2002-08-25,Odense,HB Koge,2,1,1,W
183790,2,DNK1,2002-08-25,Silkeborg,Nordsjalland,0,1,-1,L
183791,2,DNK1,2002-08-25,Viborg,Aalborg,2,2,0,D
183792,2,DNK1,2002-08-31,HB Koge,Aarhus,2,0,2,W
183793,2,DNK1,2002-09-01,Aalborg,FC Kobenhavn,3,0,3,W
183794,2,DNK1,2002-09-01,Brondby,Esbjerg fB,1,1,0,D
183795,2,DNK1,2002-09-01,Nordsjalland,Odense,2,1,1,W
183796,2,DNK1,2002-09-01,Midtjylland,Silkeborg,2,0,2,W
183797,2,DNK1,2002-09-01,Viborg,Akademisk,2,1,1,W
183798,2,DNK1,2002-09-08,Esbjerg fB,FC Kobenhavn,3,0,3,W
183799,2,DNK1,2002-09-08,Akademisk,Nordsjalland,2,0,2,W
183800,2,DNK1,2002-09-08,HB Koge,Midtjylland,2,3,-1,L
183801,2,DNK1,2002-09-08,Odense,Aalborg,3,0,3,W
183802,2,DNK1,2002-09-08,Silkeborg,Viborg,1,1,0,D
183803,2,DNK1,2002-09-08,Aarhus,Brondby,2,2,0,D
183804,2,DNK1,2002-09-14,Nordsjalland,HB Koge,1,0,1,W
183805,2,DNK1,2002-09-15,Aalborg,Silkeborg,1,0,1,W
183806,2,DNK1,2002-09-15,Brondby,Odense,2,0,2,W
183807,2,DNK1,2002-09-15,Midtjylland,Aarhus,1,2,-1,L
183808,2,DNK1,2002-09-15,FC Kobenhavn,Akademisk,1,0,1,W
183809,2,DNK1,2002-09-15,Viborg,Esbjerg fB,6,0,6,W
183810,2,DNK1,2002-09-21,Aalborg,Nordsjalland,1,3,-2,L
183811,2,DNK1,2002-09-22,Brondby,Midtjylland,4,0,4,W
183812,2,DNK1,2002-09-22,Esbjerg fB,Odense,5,0,5,W
183813,2,DNK1,2002-09-22,Akademisk,Silkeborg,1,0,1,W
183814,2,DNK1,2002-09-22,FC Kobenhavn,Aarhus,2,0,2,W
183815,2,DNK1,2002-09-22,Viborg,HB Koge,1,4,-3,L
183816,2,DNK1,2002-09-28,Aarhus,Viborg,1,3,-2,L
183817,2,DNK1,2002-09-29,Nordsjalland,Brondby,1,2,-1,L
183818,2,DNK1,2002-09-29,Midtjylland,Akademisk,1,1,0,D
183819,2,DNK1,2002-09-29,HB Koge,Aalborg,0,2,-2,L
183820,2,DNK1,2002-09-29,Odense,FC Kobenhavn,0,1,-1,L
183821,2,DNK1,2002-09-29,Silkeborg,Esbjerg fB,1,1,0,D
183822,2,DNK1,2002-10-04,Aalborg,Aarhus,1,2,-1,L
183823,2,DNK1,2002-10-06,Brondby,HB Koge,1,2,-1,L
183824,2,DNK1,2002-10-06,Akademisk,Esbjerg fB,1,2,-1,L
183825,2,DNK1,2002-10-06,Midtjylland,Nordsjalland,1,0,1,W
183826,2,DNK1,2002-10-06,Odense,Viborg,3,0,3,W
183827,2,DNK1,2002-10-06,FC Kobenhavn,Silkeborg,2,1,1,W
183828,2,DNK1,2002-10-19,FC Kobenhavn,Midtjylland,1,1,0,D
183829,2,DNK1,2002-10-20,Aalborg,Silkeborg,3,4,-1,L
183830,2,DNK1,2002-10-20,Esbjerg fB,Nordsjalland,0,2,-2,L
183831,2,DNK1,2002-10-20,Akademisk,Brondby,1,1,0,D
183832,2,DNK1,2002-10-20,Viborg,Odense,0,0,0,D
183833,2,DNK1,2002-10-20,Aarhus,HB Koge,1,3,-2,L
183834,2,DNK1,2002-10-26,Viborg,FC Kobenhavn,0,3,-3,L
183835,2,DNK1,2002-10-27,Brondby,Aalborg,1,0,1,W
183836,2,DNK1,2002-10-27,Nordsjalland,Midtjylland,1,0,1,W
183837,2,DNK1,2002-10-27,HB Koge,Esbjerg fB,1,4,-3,L
183838,2,DNK1,2002-10-27,Odense,Akademisk,0,0,0,D
183839,2,DNK1,2002-10-27,Silkeborg,Aarhus,2,1,1,W
183840,2,DNK1,2002-11-02,Aarhus,Brondby,2,1,1,W
183841,2,DNK1,2002-11-03,Aalborg,Odense,2,1,1,W
183842,2,DNK1,2002-11-03,Esbjerg fB,Silkeborg,1,1,0,D
183843,2,DNK1,2002-11-03,Akademisk,Viborg,1,1,0,D
183844,2,DNK1,2002-11-03,Midtjylland,HB Koge,5,0,5,W
183845,2,DNK1,2002-11-03,FC Kobenhavn,Nordsjalland,4,0,4,W
183846,2,DNK1,2002-11-09,Viborg,Aalborg,1,3,-2,L
183847,2,DNK1,2002-11-10,Brondby,Esbjerg fB,1,1,0,D
183848,2,DNK1,2002-11-10,Akademisk,FC Kobenhavn,0,0,0,D
183849,2,DNK1,2002-11-10,HB Koge,Nordsjalland,4,2,2,W
183850,2,DNK1,2002-11-10,Odense,Aarhus,2,2,0,D
183851,2,DNK1,2002-11-10,Silkeborg,Midtjylland,1,1,0,D
183852,2,DNK1,2002-11-16,Esbjerg fB,Odense,4,4,0,D
183853,2,DNK1,2002-11-17,Aalborg,Akademisk,0,4,-4,L
183854,2,DNK1,2002-11-17,Nordsjalland,Silkeborg,3,2,1,W
183855,2,DNK1,2002-11-17,FC Kobenhavn,HB Koge,1,0,1,W
183856,2,DNK1,2002-11-17,Aarhus,Viborg,2,4,-2,L
183857,2,DNK1,2002-11-17,Midtjylland,Brondby,1,1,0,D
183858,2,DNK1,2002-11-23,Brondby,Nordsjalland,7,1,6,W
183859,2,DNK1,2002-11-24,Akademisk,Aarhus,3,1,2,W
183860,2,DNK1,2002-11-24,Odense,Midtjylland,1,0,1,W
183861,2,DNK1,2002-11-24,Silkeborg,HB Koge,3,4,-1,L
183862,2,DNK1,2002-11-24,Viborg,Esbjerg fB,4,1,3,W
183863,2,DNK1,2002-11-24,Aalborg,FC Kobenhavn,1,1,0,D
183864,2,DNK1,2002-11-30,HB Koge,Brondby,0,2,-2,L
183865,2,DNK1,2002-12-01,Esbjerg fB,Akademisk,1,1,0,D
183866,2,DNK1,2002-12-01,Nordsjalland,Odense,2,1,1,W
183867,2,DNK1,2002-12-01,Midtjylland,Viborg,3,1,2,W
183868,2,DNK1,2002-12-01,FC Kobenhavn,Silkeborg,3,0,3,W
183869,2,DNK1,2002-12-01,Aarhus,Aalborg,1,0,1,W
183870,2,DNK1,2003-03-15,Brondby,Viborg,2,1,1,W
183871,2,DNK1,2003-03-16,Midtjylland,Esbjerg fB,2,0,2,W
183872,2,DNK1,2003-03-16,HB Koge,Aalborg,1,1,0,D
183873,2,DNK1,2003-03-16,Odense,FC Kobenhavn,2,0,2,W
183874,2,DNK1,2003-03-16,Silkeborg,Akademisk,3,0,3,W
183875,2,DNK1,2003-03-22,Brondby,Silkeborg,2,0,2,W
183876,2,DNK1,2003-03-23,Aalborg,Esbjerg fB,0,1,-1,L
183877,2,DNK1,2003-03-23,Akademisk,Midtjylland,0,3,-3,L
183878,2,DNK1,2003-03-23,Odense,HB Koge,3,1,2,W
183879,2,DNK1,2003-03-23,Aarhus,FC Kobenhavn,2,2,0,D
183880,2,DNK1,2003-03-24,Viborg,Nordsjalland,1,3,-2,L
183881,2,DNK1,2003-04-05,Midtjylland,Aalborg,2,1,1,W
183882,2,DNK1,2003-04-06,Esbjerg fB,Aarhus,4,1,3,W
183883,2,DNK1,2003-04-06,Nordsjalland,Akademisk,2,0,2,W
183884,2,DNK1,2003-04-06,HB Koge,Viborg,2,0,2,W
183885,2,DNK1,2003-04-06,FC Kobenhavn,Brondby,1,1,0,D
183886,2,DNK1,2003-04-06,Silkeborg,Odense,1,1,0,D
183887,2,DNK1,2003-04-12,Odense,Brondby,1,1,0,D
183888,2,DNK1,2003-04-13,Aalborg,Nordsjalland,1,2,-1,L
183889,2,DNK1,2003-04-13,Akademisk,HB Koge,3,1,2,W
183890,2,DNK1,2003-04-13,FC Kobenhavn,Esbjerg fB,1,0,1,W
183891,2,DNK1,2003-04-13,Viborg,Silkeborg,0,0,0,D
183892,2,DNK1,2003-04-13,Aarhus,Midtjylland,3,2,1,W
183893,2,DNK1,2003-04-16,Aalborg,Aarhus,2,0,2,W
183894,2,DNK1,2003-04-17,Brondby,HB Koge,2,1,1,W
183895,2,DNK1,2003-04-17,Akademisk,Esbjerg fB,1,4,-3,L
183896,2,DNK1,2003-04-17,Odense,Nordsjalland,2,2,0,D
183897,2,DNK1,2003-04-17,Silkeborg,FC Kobenhavn,3,0,3,W
183898,2,DNK1,2003-04-17,Viborg,Midtjylland,0,0,0,D
183899,2,DNK1,2003-04-20,Nordsjalland,Brondby,1,1,0,D
183900,2,DNK1,2003-04-21,Esbjerg fB,Viborg,1,5,-4,L
183901,2,DNK1,2003-04-21,Midtjylland,Odense,2,2,0,D
183902,2,DNK1,2003-04-21,HB Koge,Silkeborg,1,3,-2,L
183903,2,DNK1,2003-04-21,FC Kobenhavn,Aalborg,0,1,-1,L
183904,2,DNK1,2003-04-21,Aarhus,Akademisk,1,2,-1,L
183905,2,DNK1,2003-04-24,Nordsjalland,Aarhus,2,0,2,W
183906,2,DNK1,2003-04-26,HB Koge,FC Kobenhavn,0,5,-5,L
183907,2,DNK1,2003-04-27,Brondby,Midtjylland,3,1,2,W
183908,2,DNK1,2003-04-27,Akademisk,Aalborg,3,1,2,W
183909,2,DNK1,2003-04-27,Odense,Esbjerg fB,1,1,0,D
183910,2,DNK1,2003-04-27,Silkeborg,Nordsjalland,5,1,4,W
183911,2,DNK1,2003-04-27,Viborg,Aarhus,0,0,0,D
183912,2,DNK1,2003-05-03,Esbjerg fB,Brondby,1,2,-1,L
183913,2,DNK1,2003-05-04,Aalborg,Viborg,2,3,-1,L
183914,2,DNK1,2003-05-04,Nordsjalland,HB Koge,2,1,1,W
183915,2,DNK1,2003-05-04,Midtjylland,Silkeborg,2,1,1,W
183916,2,DNK1,2003-05-04,FC Kobenhavn,Akademisk,1,1,0,D
183917,2,DNK1,2003-05-04,Aarhus,Odense,4,1,3,W
183918,2,DNK1,2003-05-10,Nordsjalland,FC Kobenhavn,0,1,-1,L
183919,2,DNK1,2003-05-11,Brondby,Aarhus,1,1,0,D
183920,2,DNK1,2003-05-11,HB Koge,Midtjylland,1,1,0,D
183921,2,DNK1,2003-05-11,Odense,Aalborg,3,1,2,W
183922,2,DNK1,2003-05-11,Silkeborg,Esbjerg fB,2,2,0,D
183923,2,DNK1,2003-05-11,Viborg,Akademisk,3,0,3,W
183924,2,DNK1,2003-05-17,Akademisk,Odense,1,1,0,D
183925,2,DNK1,2003-05-18,Esbjerg fB,HB Koge,6,1,5,W
183926,2,DNK1,2003-05-18,Midtjylland,Nordsjalland,2,0,2,W
183927,2,DNK1,2003-05-18,FC Kobenhavn,Viborg,2,3,-1,L
183928,2,DNK1,2003-05-18,Aarhus,Silkeborg,2,1,1,W
183929,2,DNK1,2003-05-18,Aalborg,Brondby,1,2,-1,L
183930,2,DNK1,2003-05-24,Midtjylland,FC Kobenhavn,1,2,-1,L
183931,2,DNK1,2003-05-25,Brondby,Akademisk,0,0,0,D
183932,2,DNK1,2003-05-25,Nordsjalland,Esbjerg fB,2,3,-1,L
183933,2,DNK1,2003-05-25,HB Koge,Aarhus,1,4,-3,L
183934,2,DNK1,2003-05-25,Odense,Viborg,3,1,2,W
183935,2,DNK1,2003-05-25,Silkeborg,Aalborg,0,0,0,D
183936,2,DNK1,2003-05-31,Aarhus,Nordsjalland,2,2,0,D
183937,2,DNK1,2003-06-01,Esbjerg fB,Midtjylland,4,1,3,W
183938,2,DNK1,2003-06-01,Aalborg,HB Koge,1,0,1,W
183939,2,DNK1,2003-06-01,Akademisk,Silkeborg,3,1,2,W
183940,2,DNK1,2003-06-01,FC Kobenhavn,Odense,1,1,0,D
183941,2,DNK1,2003-06-01,Viborg,Brondby,1,1,0,D
183942,2,DNK1,2003-06-14,Esbjerg fB,FC Kobenhavn,0,0,0,D
183943,2,DNK1,2003-06-15,Nordsjalland,Aalborg,1,3,-2,L
183944,2,DNK1,2003-06-15,Midtjylland,Aarhus,1,1,0,D
183945,2,DNK1,2003-06-15,HB Koge,Akademisk,2,3,-1,L
183946,2,DNK1,2003-06-15,Silkeborg,Viborg,2,3,-1,L
183947,2,DNK1,2003-06-15,Brondby,Odense,4,0,4,W
183948,2,DNK1,2003-06-18,Aalborg,Midtjylland,1,0,1,W
183949,2,DNK1,2003-06-18,Brondby,FC Kobenhavn,0,1,-1,L
183950,2,DNK1,2003-06-18,Akademisk,Nordsjalland,1,2,-1,L
183951,2,DNK1,2003-06-18,Odense,Silkeborg,4,3,1,W
183952,2,DNK1,2003-06-18,Viborg,HB Koge,6,1,5,W
183953,2,DNK1,2003-06-18,Aarhus,Esbjerg fB,1,1,0,D
183954,2,DNK1,2003-06-22,Esbjerg fB,Aalborg,0,1,-1,L
183955,2,DNK1,2003-06-22,Nordsjalland,Viborg,1,0,1,W
183956,2,DNK1,2003-06-22,Midtjylland,Akademisk,3,3,0,D
183957,2,DNK1,2003-06-22,HB Koge,Odense,1,2,-1,L
183958,2,DNK1,2003-06-22,FC Kobenhavn,Aarhus,4,1,3,W
183959,2,DNK1,2003-06-22,Silkeborg,Brondby,4,3,1,W
183960,3,DNK1,2003-07-26,Aalborg,FC Kobenhavn,0,2,-2,L
183961,3,DNK1,2003-07-27,Midtjylland,Viborg,1,1,0,D
183962,3,DNK1,2003-07-27,Odense,Frem Kobenhavn,2,0,2,W
183963,3,DNK1,2003-07-27,Esbjerg fB,Aarhus,2,0,2,W
183964,3,DNK1,2003-07-27,Nordsjalland,Akademisk,1,1,0,D
183965,3,DNK1,2003-07-27,Brondby,Herfolge,2,0,2,W
183966,3,DNK1,2003-08-02,FC Kobenhavn,Odense,2,4,-2,L
183967,3,DNK1,2003-08-03,Akademisk,Aalborg,0,2,-2,L
183968,3,DNK1,2003-08-03,Herfolge,Midtjylland,0,1,-1,L
183969,3,DNK1,2003-08-03,Aarhus,Nordsjalland,2,2,0,D
183970,3,DNK1,2003-08-03,Viborg,Esbjerg fB,1,1,0,D
183971,3,DNK1,2003-08-03,Frem Kobenhavn,Brondby,0,2,-2,L
183972,3,DNK1,2003-08-09,Esbjerg fB,FC Kobenhavn,1,1,0,D
183973,3,DNK1,2003-08-10,Nordsjalland,Odense,2,0,2,W
183974,3,DNK1,2003-08-10,Midtjylland,Akademisk,3,0,3,W
183975,3,DNK1,2003-08-10,Aalborg,Frem Kobenhavn,0,1,-1,L
183976,3,DNK1,2003-08-10,Herfolge,Viborg,2,1,1,W
183977,3,DNK1,2003-08-10,Brondby,Aarhus,2,0,2,W
183978,3,DNK1,2003-08-16,Aarhus,Midtjylland,5,3,2,W
183979,3,DNK1,2003-08-17,Akademisk,Esbjerg fB,2,4,-2,L
183980,3,DNK1,2003-08-17,Frem Kobenhavn,Herfolge,1,0,1,W
183981,3,DNK1,2003-08-17,Odense,Aalborg,0,0,0,D
183982,3,DNK1,2003-08-17,Viborg,Brondby,2,2,0,D
183983,3,DNK1,2003-08-17,FC Kobenhavn,Nordsjalland,2,1,1,W
183984,3,DNK1,2003-08-23,Brondby,FC Kobenhavn,0,1,-1,L
183985,3,DNK1,2003-08-24,Esbjerg fB,Aalborg,3,2,1,W
183986,3,DNK1,2003-08-24,Nordsjalland,Frem Kobenhavn,1,3,-2,L
183987,3,DNK1,2003-08-24,Viborg,Aarhus,1,0,1,W
183988,3,DNK1,2003-08-24,Herfolge,Akademisk,0,2,-2,L
183989,3,DNK1,2003-08-24,Midtjylland,Odense,2,1,1,W
183990,3,DNK1,2003-08-30,Aalborg,Herfolge,0,2,-2,L
183991,3,DNK1,2003-08-31,Frem Kobenhavn,Akademisk,1,2,-1,L
183992,3,DNK1,2003-08-31,Odense,Viborg,4,2,2,W
183993,3,DNK1,2003-08-31,Esbjerg fB,Midtjylland,2,0,2,W
183994,3,DNK1,2003-08-31,Nordsjalland,Brondby,0,1,-1,L
183995,3,DNK1,2003-08-31,FC Kobenhavn,Aarhus,4,0,4,W
183996,3,DNK1,2003-09-13,FC Kobenhavn,Midtjylland,0,1,-1,L
183997,3,DNK1,2003-09-14,Frem Kobenhavn,Viborg,2,3,-1,L
183998,3,DNK1,2003-09-14,Aalborg,Nordsjalland,1,0,1,W
183999,3,DNK1,2003-09-14,Odense,Esbjerg fB,2,0,2,W
184000,3,DNK1,2003-09-14,Aarhus,Herfolge,2,1,1,W
184001,3,DNK1,2003-09-14,Akademisk,Brondby,0,3,-3,L
184002,3,DNK1,2003-09-17,Viborg,FC Kobenhavn,2,2,0,D
184003,3,DNK1,2003-09-17,Herfolge,Odense,2,2,0,D
184004,3,DNK1,2003-09-17,Esbjerg fB,Frem Kobenhavn,2,0,2,W
184005,3,DNK1,2003-09-17,Midtjylland,Nordsjalland,1,1,0,D
184006,3,DNK1,2003-09-17,Brondby,Aalborg,1,1,0,D
184007,3,DNK1,2003-09-17,Aarhus,Akademisk,2,0,2,W
184008,3,DNK1,2003-09-20,FC Kobenhavn,Herfolge,0,0,0,D
184009,3,DNK1,2003-09-20,Nordsjalland,Esbjerg fB,1,1,0,D
184010,3,DNK1,2003-09-20,Odense,Brondby,0,1,-1,L
184011,3,DNK1,2003-09-21,Frem Kobenhavn,Aarhus,1,4,-3,L
184012,3,DNK1,2003-09-21,Aalborg,Midtjylland,1,0,1,W
184013,3,DNK1,2003-09-21,Akademisk,Viborg,1,4,-3,L
184014,3,DNK1,2003-09-28,Nordsjalland,Viborg,2,1,1,W
184015,3,DNK1,2003-09-28,Aalborg,Aarhus,2,1,1,W
184016,3,DNK1,2003-09-28,Odense,Akademisk,2,1,1,W
184017,3,DNK1,2003-09-28,FC Kobenhavn,Frem Kobenhavn,2,0,2,W
184018,3,DNK1,2003-09-28,Esbjerg fB,Herfolge,2,0,2,W
184019,3,DNK1,2003-09-28,Brondby,Midtjylland,1,3,-2,L
184020,3,DNK1,2003-10-04,Akademisk,FC Kobenhavn,0,1,-1,L
184021,3,DNK1,2003-10-05,Herfolge,Nordsjalland,2,1,1,W
184022,3,DNK1,2003-10-05,Midtjylland,Frem Kobenhavn,4,1,3,W
184023,3,DNK1,2003-10-05,Aarhus,Odense,0,5,-5,L
184024,3,DNK1,2003-10-05,Viborg,Aalborg,2,3,-1,L
184025,3,DNK1,2003-10-05,Brondby,Esbjerg fB,3,0,3,W
184026,3,DNK1,2003-10-18,Frem Kobenhavn,Nordsjalland,5,1,4,W
184027,3,DNK1,2003-10-19,Akademisk,Aalborg,0,3,-3,L
184028,3,DNK1,2003-10-19,Midtjylland,Herfolge,0,2,-2,L
184029,3,DNK1,2003-10-19,Aarhus,Brondby,1,2,-1,L
184030,3,DNK1,2003-10-19,Viborg,Esbjerg fB,1,2,-1,L
184031,3,DNK1,2003-10-19,FC Kobenhavn,Odense,2,2,0,D
184032,3,DNK1,2003-10-22,Brondby,Viborg,1,0,1,W
184033,3,DNK1,2003-10-22,Nordsjalland,Midtjylland,1,7,-6,L
184034,3,DNK1,2003-10-22,Aalborg,Frem Kobenhavn,0,0,0,D
184035,3,DNK1,2003-10-22,Odense,Aarhus,4,2,2,W
184036,3,DNK1,2003-10-22,Herfolge,FC Kobenhavn,0,1,-1,L
184037,3,DNK1,2003-10-22,Esbjerg fB,Akademisk,3,1,2,W
184038,3,DNK1,2003-10-25,Herfolge,Odense,2,2,0,D
184039,3,DNK1,2003-10-26,Midtjylland,Aalborg,2,3,-1,L
184040,3,DNK1,2003-10-26,Frem Kobenhavn,Esbjerg fB,0,4,-4,L
184041,3,DNK1,2003-10-26,Viborg,Aarhus,4,0,4,W
184042,3,DNK1,2003-10-26,Akademisk,Brondby,0,1,-1,L
184043,3,DNK1,2003-10-26,FC Kobenhavn,Nordsjalland,2,0,2,W
184044,3,DNK1,2003-10-29,Aarhus,Akademisk,3,1,2,W
184045,3,DNK1,2003-10-29,Nordsjalland,Herfolge,1,1,0,D
184046,3,DNK1,2003-10-29,Aalborg,FC Kobenhavn,0,1,-1,L
184047,3,DNK1,2003-10-29,Odense,Viborg,4,2,2,W
184048,3,DNK1,2003-10-29,Brondby,Frem Kobenhavn,3,1,2,W
184049,3,DNK1,2003-10-29,Esbjerg fB,Midtjylland,2,0,2,W
184050,3,DNK1,2003-11-01,Midtjylland,Brondby,0,2,-2,L
184051,3,DNK1,2003-11-02,Nordsjalland,Odense,3,0,3,W
184052,3,DNK1,2003-11-02,Frem Kobenhavn,Aarhus,1,2,-1,L
184053,3,DNK1,2003-11-02,Akademisk,Viborg,0,3,-3,L
184054,3,DNK1,2003-11-02,Herfolge,Aalborg,3,3,0,D
184055,3,DNK1,2003-11-02,FC Kobenhavn,Esbjerg fB,0,1,-1,L
184056,3,DNK1,2003-11-08,Aarhus,Midtjylland,2,1,1,W
184057,3,DNK1,2003-11-09,Esbjerg fB,Herfolge,2,0,2,W
184058,3,DNK1,2003-11-09,Aalborg,Nordsjalland,3,3,0,D
184059,3,DNK1,2003-11-09,Odense,Akademisk,1,0,1,W
184060,3,DNK1,2003-11-09,Viborg,Frem Kobenhavn,0,0,0,D
184061,3,DNK1,2003-11-09,Brondby,FC Kobenhavn,2,2,0,D
184062,3,DNK1,2003-11-22,Herfolge,Brondby,1,3,-2,L
184063,3,DNK1,2003-11-23,Midtjylland,Viborg,0,0,0,D
184064,3,DNK1,2003-11-23,Frem Kobenhavn,Akademisk,1,2,-1,L
184065,3,DNK1,2003-11-23,Aalborg,Odense,3,1,2,W
184066,3,DNK1,2003-11-23,Nordsjalland,Esbjerg fB,2,0,2,W
184067,3,DNK1,2003-11-23,FC Kobenhavn,Aarhus,1,1,0,D
184068,3,DNK1,2003-11-29,Esbjerg fB,Aalborg,4,2,2,W
184069,3,DNK1,2003-11-30,Akademisk,Midtjylland,3,3,0,D
184070,3,DNK1,2003-11-30,Odense,Frem Kobenhavn,2,1,1,W
184071,3,DNK1,2003-11-30,Aarhus,Herfolge,1,3,-2,L
184072,3,DNK1,2003-11-30,Viborg,FC Kobenhavn,0,2,-2,L
184073,3,DNK1,2003-11-30,Brondby,Nordsjalland,2,1,1,W
184074,3,DNK1,2003-12-06,Nordsjalland,Aarhus,1,3,-2,L
184075,3,DNK1,2003-12-07,Midtjylland,Frem Kobenhavn,3,3,0,D
184076,3,DNK1,2003-12-07,FC Kobenhavn,Akademisk,3,1,2,W
184077,3,DNK1,2003-12-07,Herfolge,Viborg,0,1,-1,L
184078,3,DNK1,2003-12-07,Esbjerg fB,Odense,3,3,0,D
184079,3,DNK1,2003-12-07,Aalborg,Brondby,1,1,0,D
184080,3,DNK1,2004-03-13,Frem Kobenhavn,FC Kobenhavn,1,2,-1,L
184081,3,DNK1,2004-03-14,Akademisk,Herfolge,1,2,-1,L
184082,3,DNK1,2004-03-14,Odense,Midtjylland,4,0,4,W
184083,3,DNK1,2004-03-14,Aarhus,Aalborg,0,1,-1,L
184084,3,DNK1,2004-03-14,Viborg,Nordsjalland,0,0,0,D
184085,3,DNK1,2004-03-14,Brondby,Esbjerg fB,1,6,-5,L
184086,3,DNK1,2004-03-20,Odense,Brondby,1,0,1,W
184087,3,DNK1,2004-03-21,Nordsjalland,Akademisk,1,0,1,W
184088,3,DNK1,2004-03-21,Aalborg,Viborg,2,0,2,W
184089,3,DNK1,2004-03-21,Herfolge,Frem Kobenhavn,0,1,-1,L
184090,3,DNK1,2004-03-21,Esbjerg fB,Aarhus,3,3,0,D
184091,3,DNK1,2004-03-21,FC Kobenhavn,Midtjylland,2,1,1,W
184092,3,DNK1,2004-03-27,Midtjylland,Akademisk,6,0,6,W
184093,3,DNK1,2004-03-28,Frem Kobenhavn,Odense,1,3,-2,L
184094,3,DNK1,2004-03-28,Aalborg,Esbjerg fB,1,1,0,D
184095,3,DNK1,2004-03-28,FC Kobenhavn,Viborg,0,1,-1,L
184096,3,DNK1,2004-03-28,Herfolge,Aarhus,1,0,1,W
184097,3,DNK1,2004-03-28,Nordsjalland,Brondby,0,0,0,D
184098,3,DNK1,2004-04-03,Brondby,Herfolge,3,0,3,W
184099,3,DNK1,2004-04-04,Akademisk,Frem Kobenhavn,1,0,1,W
184100,3,DNK1,2004-04-04,Esbjerg fB,Nordsjalland,4,0,4,W
184101,3,DNK1,2004-04-04,Odense,Aalborg,3,1,2,W
184102,3,DNK1,2004-04-04,Viborg,Midtjylland,1,1,0,D
184103,3,DNK1,2004-04-04,Aarhus,FC Kobenhavn,0,2,-2,L
184104,3,DNK1,2004-04-11,FC Kobenhavn,Frem Kobenhavn,3,2,1,W
184105,3,DNK1,2004-04-12,Nordsjalland,Viborg,0,4,-4,L
184106,3,DNK1,2004-04-12,Midtjylland,Odense,3,1,2,W
184107,3,DNK1,2004-04-12,Aalborg,Aarhus,4,1,3,W
184108,3,DNK1,2004-04-12,Herfolge,Akademisk,0,1,-1,L
184109,3,DNK1,2004-04-12,Esbjerg fB,Brondby,0,0,0,D
184110,3,DNK1,2004-04-17,Odense,Esbjerg fB,2,2,0,D
184111,3,DNK1,2004-04-18,Akademisk,FC Kobenhavn,0,2,-2,L
184112,3,DNK1,2004-04-18,Frem Kobenhavn,Midtjylland,2,1,1,W
184113,3,DNK1,2004-04-18,Aarhus,Nordsjalland,1,2,-1,L
184114,3,DNK1,2004-04-18,Viborg,Herfolge,2,0,2,W
184115,3,DNK1,2004-04-18,Brondby,Aalborg,4,0,4,W
184116,3,DNK1,2004-04-24,Viborg,Brondby,3,2,1,W
184117,3,DNK1,2004-04-25,Akademisk,Esbjerg fB,2,5,-3,L
184118,3,DNK1,2004-04-25,Midtjylland,Nordsjalland,3,0,3,W
184119,3,DNK1,2004-04-25,Frem Kobenhavn,Aalborg,0,1,-1,L
184120,3,DNK1,2004-04-25,Aarhus,Odense,1,0,1,W
184121,3,DNK1,2004-04-25,FC Kobenhavn,Herfolge,1,1,0,D
184122,3,DNK1,2004-05-01,Odense,FC Kobenhavn,0,4,-4,L
184123,3,DNK1,2004-05-02,Nordsjalland,Frem Kobenhavn,2,1,1,W
184124,3,DNK1,2004-05-02,Aalborg,Akademisk,3,1,2,W
184125,3,DNK1,2004-05-02,Herfolge,Midtjylland,1,4,-3,L
184126,3,DNK1,2004-05-02,Esbjerg fB,Viborg,2,0,2,W
184127,3,DNK1,2004-05-02,Brondby,Aarhus,2,0,2,W
184128,3,DNK1,2004-05-08,Midtjylland,FC Kobenhavn,2,1,1,W
184129,3,DNK1,2004-05-09,Akademisk,Nordsjalland,2,1,1,W
184130,3,DNK1,2004-05-09,Frem Kobenhavn,Herfolge,3,2,1,W
184131,3,DNK1,2004-05-09,Aarhus,Esbjerg fB,4,1,3,W
184132,3,DNK1,2004-05-09,Viborg,Aalborg,0,1,-1,L
184133,3,DNK1,2004-05-09,Brondby,Odense,1,1,0,D
184134,3,DNK1,2004-05-13,Nordsjalland,Aalborg,0,0,0,D
184135,3,DNK1,2004-05-13,Midtjylland,Aarhus,5,2,3,W
184136,3,DNK1,2004-05-13,Frem Kobenhavn,Viborg,3,1,2,W
184137,3,DNK1,2004-05-13,Akademisk,Odense,0,3,-3,L
184138,3,DNK1,2004-05-13,Herfolge,Esbjerg fB,3,1,2,W
184139,3,DNK1,2004-05-13,FC Kobenhavn,Brondby,1,0,1,W
184140,3,DNK1,2004-05-16,Aalborg,Herfolge,7,2,5,W
184141,3,DNK1,2004-05-16,Odense,Nordsjalland,1,1,0,D
184142,3,DNK1,2004-05-16,Brondby,Midtjylland,2,1,1,W
184143,3,DNK1,2004-05-16,Aarhus,Frem Kobenhavn,1,0,1,W
184144,3,DNK1,2004-05-16,Viborg,Akademisk,0,2,-2,L
184145,3,DNK1,2004-05-16,Esbjerg fB,FC Kobenhavn,0,2,-2,L
184146,3,DNK1,2004-05-23,Herfolge,Nordsjalland,1,1,0,D
184147,3,DNK1,2004-05-23,Midtjylland,Esbjerg fB,2,1,1,W
184148,3,DNK1,2004-05-23,Frem Kobenhavn,Brondby,1,3,-2,L
184149,3,DNK1,2004-05-23,FC Kobenhavn,Aalborg,1,1,0,D
184150,3,DNK1,2004-05-23,Viborg,Odense,2,2,0,D
184151,3,DNK1,2004-05-23,Akademisk,Aarhus,3,1,2,W
184152,3,DNK1,2004-05-29,Nordsjalland,FC Kobenhavn,2,4,-2,L
184153,3,DNK1,2004-05-29,Aalborg,Midtjylland,3,1,2,W
184154,3,DNK1,2004-05-29,Odense,Herfolge,4,0,4,W
184155,3,DNK1,2004-05-29,Brondby,Akademisk,2,1,1,W
184156,3,DNK1,2004-05-29,Aarhus,Viborg,0,2,-2,L
184157,3,DNK1,2004-05-29,Esbjerg fB,Frem Kobenhavn,6,3,3,W
184158,4,DNK1,2004-07-24,Silkeborg,FC Kobenhavn,2,2,0,D
184159,4,DNK1,2004-07-25,Herfolge,Viborg,0,0,0,D
184160,4,DNK1,2004-07-25,Nordsjalland,Aarhus,2,2,0,D
184161,4,DNK1,2004-07-25,Aalborg,Midtjylland,1,2,-1,L
184162,4,DNK1,2004-07-25,Brondby,Odense,1,2,-1,L
184163,4,DNK1,2004-07-31,Midtjylland,Odense,2,1,1,W
184164,4,DNK1,2004-08-01,Brondby,Viborg,2,0,2,W
184165,4,DNK1,2004-08-01,Silkeborg,Aarhus,3,1,2,W
184166,4,DNK1,2004-08-01,Aalborg,Nordsjalland,2,0,2,W
184167,4,DNK1,2004-08-01,Randers FC,Herfolge,0,1,-1,L
184168,4,DNK1,2004-08-01,FC Kobenhavn,Esbjerg fB,2,2,0,D
184169,4,DNK1,2004-08-07,Viborg,FC Kobenhavn,3,2,1,W
184170,4,DNK1,2004-08-08,Odense,Randers FC,5,1,4,W
184171,4,DNK1,2004-08-08,Herfolge,Aalborg,2,1,1,W
184172,4,DNK1,2004-08-08,Nordsjalland,Silkeborg,2,3,-1,L
184173,4,DNK1,2004-08-08,Esbjerg fB,Midtjylland,3,0,3,W
184174,4,DNK1,2004-08-08,Aarhus,Brondby,0,0,0,D
184175,4,DNK1,2004-08-14,Randers FC,Aarhus,0,3,-3,L
184176,4,DNK1,2004-08-15,Aalborg,Viborg,1,2,-1,L
184177,4,DNK1,2004-08-15,Herfolge,Nordsjalland,0,2,-2,L
184178,4,DNK1,2004-08-15,Brondby,Midtjylland,2,1,1,W
184179,4,DNK1,2004-08-15,Silkeborg,Esbjerg fB,2,1,1,W
184180,4,DNK1,2004-08-15,FC Kobenhavn,Odense,1,1,0,D
184181,4,DNK1,2004-08-29,Odense,Aarhus,0,2,-2,L
184182,4,DNK1,2004-08-29,Viborg,Nordsjalland,0,1,-1,L
184183,4,DNK1,2004-08-29,Esbjerg fB,Herfolge,7,2,5,W
184184,4,DNK1,2004-08-29,Midtjylland,Randers FC,3,1,2,W
184185,4,DNK1,2004-08-29,FC Kobenhavn,Aalborg,3,2,1,W
184186,4,DNK1,2004-08-29,Brondby,Silkeborg,1,0,1,W
184187,4,DNK1,2004-09-11,Randers FC,FC Kobenhavn,0,0,0,D
184188,4,DNK1,2004-09-12,Aarhus,Viborg,1,2,-1,L
184189,4,DNK1,2004-09-12,Herfolge,Midtjylland,0,1,-1,L
184190,4,DNK1,2004-09-12,Nordsjalland,Esbjerg fB,2,1,1,W
184191,4,DNK1,2004-09-12,Silkeborg,Odense,1,2,-1,L
184192,4,DNK1,2004-09-12,Aalborg,Brondby,1,1,0,D
184193,4,DNK1,2004-09-18,Midtjylland,Silkeborg,2,1,1,W
184194,4,DNK1,2004-09-19,Odense,Nordsjalland,4,0,4,W
184195,4,DNK1,2004-09-19,Aarhus,Herfolge,2,0,2,W
184196,4,DNK1,2004-09-19,Viborg,Randers FC,0,1,-1,L
184197,4,DNK1,2004-09-19,Esbjerg fB,Aalborg,1,0,1,W
184198,4,DNK1,2004-09-19,FC Kobenhavn,Brondby,1,3,-2,L
184199,4,DNK1,2004-09-22,Midtjylland,Viborg,1,1,0,D
184200,4,DNK1,2004-09-22,FC Kobenhavn,Aarhus,2,1,1,W
184201,4,DNK1,2004-09-22,Brondby,Nordsjalland,0,0,0,D
184202,4,DNK1,2004-09-22,Silkeborg,Herfolge,2,4,-2,L
184203,4,DNK1,2004-09-22,Aalborg,Randers FC,3,0,3,W
184204,4,DNK1,2004-09-22,Esbjerg fB,Odense,2,4,-2,L
184205,4,DNK1,2004-09-25,Herfolge,Brondby,1,4,-3,L
184206,4,DNK1,2004-09-26,Odense,Aalborg,1,3,-2,L
184207,4,DNK1,2004-09-26,Randers FC,Silkeborg,4,3,1,W
184208,4,DNK1,2004-09-26,Aarhus,Midtjylland,3,1,2,W
184209,4,DNK1,2004-09-26,Viborg,Esbjerg fB,2,0,2,W
184210,4,DNK1,2004-09-26,Nordsjalland,FC Kobenhavn,1,2,-1,L
184211,4,DNK1,2004-10-02,FC Kobenhavn,Herfolge,2,0,2,W
184212,4,DNK1,2004-10-03,Odense,Viborg,0,2,-2,L
184213,4,DNK1,2004-10-03,Esbjerg fB,Aarhus,1,2,-1,L
184214,4,DNK1,2004-10-03,Midtjylland,Nordsjalland,1,1,0,D
184215,4,DNK1,2004-10-03,Aalborg,Silkeborg,1,0,1,W
184216,4,DNK1,2004-10-03,Brondby,Randers FC,2,0,2,W
184217,4,DNK1,2004-10-16,Brondby,Odense,2,1,1,W
184218,4,DNK1,2004-10-17,Aarhus,Aalborg,2,2,0,D
184219,4,DNK1,2004-10-17,Nordsjalland,Esbjerg fB,2,3,-1,L
184220,4,DNK1,2004-10-17,Viborg,Midtjylland,2,1,1,W
184221,4,DNK1,2004-10-17,Herfolge,Randers FC,3,2,1,W
184222,4,DNK1,2004-10-17,Silkeborg,FC Kobenhavn,4,1,3,W
184223,4,DNK1,2004-10-20,Randers FC,Esbjerg fB,1,1,0,D
184224,4,DNK1,2004-10-23,Randers FC,Brondby,0,2,-2,L
184225,4,DNK1,2004-10-24,Esbjerg fB,Aarhus,3,1,2,W
184226,4,DNK1,2004-10-24,Aalborg,Herfolge,3,0,3,W
184227,4,DNK1,2004-10-24,Odense,Silkeborg,3,0,3,W
184228,4,DNK1,2004-10-24,Midtjylland,Nordsjalland,2,0,2,W
184229,4,DNK1,2004-10-24,FC Kobenhavn,Viborg,0,0,0,D
184230,4,DNK1,2004-10-30,Aarhus,Midtjylland,2,2,0,D
184231,4,DNK1,2004-10-30,Nordsjalland,FC Kobenhavn,2,3,-1,L
184232,4,DNK1,2004-10-31,Viborg,Odense,1,0,1,W
184233,4,DNK1,2004-10-31,Herfolge,Esbjerg fB,1,1,0,D
184234,4,DNK1,2004-10-31,Aalborg,Randers FC,1,1,0,D
184235,4,DNK1,2004-10-31,Silkeborg,Brondby,0,1,-1,L
184236,4,DNK1,2004-11-03,Aarhus,Aalborg,2,1,1,W
184237,4,DNK1,2004-11-03,Odense,Herfolge,5,0,5,W
184238,4,DNK1,2004-11-03,Nordsjalland,Randers FC,2,2,0,D
184239,4,DNK1,2004-11-03,Viborg,Silkeborg,1,1,0,D
184240,4,DNK1,2004-11-03,Esbjerg fB,Brondby,2,2,0,D
184241,4,DNK1,2004-11-03,Midtjylland,FC Kobenhavn,2,0,2,W
184242,4,DNK1,2004-11-06,Brondby,Viborg,1,0,1,W
184243,4,DNK1,2004-11-06,Esbjerg fB,Aalborg,2,3,-1,L
184244,4,DNK1,2004-11-07,Randers FC,Silkeborg,4,0,4,W
184245,4,DNK1,2004-11-07,Odense,Nordsjalland,7,1,6,W
184246,4,DNK1,2004-11-07,Midtjylland,Herfolge,1,0,1,W
184247,4,DNK1,2004-11-07,FC Kobenhavn,Aarhus,2,3,-1,L
184248,4,DNK1,2004-11-13,Aalborg,Midtjylland,2,1,1,W
184249,4,DNK1,2004-11-13,Viborg,Silkeborg,1,1,0,D
184250,4,DNK1,2004-11-14,Aarhus,Odense,3,3,0,D
184251,4,DNK1,2004-11-14,Herfolge,FC Kobenhavn,0,1,-1,L
184252,4,DNK1,2004-11-14,Esbjerg fB,Randers FC,1,0,1,W
184253,4,DNK1,2004-11-14,Nordsjalland,Brondby,0,1,-1,L
184254,4,DNK1,2004-11-20,Odense,Herfolge,2,0,2,W
184255,4,DNK1,2004-11-20,Midtjylland,Esbjerg fB,4,3,1,W
184256,4,DNK1,2004-11-21,FC Kobenhavn,Aalborg,4,0,4,W
184257,4,DNK1,2004-11-21,Brondby,Aarhus,4,0,4,W
184258,4,DNK1,2004-11-25,Randers FC,Viborg,2,2,0,D
184259,4,DNK1,2004-11-25,Silkeborg,Nordsjalland,2,1,1,W
184260,4,DNK1,2004-11-27,Esbjerg fB,FC Kobenhavn,1,1,0,D
184261,4,DNK1,2004-11-27,Aalborg,Odense,1,1,0,D
184262,4,DNK1,2004-11-28,Aarhus,Silkeborg,1,3,-2,L
184263,4,DNK1,2004-11-28,Nordsjalland,Viborg,3,2,1,W
184264,4,DNK1,2004-11-28,Midtjylland,Randers FC,2,1,1,W
184265,4,DNK1,2004-11-28,Herfolge,Brondby,1,2,-1,L
184266,4,DNK1,2005-03-12,Viborg,Aarhus,2,1,1,W
184267,4,DNK1,2005-03-13,Odense,Esbjerg fB,0,1,-1,L
184268,4,DNK1,2005-03-13,FC Kobenhavn,Midtjylland,4,0,4,W
184269,4,DNK1,2005-03-13,Brondby,Aalborg,1,1,0,D
184270,4,DNK1,2005-03-19,Aalborg,Silkeborg,3,1,2,W
184271,4,DNK1,2005-03-19,Herfolge,Viborg,1,1,0,D
184272,4,DNK1,2005-03-20,Midtjylland,Odense,0,0,0,D
184273,4,DNK1,2005-03-20,Aarhus,Nordsjalland,2,1,1,W
184274,4,DNK1,2005-03-20,FC Kobenhavn,Randers FC,4,0,4,W
184275,4,DNK1,2005-03-20,Esbjerg fB,Brondby,0,0,0,D
184276,4,DNK1,2005-04-02,Brondby,Midtjylland,0,1,-1,L
184277,4,DNK1,2005-04-02,Silkeborg,Esbjerg fB,2,1,1,W
184278,4,DNK1,2005-04-03,Randers FC,Aarhus,1,0,1,W
184279,4,DNK1,2005-04-03,Nordsjalland,Herfolge,0,0,0,D
184280,4,DNK1,2005-04-03,Viborg,Aalborg,2,1,1,W
184281,4,DNK1,2005-04-03,Odense,FC Kobenhavn,1,2,-1,L
184282,4,DNK1,2005-04-06,Silkeborg,Herfolge,3,0,3,W
184283,4,DNK1,2005-04-09,Aalborg,Nordsjalland,2,0,2,W
184284,4,DNK1,2005-04-09,Midtjylland,Silkeborg,0,0,0,D
184285,4,DNK1,2005-04-10,Randers FC,Odense,1,1,0,D
184286,4,DNK1,2005-04-10,Esbjerg fB,Viborg,4,1,3,W
184287,4,DNK1,2005-04-10,Herfolge,Aarhus,1,0,1,W
184288,4,DNK1,2005-04-10,FC Kobenhavn,Brondby,3,0,3,W
184289,4,DNK1,2005-04-13,Randers FC,Nordsjalland,2,1,1,W
184290,4,DNK1,2005-04-16,Viborg,Brondby,0,2,-2,L
184291,4,DNK1,2005-04-16,Aalborg,Esbjerg fB,0,0,0,D
184292,4,DNK1,2005-04-17,Silkeborg,Randers FC,2,2,0,D
184293,4,DNK1,2005-04-17,Nordsjalland,Odense,0,0,0,D
184294,4,DNK1,2005-04-17,Herfolge,Midtjylland,1,3,-2,L
184295,4,DNK1,2005-04-17,Aarhus,FC Kobenhavn,1,2,-1,L
184296,4,DNK1,2005-04-23,FC Kobenhavn,Nordsjalland,2,0,2,W
184297,4,DNK1,2005-04-24,Odense,Viborg,0,0,0,D
184298,4,DNK1,2005-04-24,Esbjerg fB,Herfolge,5,1,4,W
184299,4,DNK1,2005-04-24,Midtjylland,Aarhus,0,1,-1,L
184300,4,DNK1,2005-04-24,Randers FC,Aalborg,0,4,-4,L
184301,4,DNK1,2005-04-24,Brondby,Silkeborg,0,0,0,D
184302,4,DNK1,2005-04-30,Brondby,Randers FC,2,0,2,W
184303,4,DNK1,2005-05-01,Silkeborg,Odense,4,2,2,W
184304,4,DNK1,2005-05-01,Nordsjalland,Midtjylland,3,2,1,W
184305,4,DNK1,2005-05-01,Aarhus,Esbjerg fB,0,1,-1,L
184306,4,DNK1,2005-05-01,Herfolge,Aalborg,2,4,-2,L
184307,4,DNK1,2005-05-01,Viborg,FC Kobenhavn,0,2,-2,L
184308,4,DNK1,2005-05-07,Aalborg,Aarhus,3,1,2,W
184309,4,DNK1,2005-05-08,Esbjerg fB,Nordsjalland,3,1,2,W
184310,4,DNK1,2005-05-08,Midtjylland,Viborg,1,2,-1,L
184311,4,DNK1,2005-05-08,FC Kobenhavn,Silkeborg,0,1,-1,L
184312,4,DNK1,2005-05-08,Randers FC,Herfolge,1,1,0,D
184313,4,DNK1,2005-05-08,Odense,Brondby,1,1,0,D
184314,4,DNK1,2005-05-15,Silkeborg,Midtjylland,0,1,-1,L
184315,4,DNK1,2005-05-16,Odense,Randers FC,1,0,1,W
184316,4,DNK1,2005-05-16,Viborg,Esbjerg fB,2,2,0,D
184317,4,DNK1,2005-05-16,Nordsjalland,Aalborg,0,1,-1,L
184318,4,DNK1,2005-05-16,Aarhus,Herfolge,2,1,1,W
184319,4,DNK1,2005-05-16,Brondby,FC Kobenhavn,5,0,5,W
184320,4,DNK1,2005-05-19,Aarhus,Randers FC,4,0,4,W
184321,4,DNK1,2005-05-19,Herfolge,Nordsjalland,1,0,1,W
184322,4,DNK1,2005-05-19,Aalborg,Viborg,5,3,2,W
184323,4,DNK1,2005-05-19,Esbjerg fB,Silkeborg,4,0,4,W
184324,4,DNK1,2005-05-19,FC Kobenhavn,Odense,1,1,0,D
184325,4,DNK1,2005-05-19,Midtjylland,Brondby,3,1,2,W
184326,4,DNK1,2005-05-22,Odense,Midtjylland,3,1,2,W
184327,4,DNK1,2005-05-22,Silkeborg,Aalborg,1,0,1,W
184328,4,DNK1,2005-05-22,Viborg,Herfolge,2,1,1,W
184329,4,DNK1,2005-05-22,Nordsjalland,Aarhus,2,1,1,W
184330,4,DNK1,2005-05-22,Randers FC,FC Kobenhavn,0,1,-1,L
184331,4,DNK1,2005-05-22,Brondby,Esbjerg fB,4,0,4,W
184332,4,DNK1,2005-05-28,Aalborg,Brondby,3,3,0,D
184333,4,DNK1,2005-05-29,Nordsjalland,Randers FC,2,0,2,W
184334,4,DNK1,2005-05-29,Aarhus,Viborg,1,2,-1,L
184335,4,DNK1,2005-05-29,Herfolge,Silkeborg,1,1,0,D
184336,4,DNK1,2005-05-29,Esbjerg fB,Odense,3,2,1,W
184337,4,DNK1,2005-05-29,Midtjylland,FC Kobenhavn,1,0,1,W
184338,4,DNK1,2005-06-11,Brondby,Herfolge,7,0,7,W
184339,4,DNK1,2005-06-12,Odense,Aalborg,1,2,-1,L
184340,4,DNK1,2005-06-12,Silkeborg,Aarhus,1,1,0,D
184341,4,DNK1,2005-06-12,Viborg,Nordsjalland,1,2,-1,L
184342,4,DNK1,2005-06-12,Randers FC,Midtjylland,0,3,-3,L
184343,4,DNK1,2005-06-12,FC Kobenhavn,Esbjerg fB,1,0,1,W
184344,4,DNK1,2005-06-15,Viborg,Randers FC,2,1,1,W
184345,4,DNK1,2005-06-15,Nordsjalland,Silkeborg,2,3,-1,L
184346,4,DNK1,2005-06-15,Aarhus,Brondby,1,2,-1,L
184347,4,DNK1,2005-06-15,Herfolge,Odense,2,3,-1,L
184348,4,DNK1,2005-06-15,Aalborg,FC Kobenhavn,1,1,0,D
184349,4,DNK1,2005-06-15,Esbjerg fB,Midtjylland,0,0,0,D
184350,4,DNK1,2005-06-19,Odense,Aarhus,3,0,3,W
184351,4,DNK1,2005-06-19,Brondby,Nordsjalland,2,0,2,W
184352,4,DNK1,2005-06-19,Silkeborg,Viborg,3,2,1,W
184353,4,DNK1,2005-06-19,Midtjylland,Aalborg,4,1,3,W
184354,4,DNK1,2005-06-19,FC Kobenhavn,Herfolge,1,1,0,D
184355,4,DNK1,2005-06-19,Randers FC,Esbjerg fB,2,2,0,D
184356,5,DNK1,2005-07-19,Esbjerg fB,Odense,2,2,0,D
184357,5,DNK1,2005-07-20,Silkeborg,Aarhus,2,1,1,W
184358,5,DNK1,2005-07-20,Nordsjalland,SonderjyskE,1,1,0,D
184359,5,DNK1,2005-07-20,Horsens,Viborg,0,3,-3,L
184360,5,DNK1,2005-07-20,Aalborg,FC Kobenhavn,0,1,-1,L
184361,5,DNK1,2005-07-20,Brondby,Midtjylland,3,0,3,W
184362,5,DNK1,2005-07-23,Brondby,Silkeborg,2,0,2,W
184363,5,DNK1,2005-07-24,Viborg,Nordsjalland,3,1,2,W
184364,5,DNK1,2005-07-24,SonderjyskE,Aarhus,2,1,1,W
184365,5,DNK1,2005-07-24,Midtjylland,Esbjerg fB,2,1,1,W
184366,5,DNK1,2005-07-24,Odense,Aalborg,2,1,1,W
184367,5,DNK1,2005-07-24,FC Kobenhavn,Horsens,2,0,2,W
184368,5,DNK1,2005-07-30,Aalborg,Midtjylland,1,1,0,D
184369,5,DNK1,2005-07-31,Silkeborg,SonderjyskE,3,2,1,W
184370,5,DNK1,2005-07-31,Aarhus,Viborg,2,3,-1,L
184371,5,DNK1,2005-07-31,Nordsjalland,FC Kobenhavn,1,2,-1,L
184372,5,DNK1,2005-07-31,Horsens,Odense,0,0,0,D
184373,5,DNK1,2005-07-31,Esbjerg fB,Brondby,2,3,-1,L
184374,5,DNK1,2005-08-06,Brondby,Aalborg,3,1,2,W
184375,5,DNK1,2005-08-07,Midtjylland,Horsens,2,1,1,W
184376,5,DNK1,2005-08-07,Odense,Nordsjalland,0,0,0,D
184377,5,DNK1,2005-08-07,Viborg,SonderjyskE,3,1,2,W
184378,5,DNK1,2005-08-07,Esbjerg fB,Silkeborg,4,0,4,W
184379,5,DNK1,2005-08-07,FC Kobenhavn,Aarhus,1,1,0,D
184380,5,DNK1,2005-08-13,Aarhus,Odense,0,4,-4,L
184381,5,DNK1,2005-08-14,Silkeborg,Viborg,1,1,0,D
184382,5,DNK1,2005-08-14,SonderjyskE,FC Kobenhavn,0,1,-1,L
184383,5,DNK1,2005-08-14,Nordsjalland,Midtjylland,3,2,1,W
184384,5,DNK1,2005-08-14,Aalborg,Esbjerg fB,2,0,2,W
184385,5,DNK1,2005-08-14,Horsens,Brondby,0,0,0,D
184386,5,DNK1,2005-08-20,Brondby,Nordsjalland,2,1,1,W
184387,5,DNK1,2005-08-21,Esbjerg fB,Horsens,0,0,0,D
184388,5,DNK1,2005-08-21,Midtjylland,Aarhus,3,3,0,D
184389,5,DNK1,2005-08-21,Odense,SonderjyskE,2,3,-1,L
184390,5,DNK1,2005-08-21,Aalborg,Silkeborg,1,1,0,D
184391,5,DNK1,2005-08-21,FC Kobenhavn,Viborg,2,1,1,W
184392,5,DNK1,2005-08-27,Viborg,Odense,1,2,-1,L
184393,5,DNK1,2005-08-28,SonderjyskE,Midtjylland,2,4,-2,L
184394,5,DNK1,2005-08-28,Nordsjalland,Esbjerg fB,2,0,2,W
184395,5,DNK1,2005-08-28,Horsens,Aalborg,0,0,0,D
184396,5,DNK1,2005-08-28,FC Kobenhavn,Silkeborg,2,0,2,W
184397,5,DNK1,2005-08-28,Aarhus,Brondby,3,0,3,W
184398,5,DNK1,2005-09-10,Brondby,SonderjyskE,3,0,3,W
184399,5,DNK1,2005-09-11,Silkeborg,Horsens,0,1,-1,L
184400,5,DNK1,2005-09-11,Aalborg,Nordsjalland,1,1,0,D
184401,5,DNK1,2005-09-11,Esbjerg fB,Aarhus,0,1,-1,L
184402,5,DNK1,2005-09-11,Midtjylland,Viborg,1,1,0,D
184403,5,DNK1,2005-09-11,Odense,FC Kobenhavn,0,2,-2,L
184404,5,DNK1,2005-09-17,Aarhus,Aalborg,2,4,-2,L
184405,5,DNK1,2005-09-18,Nordsjalland,Horsens,5,0,5,W
184406,5,DNK1,2005-09-18,SonderjyskE,Esbjerg fB,0,1,-1,L
184407,5,DNK1,2005-09-18,Odense,Silkeborg,3,1,2,W
184408,5,DNK1,2005-09-18,Viborg,Brondby,3,1,2,W
184409,5,DNK1,2005-09-18,FC Kobenhavn,Midtjylland,3,1,2,W
184410,5,DNK1,2005-09-21,Midtjylland,Odense,0,1,-1,L
184411,5,DNK1,2005-09-21,Silkeborg,Nordsjalland,1,1,0,D
184412,5,DNK1,2005-09-21,Horsens,Aarhus,1,1,0,D
184413,5,DNK1,2005-09-21,Aalborg,SonderjyskE,3,2,1,W
184414,5,DNK1,2005-09-21,Esbjerg fB,Viborg,1,4,-3,L
184415,5,DNK1,2005-09-21,Brondby,FC Kobenhavn,1,1,0,D
184416,5,DNK1,2005-09-24,Odense,Brondby,1,3,-2,L
184417,5,DNK1,2005-09-25,SonderjyskE,Horsens,1,3,-2,L
184418,5,DNK1,2005-09-25,Aarhus,Nordsjalland,0,2,-2,L
184419,5,DNK1,2005-09-25,Viborg,Aalborg,2,0,2,W
184420,5,DNK1,2005-09-25,FC Kobenhavn,Esbjerg fB,5,1,4,W
184421,5,DNK1,2005-09-25,Midtjylland,Silkeborg,1,0,1,W
184422,5,DNK1,2005-10-01,Nordsjalland,Silkeborg,2,2,0,D
184423,5,DNK1,2005-10-02,Aarhus,Esbjerg fB,2,2,0,D
184424,5,DNK1,2005-10-02,Viborg,SonderjyskE,1,1,0,D
184425,5,DNK1,2005-10-02,Aalborg,Midtjylland,2,2,0,D
184426,5,DNK1,2005-10-02,FC Kobenhavn,Odense,1,1,0,D
184427,5,DNK1,2005-10-02,Brondby,Horsens,4,1,3,W
184428,5,DNK1,2005-10-15,Midtjylland,Viborg,0,1,-1,L
184429,5,DNK1,2005-10-16,Odense,Aarhus,3,1,2,W
184430,5,DNK1,2005-10-16,Esbjerg fB,Aalborg,2,1,1,W
184431,5,DNK1,2005-10-16,Horsens,Nordsjalland,0,0,0,D
184432,5,DNK1,2005-10-16,Silkeborg,FC Kobenhavn,0,3,-3,L
184433,5,DNK1,2005-10-16,SonderjyskE,Brondby,1,2,-1,L
184434,5,DNK1,2005-10-22,FC Kobenhavn,Horsens,1,0,1,W
184435,5,DNK1,2005-10-23,Viborg,Esbjerg fB,1,0,1,W
184436,5,DNK1,2005-10-23,Aalborg,Aarhus,1,1,0,D
184437,5,DNK1,2005-10-23,Nordsjalland,SonderjyskE,4,2,2,W
184438,5,DNK1,2005-10-23,Silkeborg,Odense,1,0,1,W
184439,5,DNK1,2005-10-23,Brondby,Midtjylland,5,0,5,W
184440,5,DNK1,2005-10-26,Odense,Aalborg,0,2,-2,L
184441,5,DNK1,2005-10-26,Aarhus,Viborg,3,3,0,D
184442,5,DNK1,2005-10-26,Midtjylland,Nordsjalland,1,1,0,D
184443,5,DNK1,2005-10-26,SonderjyskE,FC Kobenhavn,1,4,-3,L
184444,5,DNK1,2005-10-26,Horsens,Silkeborg,0,0,0,D
184445,5,DNK1,2005-10-26,Esbjerg fB,Brondby,0,0,0,D
184446,5,DNK1,2005-10-29,Viborg,Aalborg,2,0,2,W
184447,5,DNK1,2005-10-30,Nordsjalland,Esbjerg fB,0,2,-2,L
184448,5,DNK1,2005-10-30,Brondby,Aarhus,4,0,4,W
184449,5,DNK1,2005-10-30,Silkeborg,SonderjyskE,0,1,-1,L
184450,5,DNK1,2005-10-30,Horsens,Odense,0,0,0,D
184451,5,DNK1,2005-10-30,FC Kobenhavn,Midtjylland,2,0,2,W
184452,5,DNK1,2005-11-05,Esbjerg fB,FC Kobenhavn,3,1,2,W
184453,5,DNK1,2005-11-06,Odense,Viborg,3,0,3,W
184454,5,DNK1,2005-11-06,Aarhus,Nordsjalland,1,3,-2,L
184455,5,DNK1,2005-11-06,Midtjylland,Silkeborg,0,2,-2,L
184456,5,DNK1,2005-11-06,SonderjyskE,Horsens,1,1,0,D
184457,5,DNK1,2005-11-06,Aalborg,Brondby,3,0,3,W
184458,5,DNK1,2005-11-19,Brondby,Viborg,1,0,1,W
184459,5,DNK1,2005-11-20,Silkeborg,Esbjerg fB,2,1,1,W
184460,5,DNK1,2005-11-20,Nordsjalland,Aalborg,0,1,-1,L
184461,5,DNK1,2005-11-20,Horsens,Midtjylland,3,4,-1,L
184462,5,DNK1,2005-11-20,SonderjyskE,Odense,2,4,-2,L
184463,5,DNK1,2005-11-20,FC Kobenhavn,Aarhus,1,1,0,D
184464,5,DNK1,2005-11-26,Odense,Brondby,0,1,-1,L
184465,5,DNK1,2005-11-27,Viborg,Nordsjalland,4,1,3,W
184466,5,DNK1,2005-11-27,Aarhus,Silkeborg,2,0,2,W
184467,5,DNK1,2005-11-27,Esbjerg fB,Horsens,1,1,0,D
184468,5,DNK1,2005-11-27,Midtjylland,SonderjyskE,2,2,0,D
184469,5,DNK1,2005-11-27,Aalborg,FC Kobenhavn,0,2,-2,L
184470,5,DNK1,2005-12-03,Midtjylland,Odense,1,2,-1,L
184471,5,DNK1,2005-12-04,SonderjyskE,Esbjerg fB,1,3,-2,L
184472,5,DNK1,2005-12-04,Horsens,Aarhus,2,1,1,W
184473,5,DNK1,2005-12-04,Silkeborg,Aalborg,1,4,-3,L
184474,5,DNK1,2005-12-04,FC Kobenhavn,Viborg,3,1,2,W
184475,5,DNK1,2005-12-04,Nordsjalland,Brondby,0,2,-2,L
184476,5,DNK1,2006-03-11,Aarhus,SonderjyskE,1,1,0,D
184477,5,DNK1,2006-03-12,Odense,Nordsjalland,2,0,2,W
184478,5,DNK1,2006-03-12,Viborg,Silkeborg,2,3,-1,L
184479,5,DNK1,2006-03-12,Aalborg,Horsens,2,2,0,D
184480,5,DNK1,2006-03-12,Esbjerg fB,Midtjylland,2,0,2,W
184481,5,DNK1,2006-03-12,Brondby,FC Kobenhavn,3,0,3,W
184482,5,DNK1,2006-03-18,Silkeborg,Brondby,2,0,2,W
184483,5,DNK1,2006-03-19,Midtjylland,Aarhus,2,0,2,W
184484,5,DNK1,2006-03-19,Odense,Esbjerg fB,1,0,1,W
184485,5,DNK1,2006-03-19,SonderjyskE,Aalborg,2,2,0,D
184486,5,DNK1,2006-03-19,Horsens,Viborg,3,1,2,W
184487,5,DNK1,2006-03-19,FC Kobenhavn,Nordsjalland,3,3,0,D
184488,5,DNK1,2006-03-25,Esbjerg fB,Odense,1,0,1,W
184489,5,DNK1,2006-03-26,Aarhus,Midtjylland,1,2,-1,L
184490,5,DNK1,2006-03-26,Aalborg,SonderjyskE,2,2,0,D
184491,5,DNK1,2006-03-26,Viborg,Horsens,1,1,0,D
184492,5,DNK1,2006-03-26,Brondby,Silkeborg,3,1,2,W
184493,5,DNK1,2006-03-29,Brondby,Odense,1,0,1,W
184494,5,DNK1,2006-03-29,Nordsjalland,Viborg,1,3,-2,L
184495,5,DNK1,2006-03-29,FC Kobenhavn,Aalborg,1,0,1,W
184496,5,DNK1,2006-03-29,Silkeborg,Aarhus,1,0,1,W
184497,5,DNK1,2006-03-29,Horsens,Esbjerg fB,1,0,1,W
184498,5,DNK1,2006-03-29,SonderjyskE,Midtjylland,0,2,-2,L
184499,5,DNK1,2006-04-01,Aarhus,FC Kobenhavn,0,4,-4,L
184500,5,DNK1,2006-04-02,Aalborg,Nordsjalland,2,4,-2,L
184501,5,DNK1,2006-04-02,Esbjerg fB,Silkeborg,2,0,2,W
184502,5,DNK1,2006-04-02,Midtjylland,Horsens,0,0,0,D
184503,5,DNK1,2006-04-02,Odense,SonderjyskE,3,0,3,W
184504,5,DNK1,2006-04-02,Viborg,Brondby,2,0,2,W
184505,5,DNK1,2006-04-08,Brondby,Aalborg,4,3,1,W
184506,5,DNK1,2006-04-09,Silkeborg,Midtjylland,0,0,0,D
184507,5,DNK1,2006-04-09,Viborg,Odense,2,2,0,D
184508,5,DNK1,2006-04-09,Nordsjalland,Aarhus,3,1,2,W
184509,5,DNK1,2006-04-09,Horsens,SonderjyskE,2,0,2,W
184510,5,DNK1,2006-04-09,FC Kobenhavn,Esbjerg fB,2,1,1,W
184511,5,DNK1,2006-04-13,Esbjerg fB,Nordsjalland,4,0,4,W
184512,5,DNK1,2006-04-13,Aalborg,Viborg,1,1,0,D
184513,5,DNK1,2006-04-13,SonderjyskE,Silkeborg,2,0,2,W
184514,5,DNK1,2006-04-13,Midtjylland,FC Kobenhavn,1,3,-2,L
184515,5,DNK1,2006-04-13,Odense,Horsens,3,0,3,W
184516,5,DNK1,2006-04-13,Aarhus,Brondby,0,1,-1,L
184517,5,DNK1,2006-04-16,Silkeborg,Horsens,2,1,1,W
184518,5,DNK1,2006-04-17,Aalborg,Odense,0,0,0,D
184519,5,DNK1,2006-04-17,Viborg,Aarhus,2,2,0,D
184520,5,DNK1,2006-04-17,Nordsjalland,Midtjylland,2,2,0,D
184521,5,DNK1,2006-04-17,FC Kobenhavn,SonderjyskE,4,1,3,W
184522,5,DNK1,2006-04-17,Brondby,Esbjerg fB,3,0,3,W
184523,5,DNK1,2006-04-22,Horsens,FC Kobenhavn,0,1,-1,L
184524,5,DNK1,2006-04-23,SonderjyskE,Nordsjalland,2,2,0,D
184525,5,DNK1,2006-04-23,Esbjerg fB,Viborg,3,2,1,W
184526,5,DNK1,2006-04-23,Aarhus,Aalborg,1,1,0,D
184527,5,DNK1,2006-04-23,Odense,Silkeborg,2,1,1,W
184528,5,DNK1,2006-04-23,Midtjylland,Brondby,2,0,2,W
184529,5,DNK1,2006-04-26,Nordsjalland,FC Kobenhavn,1,1,0,D
184530,5,DNK1,2006-04-29,SonderjyskE,Aarhus,1,0,1,W
184531,5,DNK1,2006-04-30,Nordsjalland,Odense,0,3,-3,L
184532,5,DNK1,2006-04-30,Silkeborg,Viborg,1,3,-2,L
184533,5,DNK1,2006-04-30,Horsens,Aalborg,0,1,-1,L
184534,5,DNK1,2006-04-30,Midtjylland,Esbjerg fB,0,0,0,D
184535,5,DNK1,2006-04-30,FC Kobenhavn,Brondby,0,0,0,D
184536,5,DNK1,2006-05-04,Esbjerg fB,SonderjyskE,3,2,1,W
184537,5,DNK1,2006-05-04,Aarhus,Horsens,0,1,-1,L
184538,5,DNK1,2006-05-04,Aalborg,Silkeborg,1,0,1,W
184539,5,DNK1,2006-05-04,Viborg,FC Kobenhavn,0,1,-1,L
184540,5,DNK1,2006-05-04,Odense,Midtjylland,0,1,-1,L
184541,5,DNK1,2006-05-04,Brondby,Nordsjalland,3,1,2,W
184542,5,DNK1,2006-05-07,Esbjerg fB,Aarhus,1,3,-2,L
184543,5,DNK1,2006-05-07,Silkeborg,Nordsjalland,2,0,2,W
184544,5,DNK1,2006-05-07,Horsens,Brondby,4,1,3,W
184545,5,DNK1,2006-05-07,SonderjyskE,Viborg,0,4,-4,L
184546,5,DNK1,2006-05-07,Midtjylland,Aalborg,2,4,-2,L
184547,5,DNK1,2006-05-07,Odense,FC Kobenhavn,1,0,1,W
184548,5,DNK1,2006-05-14,Aarhus,Odense,0,2,-2,L
184549,5,DNK1,2006-05-14,Aalborg,Esbjerg fB,1,0,1,W
184550,5,DNK1,2006-05-14,Viborg,Midtjylland,1,1,0,D
184551,5,DNK1,2006-05-14,Brondby,SonderjyskE,1,2,-1,L
184552,5,DNK1,2006-05-14,Nordsjalland,Horsens,3,0,3,W
184553,5,DNK1,2006-05-14,FC Kobenhavn,Silkeborg,2,3,-1,L
184554,6,DNK1,2006-07-19,Nordsjalland,Randers FC,5,0,5,W
184555,6,DNK1,2006-07-19,Horsens,FC Kobenhavn,0,1,-1,L
184556,6,DNK1,2006-07-19,Aalborg,Viborg,3,1,2,W
184557,6,DNK1,2006-07-19,Esbjerg fB,Silkeborg,2,1,1,W
184558,6,DNK1,2006-07-19,Odense,Midtjylland,1,1,0,D
184559,6,DNK1,2006-07-19,Brondby,Vejle,2,1,1,W
184560,6,DNK1,2006-07-22,Silkeborg,FC Kobenhavn,1,4,-3,L
184561,6,DNK1,2006-07-23,Randers FC,Horsens,1,0,1,W
184562,6,DNK1,2006-07-23,Viborg,Midtjylland,0,1,-1,L
184563,6,DNK1,2006-07-23,Esbjerg fB,Aalborg,1,2,-1,L
184564,6,DNK1,2006-07-23,Brondby,Nordsjalland,2,1,1,W
184565,6,DNK1,2006-07-29,Odense,Esbjerg fB,0,2,-2,L
184566,6,DNK1,2006-07-30,Nordsjalland,Silkeborg,1,0,1,W
184567,6,DNK1,2006-07-30,Horsens,Viborg,2,2,0,D
184568,6,DNK1,2006-07-30,Aalborg,Vejle,4,0,4,W
184569,6,DNK1,2006-07-30,Midtjylland,Brondby,1,1,0,D
184570,6,DNK1,2006-08-02,Vejle,Odense,1,3,-2,L
184571,6,DNK1,2006-08-05,Viborg,FC Kobenhavn,1,3,-2,L
184572,6,DNK1,2006-08-05,Brondby,Horsens,3,0,3,W
184573,6,DNK1,2006-08-06,Vejle,Midtjylland,2,5,-3,L
184574,6,DNK1,2006-08-06,Silkeborg,Aalborg,0,2,-2,L
184575,6,DNK1,2006-08-06,Esbjerg fB,Nordsjalland,3,5,-2,L
184576,6,DNK1,2006-08-06,Odense,Randers FC,1,1,0,D
184577,6,DNK1,2006-08-12,Midtjylland,Aalborg,1,0,1,W
184578,6,DNK1,2006-08-13,Nordsjalland,Vejle,1,0,1,W
184579,6,DNK1,2006-08-13,Horsens,Esbjerg fB,1,1,0,D
184580,6,DNK1,2006-08-13,Randers FC,Brondby,1,1,0,D
184581,6,DNK1,2006-08-13,Viborg,Silkeborg,2,3,-1,L
184582,6,DNK1,2006-08-13,FC Kobenhavn,Odense,1,1,0,D
184583,6,DNK1,2006-08-19,Vejle,FC Kobenhavn,0,4,-4,L
184584,6,DNK1,2006-08-20,Silkeborg,Horsens,0,2,-2,L
184585,6,DNK1,2006-08-20,Aalborg,Randers FC,2,1,1,W
184586,6,DNK1,2006-08-20,Esbjerg fB,Midtjylland,4,2,2,W
184587,6,DNK1,2006-08-20,Odense,Nordsjalland,2,1,1,W
184588,6,DNK1,2006-08-20,Brondby,Viborg,3,0,3,W
184589,6,DNK1,2006-08-27,Horsens,Odense,0,2,-2,L
184590,6,DNK1,2006-08-27,Randers FC,Esbjerg fB,3,1,2,W
184591,6,DNK1,2006-08-27,Viborg,Vejle,1,0,1,W
184592,6,DNK1,2006-08-27,FC Kobenhavn,Aalborg,0,2,-2,L
184593,6,DNK1,2006-09-09,Esbjerg fB,FC Kobenhavn,2,2,0,D
184594,6,DNK1,2006-09-09,Aalborg,Brondby,1,1,0,D
184595,6,DNK1,2006-09-10,Nordsjalland,Horsens,0,0,0,D
184596,6,DNK1,2006-09-10,Randers FC,Vejle,2,1,1,W
184597,6,DNK1,2006-09-10,Silkeborg,Midtjylland,0,2,-2,L
184598,6,DNK1,2006-09-10,Odense,Viborg,2,0,2,W
184599,6,DNK1,2006-09-16,Vejle,Silkeborg,2,4,-2,L
184600,6,DNK1,2006-09-17,FC Kobenhavn,Nordsjalland,1,0,1,W
184601,6,DNK1,2006-09-17,Midtjylland,Horsens,1,2,-1,L
184602,6,DNK1,2006-09-17,Viborg,Randers FC,3,2,1,W
184603,6,DNK1,2006-09-17,Aalborg,Odense,0,1,-1,L
184604,6,DNK1,2006-09-17,Brondby,Esbjerg fB,2,0,2,W
184605,6,DNK1,2006-09-23,Horsens,Aalborg,0,0,0,D
184606,6,DNK1,2006-09-23,FC Kobenhavn,Midtjylland,2,1,1,W
184607,6,DNK1,2006-09-24,Nordsjalland,Viborg,2,0,2,W
184608,6,DNK1,2006-09-24,Randers FC,Silkeborg,0,0,0,D
184609,6,DNK1,2006-09-24,Esbjerg fB,Vejle,3,3,0,D
184610,6,DNK1,2006-09-24,Odense,Brondby,2,2,0,D
184611,6,DNK1,2006-09-30,Aalborg,Nordsjalland,0,3,-3,L
184612,6,DNK1,2006-10-01,Vejle,Horsens,2,2,0,D
184613,6,DNK1,2006-10-01,Midtjylland,Randers FC,2,1,1,W
184614,6,DNK1,2006-10-01,Silkeborg,Odense,0,1,-1,L
184615,6,DNK1,2006-10-01,Viborg,Esbjerg fB,0,4,-4,L
184616,6,DNK1,2006-10-01,FC Kobenhavn,Brondby,1,0,1,W
184617,6,DNK1,2006-10-04,Midtjylland,Nordsjalland,2,2,0,D
184618,6,DNK1,2006-10-14,Randers FC,FC Kobenhavn,0,2,-2,L
184619,6,DNK1,2006-10-15,Nordsjalland,Silkeborg,5,1,4,W
184620,6,DNK1,2006-10-15,Viborg,Vejle,2,1,1,W
184621,6,DNK1,2006-10-15,Esbjerg fB,Aalborg,0,2,-2,L
184622,6,DNK1,2006-10-15,Odense,Horsens,2,0,2,W
184623,6,DNK1,2006-10-15,Brondby,Midtjylland,1,3,-2,L
184624,6,DNK1,2006-10-18,Brondby,Silkeborg,1,1,0,D
184625,6,DNK1,2006-10-21,Horsens,Brondby,0,0,0,D
184626,6,DNK1,2006-10-22,Vejle,Nordsjalland,3,2,1,W
184627,6,DNK1,2006-10-22,Midtjylland,Odense,3,0,3,W
184628,6,DNK1,2006-10-22,Silkeborg,Esbjerg fB,1,2,-1,L
184629,6,DNK1,2006-10-22,Aalborg,Randers FC,0,4,-4,L
184630,6,DNK1,2006-10-22,FC Kobenhavn,Viborg,3,0,3,W
184631,6,DNK1,2006-10-25,Brondby,Aalborg,1,2,-1,L
184632,6,DNK1,2006-10-25,Nordsjalland,Midtjylland,1,4,-3,L
184633,6,DNK1,2006-10-25,Horsens,Esbjerg fB,1,1,0,D
184634,6,DNK1,2006-10-25,Randers FC,Vejle,0,1,-1,L
184635,6,DNK1,2006-10-25,Silkeborg,Viborg,1,2,-1,L
184636,6,DNK1,2006-10-25,Odense,FC Kobenhavn,0,0,0,D
184637,6,DNK1,2006-10-28,Esbjerg fB,Nordsjalland,1,0,1,W
184638,6,DNK1,2006-10-29,Midtjylland,Horsens,1,0,1,W
184639,6,DNK1,2006-10-29,Viborg,Randers FC,1,1,0,D
184640,6,DNK1,2006-10-29,Aalborg,Silkeborg,1,0,1,W
184641,6,DNK1,2006-10-29,Odense,Brondby,1,0,1,W
184642,6,DNK1,2006-10-29,FC Kobenhavn,Vejle,3,0,3,W
184643,6,DNK1,2006-11-04,Nordsjalland,Aalborg,1,1,0,D
184644,6,DNK1,2006-11-05,Vejle,Odense,1,2,-1,L
184645,6,DNK1,2006-11-05,Randers FC,Esbjerg fB,3,2,1,W
184646,6,DNK1,2006-11-05,Silkeborg,Midtjylland,0,1,-1,L
184647,6,DNK1,2006-11-05,Viborg,Horsens,1,0,1,W
184648,6,DNK1,2006-11-05,FC Kobenhavn,Brondby,3,1,2,W
184649,6,DNK1,2006-11-11,Brondby,Silkeborg,3,1,2,W
184650,6,DNK1,2006-11-12,Horsens,Randers FC,2,1,1,W
184651,6,DNK1,2006-11-12,Midtjylland,Viborg,3,1,2,W
184652,6,DNK1,2006-11-12,Esbjerg fB,Vejle,1,0,1,W
184653,6,DNK1,2006-11-12,Odense,Nordsjalland,0,1,-1,L
184654,6,DNK1,2006-11-12,Aalborg,FC Kobenhavn,0,1,-1,L
184655,6,DNK1,2006-11-18,FC Kobenhavn,Midtjylland,2,2,0,D
184656,6,DNK1,2006-11-19,Nordsjalland,Horsens,4,0,4,W
184657,6,DNK1,2006-11-19,Vejle,Aalborg,1,1,0,D
184658,6,DNK1,2006-11-19,Silkeborg,Odense,1,3,-2,L
184659,6,DNK1,2006-11-19,Viborg,Esbjerg fB,1,1,0,D
184660,6,DNK1,2006-11-19,Randers FC,Brondby,2,0,2,W
184661,6,DNK1,2006-11-26,FC Kobenhavn,Randers FC,2,1,1,W
184662,6,DNK1,2007-03-10,Midtjylland,Vejle,2,2,0,D
184663,6,DNK1,2007-03-11,Horsens,Silkeborg,2,1,1,W
184664,6,DNK1,2007-03-11,Aalborg,Viborg,0,2,-2,L
184665,6,DNK1,2007-03-11,Esbjerg fB,FC Kobenhavn,0,0,0,D
184666,6,DNK1,2007-03-11,Odense,Randers FC,1,2,-1,L
184667,6,DNK1,2007-03-11,Brondby,Nordsjalland,2,0,2,W
184668,6,DNK1,2007-03-17,Vejle,Silkeborg,0,2,-2,L
184669,6,DNK1,2007-03-18,FC Kobenhavn,Nordsjalland,1,1,0,D
184670,6,DNK1,2007-03-18,Randers FC,Midtjylland,0,0,0,D
184671,6,DNK1,2007-03-18,Aalborg,Horsens,4,0,4,W
184672,6,DNK1,2007-03-18,Esbjerg fB,Odense,1,2,-1,L
184673,6,DNK1,2007-03-18,Viborg,Brondby,1,1,0,D
184674,6,DNK1,2007-03-31,Horsens,FC Kobenhavn,1,3,-2,L
184675,6,DNK1,2007-04-01,Nordsjalland,Viborg,4,1,3,W
184676,6,DNK1,2007-04-01,Midtjylland,Esbjerg fB,3,1,2,W
184677,6,DNK1,2007-04-01,Silkeborg,Randers FC,0,0,0,D
184678,6,DNK1,2007-04-01,Odense,Aalborg,1,1,0,D
184679,6,DNK1,2007-04-01,Brondby,Vejle,4,0,4,W
184680,6,DNK1,2007-04-05,Vejle,Horsens,0,0,0,D
184681,6,DNK1,2007-04-05,Randers FC,Nordsjalland,1,6,-5,L
184682,6,DNK1,2007-04-05,Viborg,Odense,0,2,-2,L
184683,6,DNK1,2007-04-05,Aalborg,Midtjylland,0,2,-2,L
184684,6,DNK1,2007-04-05,FC Kobenhavn,Silkeborg,3,1,2,W
184685,6,DNK1,2007-04-05,Esbjerg fB,Brondby,1,1,0,D
184686,6,DNK1,2007-04-08,Brondby,Randers FC,3,0,3,W
184687,6,DNK1,2007-04-09,Nordsjalland,Esbjerg fB,1,1,0,D
184688,6,DNK1,2007-04-09,Horsens,Viborg,3,1,2,W
184689,6,DNK1,2007-04-09,Silkeborg,Aalborg,4,6,-2,L
184690,6,DNK1,2007-04-09,Odense,Vejle,3,2,1,W
184691,6,DNK1,2007-04-09,Midtjylland,FC Kobenhavn,1,4,-3,L
184692,6,DNK1,2007-04-14,Aalborg,Brondby,3,2,1,W
184693,6,DNK1,2007-04-15,Vejle,Randers FC,0,2,-2,L
184694,6,DNK1,2007-04-15,Midtjylland,Nordsjalland,1,1,0,D
184695,6,DNK1,2007-04-15,Viborg,Silkeborg,2,1,1,W
184696,6,DNK1,2007-04-15,Esbjerg fB,Horsens,0,1,-1,L
184697,6,DNK1,2007-04-15,FC Kobenhavn,Odense,4,2,2,W
184698,6,DNK1,2007-04-18,Horsens,Midtjylland,2,2,0,D
184699,6,DNK1,2007-04-18,Brondby,Viborg,3,1,2,W
184700,6,DNK1,2007-04-18,Randers FC,Aalborg,1,1,0,D
184701,6,DNK1,2007-04-18,Silkeborg,Vejle,1,1,0,D
184702,6,DNK1,2007-04-18,Odense,Esbjerg fB,0,0,0,D
184703,6,DNK1,2007-04-18,Nordsjalland,FC Kobenhavn,0,1,-1,L
184704,6,DNK1,2007-04-21,Midtjylland,Randers FC,2,1,1,W
184705,6,DNK1,2007-04-22,Nordsjalland,Odense,2,1,1,W
184706,6,DNK1,2007-04-22,Vejle,Brondby,3,0,3,W
184707,6,DNK1,2007-04-22,Viborg,Aalborg,0,2,-2,L
184708,6,DNK1,2007-04-22,Esbjerg fB,Silkeborg,0,3,-3,L
184709,6,DNK1,2007-04-22,FC Kobenhavn,Horsens,3,1,2,W
184710,6,DNK1,2007-04-28,Odense,Midtjylland,1,0,1,W
184711,6,DNK1,2007-04-29,Horsens,Nordsjalland,2,3,-1,L
184712,6,DNK1,2007-04-29,Randers FC,Viborg,3,2,1,W
184713,6,DNK1,2007-04-29,Silkeborg,FC Kobenhavn,0,1,-1,L
184714,6,DNK1,2007-04-29,Aalborg,Vejle,2,0,2,W
184715,6,DNK1,2007-04-29,Brondby,Esbjerg fB,2,1,1,W
184716,6,DNK1,2007-05-05,FC Kobenhavn,Aalborg,1,2,-1,L
184717,6,DNK1,2007-05-06,Vejle,Viborg,2,0,2,W
184718,6,DNK1,2007-05-06,Horsens,Odense,1,2,-1,L
184719,6,DNK1,2007-05-06,Midtjylland,Silkeborg,3,1,2,W
184720,6,DNK1,2007-05-06,Esbjerg fB,Randers FC,3,1,2,W
184721,6,DNK1,2007-05-06,Nordsjalland,Brondby,3,3,0,D
184722,6,DNK1,2007-05-09,Vejle,Esbjerg fB,3,0,3,W
184723,6,DNK1,2007-05-09,Randers FC,Odense,1,2,-1,L
184724,6,DNK1,2007-05-09,Silkeborg,Horsens,1,1,0,D
184725,6,DNK1,2007-05-09,Viborg,Midtjylland,0,1,-1,L
184726,6,DNK1,2007-05-09,Aalborg,Nordsjalland,1,1,0,D
184727,6,DNK1,2007-05-09,Brondby,FC Kobenhavn,0,1,-1,L
184728,6,DNK1,2007-05-12,Midtjylland,Brondby,1,1,0,D
184729,6,DNK1,2007-05-13,Nordsjalland,Vejle,3,0,3,W
184730,6,DNK1,2007-05-13,Horsens,Aalborg,1,4,-3,L
184731,6,DNK1,2007-05-13,Esbjerg fB,Viborg,2,2,0,D
184732,6,DNK1,2007-05-13,Odense,Silkeborg,2,0,2,W
184733,6,DNK1,2007-05-13,FC Kobenhavn,Randers FC,1,0,1,W
184734,6,DNK1,2007-05-19,Aalborg,Esbjerg fB,2,0,2,W
184735,6,DNK1,2007-05-20,Brondby,Odense,1,0,1,W
184736,6,DNK1,2007-05-20,Vejle,Midtjylland,1,2,-1,L
184737,6,DNK1,2007-05-20,Randers FC,Horsens,2,1,1,W
184738,6,DNK1,2007-05-20,Silkeborg,Nordsjalland,1,1,0,D
184739,6,DNK1,2007-05-20,Viborg,FC Kobenhavn,0,1,-1,L
184740,6,DNK1,2007-05-24,FC Kobenhavn,Esbjerg fB,1,2,-1,L
184741,6,DNK1,2007-05-24,Nordsjalland,Randers FC,4,2,2,W
184742,6,DNK1,2007-05-24,Horsens,Vejle,1,2,-1,L
184743,6,DNK1,2007-05-24,Midtjylland,Aalborg,2,1,1,W
184744,6,DNK1,2007-05-24,Silkeborg,Brondby,2,1,1,W
184745,6,DNK1,2007-05-24,Odense,Viborg,2,3,-1,L
184746,6,DNK1,2007-05-27,Brondby,Horsens,2,0,2,W
184747,6,DNK1,2007-05-27,Vejle,FC Kobenhavn,0,0,0,D
184748,6,DNK1,2007-05-27,Randers FC,Silkeborg,1,1,0,D
184749,6,DNK1,2007-05-27,Viborg,Nordsjalland,1,2,-1,L
184750,6,DNK1,2007-05-27,Aalborg,Odense,3,1,2,W
184751,6,DNK1,2007-05-27,Esbjerg fB,Midtjylland,3,0,3,W
184752,7,DNK1,2007-07-18,Nordsjalland,FC Kobenhavn,1,0,1,W
184753,7,DNK1,2007-07-18,Randers FC,Viborg,2,0,2,W
184754,7,DNK1,2007-07-18,Esbjerg fB,Brondby,1,0,1,W
184755,7,DNK1,2007-07-18,Aarhus,Horsens,1,2,-1,L
184756,7,DNK1,2007-07-21,Brondby,Nordsjalland,2,2,0,D
184757,7,DNK1,2007-07-22,Viborg,Esbjerg fB,0,5,-5,L
184758,7,DNK1,2007-07-22,Lyngby,Randers FC,0,3,-3,L
184759,7,DNK1,2007-07-22,Aarhus,Odense,0,2,-2,L
184760,7,DNK1,2007-07-23,Horsens,Midtjylland,2,1,1,W
184761,7,DNK1,2007-07-25,Odense,Lyngby,1,1,0,D
184762,7,DNK1,2007-07-25,Aalborg,FC Kobenhavn,1,1,0,D
184763,7,DNK1,2007-07-28,FC Kobenhavn,Viborg,3,1,2,W
184764,7,DNK1,2007-07-29,Odense,Horsens,3,3,0,D
184765,7,DNK1,2007-07-29,Nordsjalland,Lyngby,0,1,-1,L
184766,7,DNK1,2007-07-29,Midtjylland,Brondby,5,0,5,W
184767,7,DNK1,2007-07-30,Esbjerg fB,Aarhus,2,2,0,D
184768,7,DNK1,2007-08-01,Randers FC,Aalborg,5,0,5,W
184769,7,DNK1,2007-08-04,Aarhus,FC Kobenhavn,0,1,-1,L
184770,7,DNK1,2007-08-05,Esbjerg fB,Randers FC,1,3,-2,L
184771,7,DNK1,2007-08-05,Horsens,Aalborg,1,1,0,D
184772,7,DNK1,2007-08-05,Midtjylland,Viborg,1,0,1,W
184773,7,DNK1,2007-08-05,Brondby,Lyngby,3,0,3,W
184774,7,DNK1,2007-08-06,Odense,Nordsjalland,3,0,3,W
184775,7,DNK1,2007-08-08,Midtjylland,Aalborg,2,1,1,W
184776,7,DNK1,2007-08-11,FC Kobenhavn,Esbjerg fB,5,2,3,W
184777,7,DNK1,2007-08-12,Nordsjalland,Midtjylland,1,1,0,D
184778,7,DNK1,2007-08-12,Lyngby,Horsens,0,0,0,D
184779,7,DNK1,2007-08-12,Randers FC,Odense,0,0,0,D
184780,7,DNK1,2007-08-12,Aalborg,Aarhus,2,0,2,W
184781,7,DNK1,2007-08-13,Viborg,Brondby,1,1,0,D
184782,7,DNK1,2007-08-18,Brondby,Aarhus,0,1,-1,L
184783,7,DNK1,2007-08-19,Randers FC,Nordsjalland,1,1,0,D
184784,7,DNK1,2007-08-19,Viborg,Horsens,2,1,1,W
184785,7,DNK1,2007-08-19,Aalborg,Odense,2,3,-1,L
184786,7,DNK1,2007-08-19,FC Kobenhavn,Midtjylland,0,0,0,D
184787,7,DNK1,2007-08-20,Lyngby,Esbjerg fB,1,6,-5,L
184788,7,DNK1,2007-08-25,Odense,FC Kobenhavn,0,0,0,D
184789,7,DNK1,2007-08-26,Esbjerg fB,Aalborg,1,2,-1,L
184790,7,DNK1,2007-08-26,Midtjylland,Randers FC,3,2,1,W
184791,7,DNK1,2007-08-26,Nordsjalland,Viborg,4,0,4,W
184792,7,DNK1,2007-08-26,Horsens,Brondby,4,2,2,W
184793,7,DNK1,2007-08-27,Aarhus,Lyngby,0,0,0,D
184794,7,DNK1,2007-09-01,Viborg,Aarhus,2,0,2,W
184795,7,DNK1,2007-09-02,Lyngby,Midtjylland,1,2,-1,L
184796,7,DNK1,2007-09-02,Horsens,Esbjerg fB,4,3,1,W
184797,7,DNK1,2007-09-02,FC Kobenhavn,Randers FC,1,0,1,W
184798,7,DNK1,2007-09-02,Brondby,Odense,1,1,0,D
184799,7,DNK1,2007-09-03,Aalborg,Nordsjalland,2,1,1,W
184800,7,DNK1,2007-09-15,FC Kobenhavn,Horsens,1,0,1,W
184801,7,DNK1,2007-09-16,Midtjylland,Odense,2,1,1,W
184802,7,DNK1,2007-09-16,Viborg,Lyngby,2,1,1,W
184803,7,DNK1,2007-09-16,Randers FC,Aarhus,0,1,-1,L
184804,7,DNK1,2007-09-16,Aalborg,Brondby,3,0,3,W
184805,7,DNK1,2007-09-17,Nordsjalland,Esbjerg fB,3,1,2,W
184806,7,DNK1,2007-09-22,Aarhus,Nordsjalland,1,2,-1,L
184807,7,DNK1,2007-09-23,Lyngby,Aalborg,3,4,-1,L
184808,7,DNK1,2007-09-23,Horsens,Randers FC,1,0,1,W
184809,7,DNK1,2007-09-23,Brondby,FC Kobenhavn,0,1,-1,L
184810,7,DNK1,2007-09-23,Esbjerg fB,Midtjylland,2,0,2,W
184811,7,DNK1,2007-09-24,Odense,Viborg,4,0,4,W
184812,7,DNK1,2007-09-29,FC Kobenhavn,Lyngby,2,0,2,W
184813,7,DNK1,2007-09-30,Aalborg,Viborg,3,2,1,W
184814,7,DNK1,2007-09-30,Midtjylland,Aarhus,2,0,2,W
184815,7,DNK1,2007-09-30,Odense,Esbjerg fB,1,1,0,D
184816,7,DNK1,2007-09-30,Brondby,Randers FC,1,1,0,D
184817,7,DNK1,2007-10-01,Nordsjalland,Horsens,0,0,0,D
184818,7,DNK1,2007-10-06,Viborg,Brondby,1,2,-1,L
184819,7,DNK1,2007-10-07,Randers FC,Midtjylland,3,0,3,W
184820,7,DNK1,2007-10-07,Esbjerg fB,Odense,0,0,0,D
184821,7,DNK1,2007-10-07,Horsens,Lyngby,2,1,1,W
184822,7,DNK1,2007-10-07,FC Kobenhavn,Nordsjalland,1,1,0,D
184823,7,DNK1,2007-10-08,Aarhus,Aalborg,3,5,-2,L
184824,7,DNK1,2007-10-20,Aalborg,FC Kobenhavn,0,0,0,D
184825,7,DNK1,2007-10-21,Nordsjalland,Randers FC,2,1,1,W
184826,7,DNK1,2007-10-21,Lyngby,Viborg,2,0,2,W
184827,7,DNK1,2007-10-21,Odense,Horsens,2,0,2,W
184828,7,DNK1,2007-10-21,Brondby,Aarhus,2,1,1,W
184829,7,DNK1,2007-10-22,Midtjylland,Esbjerg fB,2,2,0,D
184830,7,DNK1,2007-10-27,Lyngby,Aarhus,1,3,-2,L
184831,7,DNK1,2007-10-28,Midtjylland,Viborg,2,1,1,W
184832,7,DNK1,2007-10-28,FC Kobenhavn,Randers FC,0,1,-1,L
184833,7,DNK1,2007-10-28,Nordsjalland,Horsens,1,2,-1,L
184834,7,DNK1,2007-10-28,Odense,Brondby,0,0,0,D
184835,7,DNK1,2007-10-29,Aalborg,Esbjerg fB,2,0,2,W
184836,7,DNK1,2007-11-03,Aarhus,FC Kobenhavn,0,2,-2,L
184837,7,DNK1,2007-11-04,Esbjerg fB,Nordsjalland,1,2,-1,L
184838,7,DNK1,2007-11-04,Randers FC,Aalborg,1,0,1,W
184839,7,DNK1,2007-11-04,Horsens,Midtjylland,1,1,0,D
184840,7,DNK1,2007-11-04,Brondby,Lyngby,3,0,3,W
184841,7,DNK1,2007-11-05,Viborg,Odense,0,2,-2,L
184842,7,DNK1,2007-11-10,Brondby,Horsens,3,0,3,W
184843,7,DNK1,2007-11-11,Odense,Randers FC,0,0,0,D
184844,7,DNK1,2007-11-11,Lyngby,Esbjerg fB,1,3,-2,L
184845,7,DNK1,2007-11-11,Nordsjalland,Aalborg,1,2,-1,L
184846,7,DNK1,2007-11-11,Midtjylland,FC Kobenhavn,2,2,0,D
184847,7,DNK1,2007-11-12,Viborg,Aarhus,0,2,-2,L
184848,7,DNK1,2007-11-24,FC Kobenhavn,Odense,2,1,1,W
184849,7,DNK1,2007-11-25,Randers FC,Lyngby,2,2,0,D
184850,7,DNK1,2007-11-25,Aalborg,Midtjylland,1,0,1,W
184851,7,DNK1,2007-11-25,Horsens,Viborg,1,1,0,D
184852,7,DNK1,2007-11-25,Esbjerg fB,Brondby,3,2,1,W
184853,7,DNK1,2007-11-29,Aarhus,Nordsjalland,3,3,0,D
184854,7,DNK1,2007-12-01,Randers FC,Viborg,0,2,-2,L
184855,7,DNK1,2007-12-02,Nordsjalland,Odense,3,3,0,D
184856,7,DNK1,2007-12-02,Aarhus,Midtjylland,2,0,2,W
184857,7,DNK1,2007-12-02,Aalborg,Lyngby,5,3,2,W
184858,7,DNK1,2007-12-02,FC Kobenhavn,Brondby,1,1,0,D
184859,7,DNK1,2007-12-03,Esbjerg fB,Horsens,1,3,-2,L
184860,7,DNK1,2008-03-15,Odense,Aalborg,1,1,0,D
184861,7,DNK1,2008-03-16,Horsens,Aarhus,0,0,0,D
184862,7,DNK1,2008-03-16,Viborg,Esbjerg fB,0,4,-4,L
184863,7,DNK1,2008-03-16,Lyngby,FC Kobenhavn,1,4,-3,L
184864,7,DNK1,2008-03-16,Brondby,Randers FC,3,1,2,W
184865,7,DNK1,2008-03-17,Midtjylland,Nordsjalland,1,0,1,W
184866,7,DNK1,2008-03-19,Horsens,Aalborg,1,2,-1,L
184867,7,DNK1,2008-03-19,Esbjerg fB,FC Kobenhavn,2,1,1,W
184868,7,DNK1,2008-03-20,Aarhus,Randers FC,0,0,0,D
184869,7,DNK1,2008-03-20,Viborg,Nordsjalland,2,3,-1,L
184870,7,DNK1,2008-03-20,Brondby,Midtjylland,2,1,1,W
184871,7,DNK1,2008-03-22,FC Kobenhavn,Horsens,1,0,1,W
184872,7,DNK1,2008-03-23,Midtjylland,Lyngby,2,1,1,W
184873,7,DNK1,2008-03-23,Randers FC,Esbjerg fB,1,0,1,W
184874,7,DNK1,2008-03-23,Aalborg,Viborg,2,0,2,W
184875,7,DNK1,2008-03-23,Nordsjalland,Brondby,1,0,1,W
184876,7,DNK1,2008-03-23,Odense,Aarhus,2,0,2,W
184877,7,DNK1,2008-03-29,Odense,Midtjylland,0,1,-1,L
184878,7,DNK1,2008-03-30,Horsens,Randers FC,1,0,1,W
184879,7,DNK1,2008-03-30,Aarhus,Esbjerg fB,0,1,-1,L
184880,7,DNK1,2008-03-30,Lyngby,Nordsjalland,0,0,0,D
184881,7,DNK1,2008-03-30,Brondby,Aalborg,0,1,-1,L
184882,7,DNK1,2008-03-31,Viborg,FC Kobenhavn,2,3,-1,L
184883,7,DNK1,2008-04-02,Lyngby,Odense,0,3,-3,L
184884,7,DNK1,2008-04-05,Horsens,Brondby,1,3,-2,L
184885,7,DNK1,2008-04-06,Randers FC,Odense,0,2,-2,L
184886,7,DNK1,2008-04-06,Esbjerg fB,Lyngby,2,1,1,W
184887,7,DNK1,2008-04-06,Aalborg,Nordsjalland,3,1,2,W
184888,7,DNK1,2008-04-06,FC Kobenhavn,Midtjylland,0,2,-2,L
184889,7,DNK1,2008-04-07,Aarhus,Viborg,0,0,0,D
184890,7,DNK1,2008-04-12,Brondby,Esbjerg fB,2,1,1,W
184891,7,DNK1,2008-04-13,Midtjylland,Aalborg,2,0,2,W
184892,7,DNK1,2008-04-13,Nordsjalland,Aarhus,3,2,1,W
184893,7,DNK1,2008-04-13,Lyngby,Randers FC,0,0,0,D
184894,7,DNK1,2008-04-13,Odense,FC Kobenhavn,0,0,0,D
184895,7,DNK1,2008-04-14,Viborg,Horsens,1,3,-2,L
184896,7,DNK1,2008-04-19,Randers FC,FC Kobenhavn,2,1,1,W
184897,7,DNK1,2008-04-20,Aarhus,Lyngby,3,1,2,W
184898,7,DNK1,2008-04-20,Viborg,Midtjylland,1,1,0,D
184899,7,DNK1,2008-04-20,Horsens,Nordsjalland,2,0,2,W
184900,7,DNK1,2008-04-20,Brondby,Odense,0,2,-2,L
184901,7,DNK1,2008-04-21,Esbjerg fB,Aalborg,1,1,0,D
184902,7,DNK1,2008-04-23,Odense,Viborg,1,0,1,W
184903,7,DNK1,2008-04-23,Lyngby,Brondby,2,2,0,D
184904,7,DNK1,2008-04-23,Midtjylland,Horsens,1,1,0,D
184905,7,DNK1,2008-04-24,FC Kobenhavn,Aarhus,1,1,0,D
184906,7,DNK1,2008-04-24,Nordsjalland,Esbjerg fB,3,2,1,W
184907,7,DNK1,2008-04-24,Aalborg,Randers FC,3,0,3,W
184908,7,DNK1,2008-04-26,Midtjylland,Brondby,1,1,0,D
184909,7,DNK1,2008-04-27,Odense,Lyngby,1,1,0,D
184910,7,DNK1,2008-04-27,Randers FC,Aarhus,4,1,3,W
184911,7,DNK1,2008-04-27,Nordsjalland,Viborg,5,3,2,W
184912,7,DNK1,2008-04-27,FC Kobenhavn,Esbjerg fB,2,1,1,W
184913,7,DNK1,2008-04-28,Aalborg,Horsens,1,0,1,W
184914,7,DNK1,2008-05-03,Aarhus,Odense,0,2,-2,L
184915,7,DNK1,2008-05-04,Lyngby,Midtjylland,1,2,-1,L
184916,7,DNK1,2008-05-04,Esbjerg fB,Randers FC,3,2,1,W
184917,7,DNK1,2008-05-04,Brondby,Nordsjalland,3,0,3,W
184918,7,DNK1,2008-05-04,Viborg,Aalborg,0,1,-1,L
184919,7,DNK1,2008-05-05,Horsens,FC Kobenhavn,3,2,1,W
184920,7,DNK1,2008-05-07,Midtjylland,Randers FC,2,1,1,W
184921,7,DNK1,2008-05-07,Odense,Esbjerg fB,1,1,0,D
184922,7,DNK1,2008-05-07,Brondby,Viborg,1,1,0,D
184923,7,DNK1,2008-05-08,Aalborg,Aarhus,3,1,2,W
184924,7,DNK1,2008-05-08,Lyngby,Horsens,4,1,3,W
184925,7,DNK1,2008-05-08,Nordsjalland,FC Kobenhavn,1,2,-1,L
184926,7,DNK1,2008-05-11,Horsens,Odense,2,2,0,D
184927,7,DNK1,2008-05-11,Aarhus,Brondby,1,1,0,D
184928,7,DNK1,2008-05-12,Randers FC,Nordsjalland,2,1,1,W
184929,7,DNK1,2008-05-12,Esbjerg fB,Midtjylland,3,2,1,W
184930,7,DNK1,2008-05-12,Viborg,Lyngby,3,2,1,W
184931,7,DNK1,2008-05-12,FC Kobenhavn,Aalborg,4,0,4,W
184932,7,DNK1,2008-05-15,Midtjylland,Odense,3,1,2,W
184933,7,DNK1,2008-05-15,FC Kobenhavn,Viborg,3,0,3,W
184934,7,DNK1,2008-05-15,Randers FC,Horsens,0,0,0,D
184935,7,DNK1,2008-05-15,Nordsjalland,Lyngby,0,0,0,D
184936,7,DNK1,2008-05-15,Esbjerg fB,Aarhus,0,1,-1,L
184937,7,DNK1,2008-05-15,Aalborg,Brondby,2,0,2,W
184938,7,DNK1,2008-05-18,Midtjylland,Aarhus,3,2,1,W
184939,7,DNK1,2008-05-18,Odense,Nordsjalland,1,1,0,D
184940,7,DNK1,2008-05-18,Lyngby,Aalborg,0,2,-2,L
184941,7,DNK1,2008-05-18,Viborg,Randers FC,0,1,-1,L
184942,7,DNK1,2008-05-18,Horsens,Esbjerg fB,3,1,2,W
184943,7,DNK1,2008-05-18,Brondby,FC Kobenhavn,2,1,1,W
184944,7,DNK1,2008-05-24,Esbjerg fB,Viborg,2,1,1,W
184945,7,DNK1,2008-05-24,Randers FC,Brondby,2,1,1,W
184946,7,DNK1,2008-05-24,FC Kobenhavn,Lyngby,3,1,2,W
184947,7,DNK1,2008-05-24,Aalborg,Odense,2,0,2,W
184948,7,DNK1,2008-05-24,Nordsjalland,Midtjylland,0,3,-3,L
184949,7,DNK1,2008-05-24,Aarhus,Horsens,1,2,-1,L
184950,8,DNK1,2008-07-19,Randers FC,Aarhus,3,1,2,W
184951,8,DNK1,2008-07-20,Horsens,SonderjyskE,2,0,2,W
184952,8,DNK1,2008-07-20,Nordsjalland,Brondby,0,2,-2,L
184953,8,DNK1,2008-07-20,Aalborg,Midtjylland,1,2,-1,L
184954,8,DNK1,2008-07-21,FC Kobenhavn,Esbjerg fB,1,0,1,W
184955,8,DNK1,2008-07-23,Vejle,Odense,1,3,-2,L
184956,8,DNK1,2008-07-26,Brondby,Aalborg,2,1,1,W
184957,8,DNK1,2008-07-27,Esbjerg fB,Vejle,0,1,-1,L
184958,8,DNK1,2008-07-27,SonderjyskE,Midtjylland,1,1,0,D
184959,8,DNK1,2008-07-27,Randers FC,FC Kobenhavn,1,1,0,D
184960,8,DNK1,2008-07-28,Aarhus,Horsens,3,1,2,W
184961,8,DNK1,2008-08-02,Vejle,Aalborg,2,3,-1,L
184962,8,DNK1,2008-08-03,Midtjylland,Horsens,2,1,1,W
184963,8,DNK1,2008-08-03,Odense,Aarhus,3,1,2,W
184964,8,DNK1,2008-08-03,Esbjerg fB,Nordsjalland,1,1,0,D
184965,8,DNK1,2008-08-03,Brondby,Randers FC,0,3,-3,L
184966,8,DNK1,2008-08-04,SonderjyskE,FC Kobenhavn,1,1,0,D
184967,8,DNK1,2008-08-06,Odense,Nordsjalland,3,1,2,W
184968,8,DNK1,2008-08-09,Aalborg,Esbjerg fB,1,1,0,D
184969,8,DNK1,2008-08-09,Horsens,Brondby,0,1,-1,L
184970,8,DNK1,2008-08-10,Nordsjalland,Randers FC,1,1,0,D
184971,8,DNK1,2008-08-10,Midtjylland,Odense,4,0,4,W
184972,8,DNK1,2008-08-10,FC Kobenhavn,Aarhus,1,0,1,W
184973,8,DNK1,2008-08-11,Vejle,SonderjyskE,2,1,1,W
184974,8,DNK1,2008-08-16,Randers FC,Esbjerg fB,1,1,0,D
184975,8,DNK1,2008-08-17,Aalborg,Odense,0,3,-3,L
184976,8,DNK1,2008-08-17,Horsens,Vejle,0,0,0,D
184977,8,DNK1,2008-08-17,FC Kobenhavn,Midtjylland,3,1,2,W
184978,8,DNK1,2008-08-17,Aarhus,Brondby,2,1,1,W
184979,8,DNK1,2008-08-17,Nordsjalland,SonderjyskE,0,1,-1,L
184980,8,DNK1,2008-08-30,Odense,Randers FC,2,1,1,W
184981,8,DNK1,2008-08-31,Aarhus,Nordsjalland,0,3,-3,L
184982,8,DNK1,2008-08-31,Esbjerg fB,Horsens,0,1,-1,L
184983,8,DNK1,2008-08-31,SonderjyskE,Aalborg,1,2,-1,L
184984,8,DNK1,2008-08-31,Brondby,FC Kobenhavn,1,0,1,W
184985,8,DNK1,2008-09-01,Midtjylland,Vejle,1,1,0,D
184986,8,DNK1,2008-09-13,Aalborg,Aarhus,0,2,-2,L
184987,8,DNK1,2008-09-14,Midtjylland,Esbjerg fB,3,1,2,W
184988,8,DNK1,2008-09-14,Horsens,Randers FC,1,1,0,D
184989,8,DNK1,2008-09-14,Vejle,Brondby,0,0,0,D
184990,8,DNK1,2008-09-15,Odense,SonderjyskE,2,0,2,W
184991,8,DNK1,2008-09-20,Horsens,Odense,1,2,-1,L
184992,8,DNK1,2008-09-21,Aarhus,SonderjyskE,2,1,1,W
184993,8,DNK1,2008-09-21,Nordsjalland,Vejle,2,1,1,W
184994,8,DNK1,2008-09-21,Randers FC,Midtjylland,0,0,0,D
184995,8,DNK1,2008-09-21,FC Kobenhavn,Aalborg,3,0,3,W
184996,8,DNK1,2008-09-22,Brondby,Esbjerg fB,2,1,1,W
184997,8,DNK1,2008-09-24,FC Kobenhavn,Nordsjalland,2,1,1,W
184998,8,DNK1,2008-10-04,Aalborg,Horsens,1,1,0,D
184999,8,DNK1,2008-10-05,Esbjerg fB,Aarhus,1,0,1,W
185000,8,DNK1,2008-10-05,SonderjyskE,Randers FC,1,0,1,W
185001,8,DNK1,2008-10-05,Midtjylland,Nordsjalland,1,0,1,W
185002,8,DNK1,2008-10-05,Odense,Brondby,0,1,-1,L
185003,8,DNK1,2008-10-06,Vejle,FC Kobenhavn,0,3,-3,L
185004,8,DNK1,2008-10-18,Aalborg,Nordsjalland,1,2,-1,L
185005,8,DNK1,2008-10-18,Horsens,FC Kobenhavn,0,1,-1,L
185006,8,DNK1,2008-10-19,Randers FC,Vejle,1,1,0,D
185007,8,DNK1,2008-10-19,Odense,Esbjerg fB,4,2,2,W
185008,8,DNK1,2008-10-19,SonderjyskE,Brondby,2,2,0,D
185009,8,DNK1,2008-10-20,Midtjylland,Aarhus,2,1,1,W
185010,8,DNK1,2008-10-25,Aarhus,Vejle,2,1,1,W
185011,8,DNK1,2008-10-26,Nordsjalland,Horsens,3,1,2,W
185012,8,DNK1,2008-10-26,Brondby,Midtjylland,3,0,3,W
185013,8,DNK1,2008-10-26,Randers FC,Aalborg,2,2,0,D
185014,8,DNK1,2008-10-26,FC Kobenhavn,Odense,0,0,0,D
185015,8,DNK1,2008-10-27,Esbjerg fB,SonderjyskE,0,0,0,D
185016,8,DNK1,2008-11-01,Odense,Aalborg,1,1,0,D
185017,8,DNK1,2008-11-02,Nordsjalland,Esbjerg fB,1,1,0,D
185018,8,DNK1,2008-11-02,Aarhus,Midtjylland,2,1,1,W
185019,8,DNK1,2008-11-02,SonderjyskE,Randers FC,1,4,-3,L
185020,8,DNK1,2008-11-02,Vejle,FC Kobenhavn,1,1,0,D
185021,8,DNK1,2008-11-03,Brondby,Horsens,4,3,1,W
185022,8,DNK1,2008-11-08,Esbjerg fB,Odense,1,2,-1,L
185023,8,DNK1,2008-11-09,Horsens,Aarhus,1,1,0,D
185024,8,DNK1,2008-11-09,Randers FC,Nordsjalland,3,2,1,W
185025,8,DNK1,2008-11-09,FC Kobenhavn,SonderjyskE,4,0,4,W
185026,8,DNK1,2008-11-09,Aalborg,Brondby,0,0,0,D
185027,8,DNK1,2008-11-10,Midtjylland,Vejle,2,0,2,W
185028,8,DNK1,2008-11-15,Aarhus,SonderjyskE,0,0,0,D
185029,8,DNK1,2008-11-15,Brondby,Nordsjalland,2,1,1,W
185030,8,DNK1,2008-11-16,Odense,Vejle,2,0,2,W
185031,8,DNK1,2008-11-16,Horsens,Randers FC,2,2,0,D
185032,8,DNK1,2008-11-16,Aalborg,Esbjerg fB,2,1,1,W
185033,8,DNK1,2008-11-16,Midtjylland,FC Kobenhavn,0,3,-3,L
185034,8,DNK1,2008-11-22,SonderjyskE,Brondby,0,6,-6,L
185035,8,DNK1,2008-11-22,Vejle,Aalborg,0,3,-3,L
185036,8,DNK1,2008-11-23,Esbjerg fB,Horsens,1,0,1,W
185037,8,DNK1,2008-11-23,Nordsjalland,Odense,1,4,-3,L
185038,8,DNK1,2008-11-23,FC Kobenhavn,Aarhus,2,1,1,W
185039,8,DNK1,2008-11-24,Randers FC,Midtjylland,1,2,-1,L
185040,8,DNK1,2008-11-29,Brondby,Vejle,2,0,2,W
185041,8,DNK1,2008-11-30,Midtjylland,Nordsjalland,3,0,3,W
185042,8,DNK1,2008-11-30,Horsens,SonderjyskE,0,3,-3,L
185043,8,DNK1,2008-11-30,Esbjerg fB,Randers FC,2,2,0,D
185044,8,DNK1,2008-11-30,Aalborg,FC Kobenhavn,3,1,2,W
185045,8,DNK1,2008-12-01,Aarhus,Odense,2,1,1,W
185046,8,DNK1,2008-12-06,Odense,Brondby,0,1,-1,L
185047,8,DNK1,2008-12-07,SonderjyskE,Midtjylland,1,1,0,D
185048,8,DNK1,2008-12-07,Vejle,Esbjerg fB,1,1,0,D
185049,8,DNK1,2008-12-07,Randers FC,Aalborg,1,2,-1,L
185050,8,DNK1,2008-12-07,FC Kobenhavn,Horsens,5,2,3,W
185051,8,DNK1,2008-12-08,Nordsjalland,Aarhus,0,0,0,D
185052,8,DNK1,2009-02-28,Midtjylland,Esbjerg fB,1,1,0,D
185053,8,DNK1,2009-03-01,Odense,SonderjyskE,2,0,2,W
185054,8,DNK1,2009-03-01,Vejle,Nordsjalland,1,1,0,D
185055,8,DNK1,2009-03-01,Aarhus,Randers FC,1,2,-1,L
185056,8,DNK1,2009-03-01,Horsens,Aalborg,0,1,-1,L
185057,8,DNK1,2009-03-02,Brondby,FC Kobenhavn,0,1,-1,L
185058,8,DNK1,2009-03-07,Randers FC,FC Kobenhavn,0,3,-3,L
185059,8,DNK1,2009-03-08,Horsens,Odense,2,1,1,W
185060,8,DNK1,2009-03-08,Esbjerg fB,SonderjyskE,0,0,0,D
185061,8,DNK1,2009-03-08,Aalborg,Nordsjalland,1,1,0,D
185062,8,DNK1,2009-03-08,Midtjylland,Brondby,1,1,0,D
185063,8,DNK1,2009-03-09,Aarhus,Vejle,1,1,0,D
185064,8,DNK1,2009-03-14,Odense,Midtjylland,2,1,1,W
185065,8,DNK1,2009-03-15,FC Kobenhavn,Esbjerg fB,0,2,-2,L
185066,8,DNK1,2009-03-15,Nordsjalland,Horsens,1,2,-1,L
185067,8,DNK1,2009-03-15,SonderjyskE,Aalborg,1,1,0,D
185068,8,DNK1,2009-03-15,Brondby,Aarhus,2,0,2,W
185069,8,DNK1,2009-03-16,Vejle,Randers FC,1,1,0,D
185070,8,DNK1,2009-03-21,Randers FC,Brondby,0,2,-2,L
185071,8,DNK1,2009-03-22,Esbjerg fB,Aarhus,1,0,1,W
185072,8,DNK1,2009-03-22,SonderjyskE,Nordsjalland,1,3,-2,L
185073,8,DNK1,2009-03-22,Horsens,Vejle,0,0,0,D
185074,8,DNK1,2009-03-22,FC Kobenhavn,Odense,2,1,1,W
185075,8,DNK1,2009-03-23,Aalborg,Midtjylland,3,2,1,W
185076,8,DNK1,2009-04-04,Nordsjalland,FC Kobenhavn,0,3,-3,L
185077,8,DNK1,2009-04-05,Aarhus,Aalborg,1,2,-1,L
185078,8,DNK1,2009-04-05,Vejle,SonderjyskE,3,2,1,W
185079,8,DNK1,2009-04-05,Midtjylland,Horsens,3,1,2,W
185080,8,DNK1,2009-04-05,Brondby,Esbjerg fB,1,0,1,W
185081,8,DNK1,2009-04-06,Odense,Randers FC,3,1,2,W
185082,8,DNK1,2009-04-08,SonderjyskE,FC Kobenhavn,1,2,-1,L
185083,8,DNK1,2009-04-09,Odense,Esbjerg fB,2,1,1,W
185084,8,DNK1,2009-04-09,Aarhus,Horsens,1,0,1,W
185085,8,DNK1,2009-04-09,Brondby,Aalborg,2,0,2,W
185086,8,DNK1,2009-04-10,Nordsjalland,Randers FC,6,1,5,W
185087,8,DNK1,2009-04-10,Vejle,Midtjylland,2,3,-1,L
185088,8,DNK1,2009-04-12,Aalborg,Odense,0,1,-1,L
185089,8,DNK1,2009-04-12,Horsens,Brondby,3,0,3,W
185090,8,DNK1,2009-04-13,Midtjylland,Aarhus,3,2,1,W
185091,8,DNK1,2009-04-13,Randers FC,SonderjyskE,3,1,2,W
185092,8,DNK1,2009-04-13,FC Kobenhavn,Vejle,4,1,3,W
185093,8,DNK1,2009-04-14,Esbjerg fB,Nordsjalland,1,2,-1,L
185094,8,DNK1,2009-04-18,Brondby,SonderjyskE,5,1,4,W
185095,8,DNK1,2009-04-19,Midtjylland,Randers FC,0,2,-2,L
185096,8,DNK1,2009-04-19,Horsens,Esbjerg fB,1,1,0,D
185097,8,DNK1,2009-04-19,Odense,Nordsjalland,3,0,3,W
185098,8,DNK1,2009-04-19,Aarhus,FC Kobenhavn,1,0,1,W
185099,8,DNK1,2009-04-20,Aalborg,Vejle,0,0,0,D
185100,8,DNK1,2009-04-22,Randers FC,Horsens,5,1,4,W
185101,8,DNK1,2009-04-22,SonderjyskE,Aarhus,0,3,-3,L
185102,8,DNK1,2009-04-22,FC Kobenhavn,Midtjylland,2,1,1,W
185103,8,DNK1,2009-04-23,Esbjerg fB,Aalborg,3,1,2,W
185104,8,DNK1,2009-04-23,Nordsjalland,Brondby,1,2,-1,L
185105,8,DNK1,2009-04-23,Vejle,Odense,0,5,-5,L
185106,8,DNK1,2009-04-25,Horsens,FC Kobenhavn,0,2,-2,L
185107,8,DNK1,2009-04-26,Aarhus,Nordsjalland,1,0,1,W
185108,8,DNK1,2009-04-26,Aalborg,Randers FC,1,2,-1,L
185109,8,DNK1,2009-04-26,Esbjerg fB,Vejle,3,2,1,W
185110,8,DNK1,2009-04-26,Brondby,Odense,0,0,0,D
185111,8,DNK1,2009-04-27,Midtjylland,SonderjyskE,2,4,-2,L
185112,8,DNK1,2009-05-02,Vejle,Brondby,1,3,-2,L
185113,8,DNK1,2009-05-03,Nordsjalland,Midtjylland,0,2,-2,L
185114,8,DNK1,2009-05-03,SonderjyskE,Horsens,2,0,2,W
185115,8,DNK1,2009-05-03,Randers FC,Esbjerg fB,1,0,1,W
185116,8,DNK1,2009-05-03,FC Kobenhavn,Aalborg,3,0,3,W
185117,8,DNK1,2009-05-04,Odense,Aarhus,6,1,5,W
185118,8,DNK1,2009-05-08,Horsens,Midtjylland,2,3,-1,L
185119,8,DNK1,2009-05-09,FC Kobenhavn,Nordsjalland,3,1,2,W
185120,8,DNK1,2009-05-10,SonderjyskE,Vejle,0,0,0,D
185121,8,DNK1,2009-05-10,Randers FC,Odense,0,0,0,D
185122,8,DNK1,2009-05-10,Esbjerg fB,Brondby,1,2,-1,L
185123,8,DNK1,2009-05-11,Aalborg,Aarhus,1,1,0,D
185124,8,DNK1,2009-05-13,Nordsjalland,SonderjyskE,0,0,0,D
185125,8,DNK1,2009-05-13,Odense,FC Kobenhavn,3,2,1,W
185126,8,DNK1,2009-05-13,Vejle,Horsens,1,1,0,D
185127,8,DNK1,2009-05-14,Midtjylland,Aalborg,2,1,1,W
185128,8,DNK1,2009-05-14,Aarhus,Esbjerg fB,3,1,2,W
185129,8,DNK1,2009-05-14,Brondby,Randers FC,3,0,3,W
185130,8,DNK1,2009-05-16,SonderjyskE,Odense,1,1,0,D
185131,8,DNK1,2009-05-17,Aalborg,Horsens,2,2,0,D
185132,8,DNK1,2009-05-17,Esbjerg fB,Midtjylland,1,0,1,W
185133,8,DNK1,2009-05-17,Randers FC,Aarhus,1,1,0,D
185134,8,DNK1,2009-05-17,FC Kobenhavn,Brondby,4,0,4,W
185135,8,DNK1,2009-05-18,Nordsjalland,Vejle,4,1,3,W
185136,8,DNK1,2009-05-24,Aarhus,Brondby,1,0,1,W
185137,8,DNK1,2009-05-24,Horsens,Nordsjalland,2,3,-1,L
185138,8,DNK1,2009-05-24,Randers FC,Vejle,3,2,1,W
185139,8,DNK1,2009-05-24,Aalborg,SonderjyskE,1,1,0,D
185140,8,DNK1,2009-05-24,Esbjerg fB,FC Kobenhavn,0,1,-1,L
185141,8,DNK1,2009-05-24,Midtjylland,Odense,1,1,0,D
185142,8,DNK1,2009-05-31,Odense,Horsens,2,1,1,W
185143,8,DNK1,2009-05-31,SonderjyskE,Esbjerg fB,1,1,0,D
185144,8,DNK1,2009-05-31,FC Kobenhavn,Randers FC,3,3,0,D
185145,8,DNK1,2009-05-31,Brondby,Midtjylland,2,4,-2,L
185146,8,DNK1,2009-05-31,Nordsjalland,Aalborg,2,2,0,D
185147,8,DNK1,2009-05-31,Vejle,Aarhus,2,1,1,W
185148,9,DNK1,2009-07-18,Nordsjalland,FC Kobenhavn,2,0,2,W
185149,9,DNK1,2009-07-18,Midtjylland,Esbjerg fB,0,0,0,D
185150,9,DNK1,2009-07-19,SonderjyskE,Randers FC,1,0,1,W
185151,9,DNK1,2009-07-19,HB Koge,Silkeborg,1,1,0,D
185152,9,DNK1,2009-07-19,Brondby,Odense,2,2,0,D
185153,9,DNK1,2009-07-20,Aarhus,Aalborg,1,0,1,W
185154,9,DNK1,2009-07-25,FC Kobenhavn,HB Koge,7,1,6,W
185155,9,DNK1,2009-07-25,Odense,SonderjyskE,3,1,2,W
185156,9,DNK1,2009-07-26,Silkeborg,Midtjylland,4,0,4,W
185157,9,DNK1,2009-07-26,Esbjerg fB,Brondby,2,1,1,W
185158,9,DNK1,2009-07-27,Randers FC,Aarhus,2,3,-1,L
185159,9,DNK1,2009-08-01,FC Kobenhavn,Silkeborg,1,1,0,D
185160,9,DNK1,2009-08-01,SonderjyskE,Esbjerg fB,1,1,0,D
185161,9,DNK1,2009-08-02,HB Koge,Aalborg,0,5,-5,L
185162,9,DNK1,2009-08-02,Nordsjalland,Randers FC,2,2,0,D
185163,9,DNK1,2009-08-02,Brondby,Midtjylland,3,1,2,W
185164,9,DNK1,2009-08-03,Aarhus,Odense,2,2,0,D
185165,9,DNK1,2009-08-08,Nordsjalland,Silkeborg,3,0,3,W
185166,9,DNK1,2009-08-09,Midtjylland,Randers FC,4,1,3,W
185167,9,DNK1,2009-08-09,Aarhus,HB Koge,2,1,1,W
185168,9,DNK1,2009-08-09,Esbjerg fB,Odense,1,2,-1,L
185169,9,DNK1,2009-08-09,SonderjyskE,FC Kobenhavn,0,1,-1,L
185170,9,DNK1,2009-08-09,Brondby,Aalborg,0,2,-2,L
185171,9,DNK1,2009-08-15,FC Kobenhavn,Aarhus,0,1,-1,L
185172,9,DNK1,2009-08-15,Aalborg,SonderjyskE,1,0,1,W
185173,9,DNK1,2009-08-16,Silkeborg,Esbjerg fB,2,3,-1,L
185174,9,DNK1,2009-08-16,Randers FC,Brondby,1,3,-2,L
185175,9,DNK1,2009-08-16,HB Koge,Nordsjalland,1,1,0,D
185176,9,DNK1,2009-08-17,Odense,Midtjylland,1,0,1,W
185177,9,DNK1,2009-08-19,Aalborg,Nordsjalland,1,0,1,W
185178,9,DNK1,2009-08-22,Midtjylland,FC Kobenhavn,1,4,-3,L
185179,9,DNK1,2009-08-22,Aarhus,Silkeborg,2,2,0,D
185180,9,DNK1,2009-08-23,Esbjerg fB,Aalborg,2,0,2,W
185181,9,DNK1,2009-08-23,Brondby,HB Koge,6,1,5,W
185182,9,DNK1,2009-08-23,SonderjyskE,Nordsjalland,1,0,1,W
185183,9,DNK1,2009-08-24,Odense,Randers FC,1,0,1,W
185184,9,DNK1,2009-08-29,Nordsjalland,Aarhus,0,2,-2,L
185185,9,DNK1,2009-08-30,Randers FC,Esbjerg fB,0,1,-1,L
185186,9,DNK1,2009-08-30,Aalborg,Midtjylland,1,0,1,W
185187,9,DNK1,2009-08-30,HB Koge,SonderjyskE,1,0,1,W
185188,9,DNK1,2009-08-30,FC Kobenhavn,Brondby,1,1,0,D
185189,9,DNK1,2009-08-31,Silkeborg,Odense,3,1,2,W
185190,9,DNK1,2009-09-12,Odense,FC Kobenhavn,1,1,0,D
185191,9,DNK1,2009-09-12,Midtjylland,Nordsjalland,0,2,-2,L
185192,9,DNK1,2009-09-13,Silkeborg,SonderjyskE,1,1,0,D
185193,9,DNK1,2009-09-13,Esbjerg fB,HB Koge,3,2,1,W
185194,9,DNK1,2009-09-13,Brondby,Aarhus,1,0,1,W
185195,9,DNK1,2009-09-14,Randers FC,Aalborg,0,3,-3,L
185196,9,DNK1,2009-09-19,Aalborg,Silkeborg,0,1,-1,L
185197,9,DNK1,2009-09-20,HB Koge,Odense,1,3,-2,L
185198,9,DNK1,2009-09-20,SonderjyskE,Brondby,2,4,-2,L
185199,9,DNK1,2009-09-20,Nordsjalland,Esbjerg fB,0,4,-4,L
185200,9,DNK1,2009-09-20,FC Kobenhavn,Randers FC,3,0,3,W
185201,9,DNK1,2009-09-21,Aarhus,Midtjylland,2,4,-2,L
185202,9,DNK1,2009-09-26,Odense,Nordsjalland,2,0,2,W
185203,9,DNK1,2009-09-27,Midtjylland,SonderjyskE,0,2,-2,L
185204,9,DNK1,2009-09-27,Randers FC,HB Koge,1,1,0,D
185205,9,DNK1,2009-09-27,Silkeborg,Brondby,4,1,3,W
185206,9,DNK1,2009-09-27,Aalborg,FC Kobenhavn,1,2,-1,L
185207,9,DNK1,2009-09-28,Esbjerg fB,Aarhus,3,2,1,W
185208,9,DNK1,2009-10-03,Aarhus,SonderjyskE,2,1,1,W
185209,9,DNK1,2009-10-04,Randers FC,Silkeborg,1,2,-1,L
185210,9,DNK1,2009-10-04,Midtjylland,HB Koge,2,1,1,W
185211,9,DNK1,2009-10-04,FC Kobenhavn,Esbjerg fB,2,1,1,W
185212,9,DNK1,2009-10-04,Brondby,Nordsjalland,6,3,3,W
185213,9,DNK1,2009-10-05,Odense,Aalborg,2,1,1,W
185214,9,DNK1,2009-10-17,Nordsjalland,Odense,0,2,-2,L
185215,9,DNK1,2009-10-18,Aalborg,Randers FC,1,1,0,D
185216,9,DNK1,2009-10-18,HB Koge,FC Kobenhavn,0,2,-2,L
185217,9,DNK1,2009-10-18,Silkeborg,Esbjerg fB,2,2,0,D
185218,9,DNK1,2009-10-18,Brondby,Midtjylland,1,1,0,D
185219,9,DNK1,2009-10-19,SonderjyskE,Aarhus,1,0,1,W
185220,9,DNK1,2009-10-24,Randers FC,Odense,1,1,0,D
185221,9,DNK1,2009-10-25,Esbjerg fB,SonderjyskE,2,0,2,W
185222,9,DNK1,2009-10-25,Midtjylland,HB Koge,2,1,1,W
185223,9,DNK1,2009-10-25,FC Kobenhavn,Silkeborg,1,0,1,W
185224,9,DNK1,2009-10-25,Aalborg,Brondby,1,2,-1,L
185225,9,DNK1,2009-10-26,Aarhus,Nordsjalland,0,2,-2,L
185226,9,DNK1,2009-10-31,Aarhus,Midtjylland,2,2,0,D
185227,9,DNK1,2009-11-01,Randers FC,Silkeborg,0,2,-2,L
185228,9,DNK1,2009-11-01,Nordsjalland,Brondby,0,1,-1,L
185229,9,DNK1,2009-11-01,SonderjyskE,HB Koge,0,0,0,D
185230,9,DNK1,2009-11-01,Esbjerg fB,FC Kobenhavn,0,0,0,D
185231,9,DNK1,2009-11-02,Odense,Aalborg,1,1,0,D
185232,9,DNK1,2009-11-07,HB Koge,Aarhus,1,1,0,D
185233,9,DNK1,2009-11-07,Silkeborg,Odense,0,1,-1,L
185234,9,DNK1,2009-11-08,Midtjylland,Randers FC,2,1,1,W
185235,9,DNK1,2009-11-08,SonderjyskE,Nordsjalland,0,1,-1,L
185236,9,DNK1,2009-11-08,Brondby,Esbjerg fB,2,4,-2,L
185237,9,DNK1,2009-11-08,Aalborg,FC Kobenhavn,1,0,1,W
185238,9,DNK1,2009-11-21,HB Koge,Nordsjalland,1,2,-1,L
185239,9,DNK1,2009-11-21,Midtjylland,Esbjerg fB,3,0,3,W
185240,9,DNK1,2009-11-22,Silkeborg,SonderjyskE,1,2,-1,L
185241,9,DNK1,2009-11-22,FC Kobenhavn,Randers FC,2,0,2,W
185242,9,DNK1,2009-11-22,Brondby,Odense,1,3,-2,L
185243,9,DNK1,2009-11-23,Aalborg,Aarhus,0,0,0,D
185244,9,DNK1,2009-11-28,Esbjerg fB,Aalborg,1,1,0,D
185245,9,DNK1,2009-11-29,Randers FC,SonderjyskE,0,0,0,D
185246,9,DNK1,2009-11-29,FC Kobenhavn,Midtjylland,2,0,2,W
185247,9,DNK1,2009-11-29,Nordsjalland,Silkeborg,0,1,-1,L
185248,9,DNK1,2009-11-29,Aarhus,Brondby,1,0,1,W
185249,9,DNK1,2009-11-30,Odense,HB Koge,1,0,1,W
185250,9,DNK1,2009-12-05,SonderjyskE,Aalborg,2,0,2,W
185251,9,DNK1,2009-12-06,Nordsjalland,Midtjylland,3,0,3,W
185252,9,DNK1,2009-12-06,Randers FC,HB Koge,2,1,1,W
185253,9,DNK1,2009-12-06,Silkeborg,Brondby,3,0,3,W
185254,9,DNK1,2009-12-06,Odense,FC Kobenhavn,0,2,-2,L
185255,9,DNK1,2009-12-07,Aarhus,Esbjerg fB,1,1,0,D
185256,9,DNK1,2010-03-06,Midtjylland,Odense,2,2,0,D
185257,9,DNK1,2010-03-07,Esbjerg fB,Randers FC,0,0,0,D
185258,9,DNK1,2010-03-07,HB Koge,Silkeborg,1,4,-3,L
185259,9,DNK1,2010-03-07,Brondby,SonderjyskE,1,1,0,D
185260,9,DNK1,2010-03-07,FC Kobenhavn,Aarhus,5,0,5,W
185261,9,DNK1,2010-03-08,Aalborg,Nordsjalland,2,1,1,W
185262,9,DNK1,2010-03-13,Odense,SonderjyskE,1,1,0,D
185263,9,DNK1,2010-03-14,Esbjerg fB,HB Koge,2,1,1,W
185264,9,DNK1,2010-03-14,Midtjylland,Aalborg,2,0,2,W
185265,9,DNK1,2010-03-14,Randers FC,Nordsjalland,0,0,0,D
185266,9,DNK1,2010-03-14,FC Kobenhavn,Brondby,2,0,2,W
185267,9,DNK1,2010-03-15,Aarhus,Silkeborg,1,2,-1,L
185268,9,DNK1,2010-03-20,Silkeborg,Midtjylland,0,2,-2,L
185269,9,DNK1,2010-03-21,HB Koge,Aalborg,0,3,-3,L
185270,9,DNK1,2010-03-21,Odense,Aarhus,2,0,2,W
185271,9,DNK1,2010-03-21,Nordsjalland,Esbjerg fB,1,0,1,W
185272,9,DNK1,2010-03-21,SonderjyskE,FC Kobenhavn,0,2,-2,L
185273,9,DNK1,2010-03-22,Brondby,Randers FC,1,1,0,D
185274,9,DNK1,2010-03-24,Aalborg,Silkeborg,1,0,1,W
185275,9,DNK1,2010-03-24,FC Kobenhavn,Nordsjalland,0,2,-2,L
185276,9,DNK1,2010-03-25,Brondby,HB Koge,1,3,-2,L
185277,9,DNK1,2010-03-25,Midtjylland,SonderjyskE,0,0,0,D
185278,9,DNK1,2010-03-25,Esbjerg fB,Odense,1,2,-1,L
185279,9,DNK1,2010-03-25,Randers FC,Aarhus,2,1,1,W
185280,9,DNK1,2010-03-27,Nordsjalland,Aalborg,1,1,0,D
185281,9,DNK1,2010-03-28,Randers FC,Esbjerg fB,4,0,4,W
185282,9,DNK1,2010-03-28,Silkeborg,HB Koge,3,0,3,W
185283,9,DNK1,2010-03-28,SonderjyskE,Brondby,1,3,-2,L
185284,9,DNK1,2010-03-28,Aarhus,FC Kobenhavn,0,0,0,D
185285,9,DNK1,2010-03-29,Odense,Midtjylland,1,2,-1,L
185286,9,DNK1,2010-03-31,Esbjerg fB,Aarhus,0,4,-4,L
185287,9,DNK1,2010-04-01,Midtjylland,Nordsjalland,1,0,1,W
185288,9,DNK1,2010-04-01,Brondby,Silkeborg,2,2,0,D
185289,9,DNK1,2010-04-01,HB Koge,Randers FC,1,2,-1,L
185290,9,DNK1,2010-04-01,FC Kobenhavn,Odense,2,0,2,W
185291,9,DNK1,2010-04-02,Aalborg,SonderjyskE,1,1,0,D
185292,9,DNK1,2010-04-04,Aarhus,Randers FC,0,0,0,D
185293,9,DNK1,2010-04-04,HB Koge,Brondby,1,2,-1,L
185294,9,DNK1,2010-04-05,Silkeborg,Aalborg,1,1,0,D
185295,9,DNK1,2010-04-05,SonderjyskE,Midtjylland,0,2,-2,L
185296,9,DNK1,2010-04-05,Nordsjalland,FC Kobenhavn,0,3,-3,L
185297,9,DNK1,2010-04-05,Odense,Esbjerg fB,0,0,0,D
185298,9,DNK1,2010-04-10,Aarhus,Aalborg,0,2,-2,L
185299,9,DNK1,2010-04-11,SonderjyskE,Silkeborg,4,0,4,W
185300,9,DNK1,2010-04-11,Esbjerg fB,Midtjylland,2,1,1,W
185301,9,DNK1,2010-04-11,Randers FC,FC Kobenhavn,1,0,1,W
185302,9,DNK1,2010-04-11,Odense,Brondby,0,1,-1,L
185303,9,DNK1,2010-04-12,Nordsjalland,HB Koge,1,1,0,D
185304,9,DNK1,2010-04-14,Midtjylland,Aarhus,1,0,1,W
185305,9,DNK1,2010-04-14,Aalborg,Odense,1,0,1,W
185306,9,DNK1,2010-04-14,Silkeborg,Randers FC,1,3,-2,L
185307,9,DNK1,2010-04-14,FC Kobenhavn,Esbjerg fB,3,2,1,W
185308,9,DNK1,2010-04-15,HB Koge,SonderjyskE,1,2,-1,L
185309,9,DNK1,2010-04-15,Brondby,Nordsjalland,0,1,-1,L
185310,9,DNK1,2010-04-17,Midtjylland,FC Kobenhavn,3,2,1,W
185311,9,DNK1,2010-04-18,Silkeborg,Nordsjalland,1,4,-3,L
185312,9,DNK1,2010-04-18,Brondby,Aarhus,1,0,1,W
185313,9,DNK1,2010-04-18,SonderjyskE,Randers FC,0,1,-1,L
185314,9,DNK1,2010-04-18,HB Koge,Odense,1,2,-1,L
185315,9,DNK1,2010-04-19,Aalborg,Esbjerg fB,0,0,0,D
185316,9,DNK1,2010-04-24,Odense,Silkeborg,1,0,1,W
185317,9,DNK1,2010-04-25,Aarhus,HB Koge,0,3,-3,L
185318,9,DNK1,2010-04-25,FC Kobenhavn,Aalborg,2,0,2,W
185319,9,DNK1,2010-04-25,Nordsjalland,SonderjyskE,3,1,2,W
185320,9,DNK1,2010-04-25,Esbjerg fB,Brondby,1,1,0,D
185321,9,DNK1,2010-04-26,Randers FC,Midtjylland,2,0,2,W
185322,9,DNK1,2010-05-01,Silkeborg,Aarhus,1,4,-3,L
185323,9,DNK1,2010-05-02,Nordsjalland,Randers FC,1,1,0,D
185324,9,DNK1,2010-05-02,HB Koge,Esbjerg fB,1,2,-1,L
185325,9,DNK1,2010-05-02,Aalborg,Midtjylland,3,2,1,W
185326,9,DNK1,2010-05-02,Brondby,FC Kobenhavn,0,2,-2,L
185327,9,DNK1,2010-05-03,SonderjyskE,Odense,2,0,2,W
185328,9,DNK1,2010-05-05,Midtjylland,Brondby,2,4,-2,L
185329,9,DNK1,2010-05-05,Randers FC,Aalborg,3,1,2,W
185330,9,DNK1,2010-05-05,FC Kobenhavn,HB Koge,4,0,4,W
185331,9,DNK1,2010-05-06,Esbjerg fB,Silkeborg,4,0,4,W
185332,9,DNK1,2010-05-06,Aarhus,SonderjyskE,1,2,-1,L
185333,9,DNK1,2010-05-06,Odense,Nordsjalland,2,1,1,W
185334,9,DNK1,2010-05-09,Nordsjalland,Aarhus,0,1,-1,L
185335,9,DNK1,2010-05-09,Brondby,Aalborg,2,0,2,W
185336,9,DNK1,2010-05-09,HB Koge,Midtjylland,1,0,1,W
185337,9,DNK1,2010-05-09,Odense,Randers FC,1,3,-2,L
185338,9,DNK1,2010-05-09,SonderjyskE,Esbjerg fB,1,0,1,W
185339,9,DNK1,2010-05-09,Silkeborg,FC Kobenhavn,2,0,2,W
185340,9,DNK1,2010-05-16,Randers FC,Brondby,1,3,-2,L
185341,9,DNK1,2010-05-16,Midtjylland,Silkeborg,3,0,3,W
185342,9,DNK1,2010-05-16,Aalborg,HB Koge,0,0,0,D
185343,9,DNK1,2010-05-16,Aarhus,Odense,0,3,-3,L
185344,9,DNK1,2010-05-16,FC Kobenhavn,SonderjyskE,3,1,2,W
185345,9,DNK1,2010-05-16,Esbjerg fB,Nordsjalland,3,3,0,D
185346,10,DNK1,2010-07-17,Odense,Esbjerg fB,3,0,3,W
185347,10,DNK1,2010-07-18,Horsens,Midtjylland,0,2,-2,L
185348,10,DNK1,2010-07-18,Randers FC,Brondby,3,2,1,W
185349,10,DNK1,2010-07-18,Nordsjalland,Silkeborg,4,1,3,W
185350,10,DNK1,2010-07-18,SonderjyskE,FC Kobenhavn,1,3,-2,L
185351,10,DNK1,2010-07-19,Lyngby,Aalborg,2,4,-2,L
185352,10,DNK1,2010-07-24,Midtjylland,Silkeborg,2,0,2,W
185353,10,DNK1,2010-07-24,Esbjerg fB,FC Kobenhavn,1,2,-1,L
185354,10,DNK1,2010-07-25,Lyngby,Horsens,1,0,1,W
185355,10,DNK1,2010-07-25,Nordsjalland,SonderjyskE,1,2,-1,L
185356,10,DNK1,2010-07-25,Aalborg,Brondby,0,2,-2,L
185357,10,DNK1,2010-07-26,Odense,Randers FC,1,1,0,D
185358,10,DNK1,2010-07-31,FC Kobenhavn,Aalborg,1,1,0,D
185359,10,DNK1,2010-07-31,SonderjyskE,Esbjerg fB,3,0,3,W
185360,10,DNK1,2010-08-01,Randers FC,Nordsjalland,0,2,-2,L
185361,10,DNK1,2010-08-01,Silkeborg,Lyngby,2,2,0,D
185362,10,DNK1,2010-08-01,Brondby,Midtjylland,1,0,1,W
185363,10,DNK1,2010-08-02,Horsens,Odense,1,0,1,W
185364,10,DNK1,2010-08-07,Esbjerg fB,Midtjylland,0,3,-3,L
185365,10,DNK1,2010-08-07,Aalborg,Silkeborg,0,0,0,D
185366,10,DNK1,2010-08-08,Horsens,Randers FC,0,0,0,D
185367,10,DNK1,2010-08-08,Nordsjalland,Brondby,1,3,-2,L
185368,10,DNK1,2010-08-08,Lyngby,SonderjyskE,1,0,1,W
185369,10,DNK1,2010-08-08,Odense,FC Kobenhavn,2,3,-1,L
185370,10,DNK1,2010-08-14,FC Kobenhavn,Nordsjalland,2,0,2,W
185371,10,DNK1,2010-08-14,SonderjyskE,Odense,1,3,-2,L
185372,10,DNK1,2010-08-15,Silkeborg,Horsens,1,2,-1,L
185373,10,DNK1,2010-08-15,Randers FC,Lyngby,2,1,1,W
185374,10,DNK1,2010-08-15,Brondby,Esbjerg fB,1,1,0,D
185375,10,DNK1,2010-08-16,Midtjylland,Aalborg,2,1,1,W
185376,10,DNK1,2010-08-21,FC Kobenhavn,Lyngby,3,0,3,W
185377,10,DNK1,2010-08-21,Aalborg,Esbjerg fB,0,2,-2,L
185378,10,DNK1,2010-08-22,SonderjyskE,Horsens,2,0,2,W
185379,10,DNK1,2010-08-22,Silkeborg,Randers FC,1,1,0,D
185380,10,DNK1,2010-08-22,Brondby,Odense,2,2,0,D
185381,10,DNK1,2010-08-23,Midtjylland,Nordsjalland,4,0,4,W
185382,10,DNK1,2010-08-28,Esbjerg fB,Silkeborg,2,1,1,W
185383,10,DNK1,2010-08-29,Nordsjalland,Aalborg,0,0,0,D
185384,10,DNK1,2010-08-29,Lyngby,Brondby,3,3,0,D
185385,10,DNK1,2010-08-29,Randers FC,SonderjyskE,0,0,0,D
185386,10,DNK1,2010-08-29,Horsens,FC Kobenhavn,1,2,-1,L
185387,10,DNK1,2010-08-30,Odense,Midtjylland,2,1,1,W
185388,10,DNK1,2010-09-11,FC Kobenhavn,Silkeborg,2,2,0,D
185389,10,DNK1,2010-09-11,Odense,Nordsjalland,0,1,-1,L
185390,10,DNK1,2010-09-12,Aalborg,Horsens,2,3,-1,L
185391,10,DNK1,2010-09-12,Esbjerg fB,Lyngby,2,3,-1,L
185392,10,DNK1,2010-09-12,Brondby,SonderjyskE,3,1,2,W
185393,10,DNK1,2010-09-13,Midtjylland,Randers FC,1,1,0,D
185394,10,DNK1,2010-09-18,Randers FC,Aalborg,2,3,-1,L
185395,10,DNK1,2010-09-19,Horsens,Esbjerg fB,0,3,-3,L
185396,10,DNK1,2010-09-19,Silkeborg,Odense,3,1,2,W
185397,10,DNK1,2010-09-19,SonderjyskE,Midtjylland,0,2,-2,L
185398,10,DNK1,2010-09-19,FC Kobenhavn,Brondby,2,0,2,W
185399,10,DNK1,2010-09-20,Lyngby,Nordsjalland,2,0,2,W
185400,10,DNK1,2010-09-25,Midtjylland,FC Kobenhavn,0,3,-3,L
185401,10,DNK1,2010-09-25,Aalborg,SonderjyskE,0,2,-2,L
185402,10,DNK1,2010-09-26,Nordsjalland,Horsens,3,0,3,W
185403,10,DNK1,2010-09-26,Esbjerg fB,Randers FC,2,2,0,D
185404,10,DNK1,2010-09-26,Brondby,Silkeborg,0,2,-2,L
185405,10,DNK1,2010-09-27,Odense,Lyngby,3,1,2,W
185406,10,DNK1,2010-10-02,Midtjylland,Lyngby,1,2,-1,L
185407,10,DNK1,2010-10-03,Esbjerg fB,Nordsjalland,1,1,0,D
185408,10,DNK1,2010-10-03,Silkeborg,SonderjyskE,3,1,2,W
185409,10,DNK1,2010-10-03,Brondby,Horsens,0,1,-1,L
185410,10,DNK1,2010-10-03,FC Kobenhavn,Randers FC,1,0,1,W
185411,10,DNK1,2010-10-04,Aalborg,Odense,1,2,-1,L
185412,10,DNK1,2010-10-16,SonderjyskE,Aalborg,1,0,1,W
185413,10,DNK1,2010-10-17,Horsens,Esbjerg fB,1,1,0,D
185414,10,DNK1,2010-10-17,Nordsjalland,Brondby,1,1,0,D
185415,10,DNK1,2010-10-17,Lyngby,Silkeborg,1,1,0,D
185416,10,DNK1,2010-10-17,FC Kobenhavn,Odense,5,0,5,W
185417,10,DNK1,2010-10-18,Randers FC,Midtjylland,1,1,0,D
185418,10,DNK1,2010-10-23,Midtjylland,Esbjerg fB,2,2,0,D
185419,10,DNK1,2010-10-24,Aalborg,Nordsjalland,2,0,2,W
185420,10,DNK1,2010-10-24,Silkeborg,FC Kobenhavn,0,3,-3,L
185421,10,DNK1,2010-10-24,Lyngby,Horsens,0,2,-2,L
185422,10,DNK1,2010-10-24,Brondby,Randers FC,2,1,1,W
185423,10,DNK1,2010-10-25,Odense,SonderjyskE,1,2,-1,L
185424,10,DNK1,2010-10-30,FC Kobenhavn,Lyngby,3,2,1,W
185425,10,DNK1,2010-10-30,Randers FC,Aalborg,0,0,0,D
185426,10,DNK1,2010-10-31,Horsens,Midtjylland,0,2,-2,L
185427,10,DNK1,2010-10-31,SonderjyskE,Silkeborg,1,2,-1,L
185428,10,DNK1,2010-10-31,Esbjerg fB,Brondby,1,2,-1,L
185429,10,DNK1,2010-11-01,Nordsjalland,Odense,1,4,-3,L
185430,10,DNK1,2010-11-06,Aalborg,Esbjerg fB,1,1,0,D
185431,10,DNK1,2010-11-07,Silkeborg,Nordsjalland,1,0,1,W
185432,10,DNK1,2010-11-07,Lyngby,SonderjyskE,1,0,1,W
185433,10,DNK1,2010-11-07,FC Kobenhavn,Horsens,4,0,4,W
185434,10,DNK1,2010-11-07,Brondby,Midtjylland,2,2,0,D
185435,10,DNK1,2010-11-08,Odense,Randers FC,1,0,1,W
185436,10,DNK1,2010-11-13,Esbjerg fB,Odense,1,2,-1,L
185437,10,DNK1,2010-11-13,Midtjylland,Aalborg,2,2,0,D
185438,10,DNK1,2010-11-14,Randers FC,Silkeborg,4,0,4,W
185439,10,DNK1,2010-11-14,Nordsjalland,Lyngby,2,1,1,W
185440,10,DNK1,2010-11-14,SonderjyskE,FC Kobenhavn,3,3,0,D
185441,10,DNK1,2010-11-14,Horsens,Brondby,2,1,1,W
185442,10,DNK1,2010-11-20,Lyngby,Randers FC,3,3,0,D
185443,10,DNK1,2010-11-21,Silkeborg,Esbjerg fB,1,1,0,D
185444,10,DNK1,2010-11-21,FC Kobenhavn,Nordsjalland,2,1,1,W
185445,10,DNK1,2010-11-21,SonderjyskE,Horsens,0,3,-3,L
185446,10,DNK1,2010-11-21,Aalborg,Brondby,1,2,-1,L
185447,10,DNK1,2010-11-22,Odense,Midtjylland,3,2,1,W
185448,10,DNK1,2010-11-27,Midtjylland,Silkeborg,2,1,1,W
185449,10,DNK1,2010-11-28,Esbjerg fB,Lyngby,0,0,0,D
185450,10,DNK1,2010-11-28,Randers FC,FC Kobenhavn,0,3,-3,L
185451,10,DNK1,2010-11-28,Nordsjalland,SonderjyskE,1,1,0,D
185452,10,DNK1,2010-11-28,Brondby,Odense,2,0,2,W
185453,10,DNK1,2010-11-29,Horsens,Aalborg,0,0,0,D
185454,10,DNK1,2010-12-04,FC Kobenhavn,Esbjerg fB,3,1,2,W
185455,10,DNK1,2010-12-04,Odense,Aalborg,6,0,6,W
185456,10,DNK1,2010-12-05,Nordsjalland,Horsens,2,1,1,W
185457,10,DNK1,2010-12-05,SonderjyskE,Randers FC,1,1,0,D
185458,10,DNK1,2010-12-05,Silkeborg,Brondby,2,2,0,D
185459,10,DNK1,2011-03-05,Aalborg,Silkeborg,1,1,0,D
185460,10,DNK1,2011-03-06,Esbjerg fB,SonderjyskE,0,1,-1,L
185461,10,DNK1,2011-03-06,Brondby,Lyngby,1,1,0,D
185462,10,DNK1,2011-03-06,Randers FC,Nordsjalland,4,0,4,W
185463,10,DNK1,2011-03-06,Midtjylland,FC Kobenhavn,2,0,2,W
185464,10,DNK1,2011-03-07,Horsens,Odense,2,1,1,W
185465,10,DNK1,2011-03-12,Midtjylland,Nordsjalland,2,2,0,D
185466,10,DNK1,2011-03-12,Aalborg,FC Kobenhavn,0,1,-1,L
185467,10,DNK1,2011-03-13,Esbjerg fB,Randers FC,1,3,-2,L
185468,10,DNK1,2011-03-13,Brondby,SonderjyskE,2,0,2,W
185469,10,DNK1,2011-03-13,Silkeborg,Horsens,2,1,1,W
185470,10,DNK1,2011-03-14,Odense,Lyngby,2,0,2,W
185471,10,DNK1,2011-03-19,Silkeborg,Odense,1,1,0,D
185472,10,DNK1,2011-03-20,Horsens,Randers FC,0,0,0,D
185473,10,DNK1,2011-03-20,Nordsjalland,Esbjerg fB,1,2,-1,L
185474,10,DNK1,2011-03-20,Lyngby,Aalborg,1,2,-1,L
185475,10,DNK1,2011-03-20,FC Kobenhavn,Brondby,3,1,2,W
185476,10,DNK1,2011-03-21,SonderjyskE,Midtjylland,2,1,1,W
185477,10,DNK1,2011-04-02,Esbjerg fB,FC Kobenhavn,1,1,0,D
185478,10,DNK1,2011-04-02,Aalborg,Odense,0,1,-1,L
185479,10,DNK1,2011-04-03,Randers FC,SonderjyskE,0,0,0,D
185480,10,DNK1,2011-04-03,Horsens,Nordsjalland,0,0,0,D
185481,10,DNK1,2011-04-03,Brondby,Silkeborg,2,2,0,D
185482,10,DNK1,2011-04-04,Midtjylland,Lyngby,4,4,0,D
185483,10,DNK1,2011-04-09,FC Kobenhavn,Randers FC,3,1,2,W
185484,10,DNK1,2011-04-09,Silkeborg,Midtjylland,1,0,1,W
185485,10,DNK1,2011-04-10,Aalborg,Horsens,0,0,0,D
185486,10,DNK1,2011-04-10,SonderjyskE,Nordsjalland,0,2,-2,L
185487,10,DNK1,2011-04-10,Odense,Brondby,1,1,0,D
185488,10,DNK1,2011-04-11,Lyngby,Esbjerg fB,1,2,-1,L
185489,10,DNK1,2011-04-14,Lyngby,Midtjylland,1,0,1,W
185490,10,DNK1,2011-04-16,Esbjerg fB,Silkeborg,1,1,0,D
185491,10,DNK1,2011-04-17,Horsens,SonderjyskE,1,1,0,D
185492,10,DNK1,2011-04-17,Randers FC,Lyngby,1,1,0,D
185493,10,DNK1,2011-04-17,Nordsjalland,FC Kobenhavn,1,3,-2,L
185494,10,DNK1,2011-04-17,Brondby,Aalborg,1,2,-1,L
185495,10,DNK1,2011-04-18,Midtjylland,Odense,1,1,0,D
185496,10,DNK1,2011-04-20,Silkeborg,SonderjyskE,1,0,1,W
185497,10,DNK1,2011-04-20,Aalborg,Randers FC,4,1,3,W
185498,10,DNK1,2011-04-21,Odense,Nordsjalland,1,2,-1,L
185499,10,DNK1,2011-04-21,Midtjylland,Horsens,1,0,1,W
185500,10,DNK1,2011-04-21,Lyngby,FC Kobenhavn,1,2,-1,L
185501,10,DNK1,2011-04-21,Brondby,Esbjerg fB,3,0,3,W
185502,10,DNK1,2011-04-24,Esbjerg fB,Midtjylland,0,1,-1,L
185503,10,DNK1,2011-04-24,Nordsjalland,Aalborg,3,3,0,D
185504,10,DNK1,2011-04-25,SonderjyskE,Odense,0,2,-2,L
185505,10,DNK1,2011-04-25,FC Kobenhavn,Silkeborg,2,0,2,W
185506,10,DNK1,2011-04-25,Horsens,Lyngby,2,0,2,W
185507,10,DNK1,2011-04-25,Randers FC,Brondby,0,4,-4,L
185508,10,DNK1,2011-04-30,Aalborg,Midtjylland,2,0,2,W
185509,10,DNK1,2011-05-01,Silkeborg,Randers FC,2,2,0,D
185510,10,DNK1,2011-05-01,Lyngby,Nordsjalland,1,0,1,W
185511,10,DNK1,2011-05-01,FC Kobenhavn,SonderjyskE,3,0,3,W
185512,10,DNK1,2011-05-01,Brondby,Horsens,0,0,0,D
185513,10,DNK1,2011-05-02,Odense,Esbjerg fB,1,0,1,W
185514,10,DNK1,2011-05-06,Aalborg,Lyngby,2,1,1,W
185515,10,DNK1,2011-05-08,Randers FC,Horsens,1,0,1,W
185516,10,DNK1,2011-05-08,Esbjerg fB,Nordsjalland,2,0,2,W
185517,10,DNK1,2011-05-08,Odense,Silkeborg,0,0,0,D
185518,10,DNK1,2011-05-08,Brondby,FC Kobenhavn,1,1,0,D
185519,10,DNK1,2011-05-09,Midtjylland,SonderjyskE,2,1,1,W
185520,10,DNK1,2011-05-14,Randers FC,Odense,1,2,-1,L
185521,10,DNK1,2011-05-15,SonderjyskE,Lyngby,1,0,1,W
185522,10,DNK1,2011-05-15,Esbjerg fB,Aalborg,0,0,0,D
185523,10,DNK1,2011-05-15,Nordsjalland,Silkeborg,3,2,1,W
185524,10,DNK1,2011-05-15,Midtjylland,Brondby,1,0,1,W
185525,10,DNK1,2011-05-16,Horsens,FC Kobenhavn,1,1,0,D
185526,10,DNK1,2011-05-18,Nordsjalland,Randers FC,2,1,1,W
185527,10,DNK1,2011-05-19,Odense,Horsens,3,3,0,D
185528,10,DNK1,2011-05-19,FC Kobenhavn,Midtjylland,5,2,3,W
185529,10,DNK1,2011-05-19,SonderjyskE,Esbjerg fB,2,1,1,W
185530,10,DNK1,2011-05-20,Silkeborg,Aalborg,4,3,1,W
185531,10,DNK1,2011-05-20,Lyngby,Brondby,1,2,-1,L
185532,10,DNK1,2011-05-25,Esbjerg fB,Horsens,2,1,1,W
185533,10,DNK1,2011-05-25,Midtjylland,Randers FC,2,2,0,D
185534,10,DNK1,2011-05-25,Brondby,Nordsjalland,1,1,0,D
185535,10,DNK1,2011-05-25,Aalborg,SonderjyskE,1,2,-1,L
185536,10,DNK1,2011-05-25,Odense,FC Kobenhavn,3,0,3,W
185537,10,DNK1,2011-05-25,Silkeborg,Lyngby,0,1,-1,L
185538,10,DNK1,2011-05-29,Randers FC,Esbjerg fB,2,2,0,D
185539,10,DNK1,2011-05-29,Lyngby,Odense,2,0,2,W
185540,10,DNK1,2011-05-29,FC Kobenhavn,Aalborg,2,0,2,W
185541,10,DNK1,2011-05-29,SonderjyskE,Brondby,0,2,-2,L
185542,10,DNK1,2011-05-29,Nordsjalland,Midtjylland,0,0,0,D
185543,10,DNK1,2011-05-29,Horsens,Silkeborg,1,2,-1,L
185544,11,DNK1,2011-07-16,Odense,Nordsjalland,2,0,2,W
185545,11,DNK1,2011-07-17,Midtjylland,Silkeborg,1,2,-1,L
185546,11,DNK1,2011-07-17,Horsens,HB Koge,3,0,3,W
185547,11,DNK1,2011-07-17,SonderjyskE,FC Kobenhavn,0,2,-2,L
185548,11,DNK1,2011-07-17,Brondby,Aalborg,2,2,0,D
185549,11,DNK1,2011-07-18,Aarhus,Lyngby,2,1,1,W
185550,11,DNK1,2011-07-23,Silkeborg,Brondby,0,1,-1,L
185551,11,DNK1,2011-07-23,FC Kobenhavn,Odense,2,2,0,D
185552,11,DNK1,2011-07-24,Nordsjalland,Horsens,1,1,0,D
185553,11,DNK1,2011-07-24,Lyngby,SonderjyskE,0,1,-1,L
185554,11,DNK1,2011-07-24,Aalborg,Aarhus,2,1,1,W
185555,11,DNK1,2011-07-25,HB Koge,Midtjylland,2,3,-1,L
185556,11,DNK1,2011-07-30,Aarhus,Odense,2,2,0,D
185557,11,DNK1,2011-07-30,FC Kobenhavn,Nordsjalland,2,0,2,W
185558,11,DNK1,2011-07-31,Silkeborg,SonderjyskE,1,1,0,D
185559,11,DNK1,2011-07-31,Lyngby,HB Koge,3,1,2,W
185560,11,DNK1,2011-07-31,Brondby,Horsens,1,4,-3,L
185561,11,DNK1,2011-08-01,Aalborg,Midtjylland,1,0,1,W
185562,11,DNK1,2011-08-06,SonderjyskE,Aarhus,3,1,2,W
185563,11,DNK1,2011-08-06,Horsens,Aalborg,3,3,0,D
185564,11,DNK1,2011-08-07,Midtjylland,Lyngby,2,1,1,W
185565,11,DNK1,2011-08-07,HB Koge,FC Kobenhavn,2,4,-2,L
185566,11,DNK1,2011-08-07,Nordsjalland,Silkeborg,2,1,1,W
185567,11,DNK1,2011-08-07,Odense,Brondby,2,1,1,W
185568,11,DNK1,2011-08-13,Aalborg,Odense,2,1,1,W
185569,11,DNK1,2011-08-13,FC Kobenhavn,Midtjylland,2,0,2,W
185570,11,DNK1,2011-08-14,Lyngby,Horsens,1,1,0,D
185571,11,DNK1,2011-08-14,Brondby,SonderjyskE,2,2,0,D
185572,11,DNK1,2011-08-14,Nordsjalland,HB Koge,2,0,2,W
185573,11,DNK1,2011-08-15,Silkeborg,Aarhus,1,1,0,D
185574,11,DNK1,2011-08-20,Odense,Lyngby,3,1,2,W
185575,11,DNK1,2011-08-20,Horsens,FC Kobenhavn,0,1,-1,L
185576,11,DNK1,2011-08-21,Midtjylland,Nordsjalland,2,1,1,W
185577,11,DNK1,2011-08-21,HB Koge,Silkeborg,3,0,3,W
185578,11,DNK1,2011-08-21,Aarhus,Brondby,0,0,0,D
185579,11,DNK1,2011-08-22,SonderjyskE,Aalborg,0,0,0,D
185580,11,DNK1,2011-08-27,HB Koge,Aalborg,1,4,-3,L
185581,11,DNK1,2011-08-28,Odense,SonderjyskE,2,4,-2,L
185582,11,DNK1,2011-08-28,Nordsjalland,Lyngby,4,0,4,W
185583,11,DNK1,2011-08-28,FC Kobenhavn,Silkeborg,2,1,1,W
185584,11,DNK1,2011-08-28,Midtjylland,Brondby,2,1,1,W
185585,11,DNK1,2011-08-29,Horsens,Aarhus,0,3,-3,L
185586,11,DNK1,2011-09-10,Lyngby,FC Kobenhavn,0,1,-1,L
185587,11,DNK1,2011-09-10,Silkeborg,Odense,1,3,-2,L
185588,11,DNK1,2011-09-11,Aalborg,Nordsjalland,1,2,-1,L
185589,11,DNK1,2011-09-11,SonderjyskE,Horsens,1,3,-2,L
185590,11,DNK1,2011-09-11,Brondby,HB Koge,5,0,5,W
185591,11,DNK1,2011-09-12,Aarhus,Midtjylland,4,2,2,W
185592,11,DNK1,2011-09-17,HB Koge,Aarhus,0,2,-2,L
185593,11,DNK1,2011-09-18,Midtjylland,SonderjyskE,2,0,2,W
185594,11,DNK1,2011-09-18,Lyngby,Silkeborg,0,2,-2,L
185595,11,DNK1,2011-09-18,Nordsjalland,Brondby,2,0,2,W
185596,11,DNK1,2011-09-18,FC Kobenhavn,Aalborg,2,0,2,W
185597,11,DNK1,2011-09-19,Horsens,Odense,4,3,1,W
185598,11,DNK1,2011-09-24,Brondby,FC Kobenhavn,1,2,-1,L
185599,11,DNK1,2011-09-24,Aarhus,Nordsjalland,1,0,1,W
185600,11,DNK1,2011-09-25,Silkeborg,Horsens,1,1,0,D
185601,11,DNK1,2011-09-25,SonderjyskE,HB Koge,0,0,0,D
185602,11,DNK1,2011-09-25,Odense,Midtjylland,1,4,-3,L
185603,11,DNK1,2011-09-26,Aalborg,Lyngby,1,2,-1,L
185604,11,DNK1,2011-10-01,Silkeborg,Aalborg,1,1,0,D
185605,11,DNK1,2011-10-02,Odense,HB Koge,2,1,1,W
185606,11,DNK1,2011-10-02,Brondby,Lyngby,1,0,1,W
185607,11,DNK1,2011-10-02,Nordsjalland,SonderjyskE,1,0,1,W
185608,11,DNK1,2011-10-02,FC Kobenhavn,Aarhus,1,1,0,D
185609,11,DNK1,2011-10-03,Midtjylland,Horsens,1,0,1,W
185610,11,DNK1,2011-10-15,Nordsjalland,Aalborg,1,0,1,W
185611,11,DNK1,2011-10-16,Lyngby,Silkeborg,2,3,-1,L
185612,11,DNK1,2011-10-16,HB Koge,SonderjyskE,1,3,-2,L
185613,11,DNK1,2011-10-16,Aarhus,Odense,0,0,0,D
185614,11,DNK1,2011-10-16,Midtjylland,Brondby,1,0,1,W
185615,11,DNK1,2011-10-17,Horsens,FC Kobenhavn,2,0,2,W
185616,11,DNK1,2011-10-22,Lyngby,Aarhus,1,1,0,D
185617,11,DNK1,2011-10-23,SonderjyskE,Horsens,1,4,-3,L
185618,11,DNK1,2011-10-23,Aalborg,Odense,2,1,1,W
185619,11,DNK1,2011-10-23,HB Koge,Midtjylland,1,1,0,D
185620,11,DNK1,2011-10-23,Silkeborg,Brondby,2,1,1,W
185621,11,DNK1,2011-10-24,FC Kobenhavn,Nordsjalland,1,3,-2,L
185622,11,DNK1,2011-10-29,Horsens,Silkeborg,1,1,0,D
185623,11,DNK1,2011-10-30,Aarhus,HB Koge,2,0,2,W
185624,11,DNK1,2011-10-30,Nordsjalland,Lyngby,0,1,-1,L
185625,11,DNK1,2011-10-30,Brondby,Aalborg,1,1,0,D
185626,11,DNK1,2011-10-30,Odense,FC Kobenhavn,1,3,-2,L
185627,11,DNK1,2011-10-31,Midtjylland,SonderjyskE,1,1,0,D
185628,11,DNK1,2011-11-05,Aalborg,Horsens,2,0,2,W
185629,11,DNK1,2011-11-06,Silkeborg,Midtjylland,4,1,3,W
185630,11,DNK1,2011-11-06,HB Koge,Nordsjalland,0,2,-2,L
185631,11,DNK1,2011-11-06,FC Kobenhavn,Lyngby,3,0,3,W
185632,11,DNK1,2011-11-06,Odense,Brondby,0,0,0,D
185633,11,DNK1,2011-11-07,SonderjyskE,Aarhus,1,1,0,D
185634,11,DNK1,2011-11-19,Horsens,Odense,0,1,-1,L
185635,11,DNK1,2011-11-20,Brondby,FC Kobenhavn,2,1,1,W
185636,11,DNK1,2011-11-20,Lyngby,HB Koge,2,2,0,D
185637,11,DNK1,2011-11-20,Nordsjalland,SonderjyskE,2,0,2,W
185638,11,DNK1,2011-11-20,Midtjylland,Aalborg,1,3,-2,L
185639,11,DNK1,2011-11-21,Aarhus,Silkeborg,0,2,-2,L
185640,11,DNK1,2011-11-26,Odense,Midtjylland,2,3,-1,L
185641,11,DNK1,2011-11-27,Silkeborg,Nordsjalland,1,2,-1,L
185642,11,DNK1,2011-11-27,SonderjyskE,Lyngby,3,1,2,W
185643,11,DNK1,2011-11-27,FC Kobenhavn,HB Koge,2,1,1,W
185644,11,DNK1,2011-11-27,Aalborg,Aarhus,0,2,-2,L
185645,11,DNK1,2011-11-28,Brondby,Horsens,0,1,-1,L
185646,11,DNK1,2011-12-03,Silkeborg,Aalborg,4,2,2,W
185647,11,DNK1,2011-12-04,Nordsjalland,Midtjylland,0,0,0,D
185648,11,DNK1,2011-12-04,HB Koge,Brondby,1,1,0,D
185649,11,DNK1,2011-12-04,Lyngby,Horsens,1,2,-1,L
185650,11,DNK1,2011-12-04,FC Kobenhavn,Aarhus,0,0,0,D
185651,11,DNK1,2011-12-05,SonderjyskE,Odense,0,4,-4,L
185652,11,DNK1,2012-03-03,Aarhus,Nordsjalland,1,1,0,D
185653,11,DNK1,2012-03-04,Midtjylland,Lyngby,1,2,-1,L
185654,11,DNK1,2012-03-04,Brondby,SonderjyskE,1,0,1,W
185655,11,DNK1,2012-03-04,Horsens,HB Koge,2,1,1,W
185656,11,DNK1,2012-03-04,Aalborg,FC Kobenhavn,1,1,0,D
185657,11,DNK1,2012-03-05,Odense,Silkeborg,2,2,0,D
185658,11,DNK1,2012-03-10,Odense,Nordsjalland,0,1,-1,L
185659,11,DNK1,2012-03-11,Aalborg,Lyngby,1,0,1,W
185660,11,DNK1,2012-03-11,Silkeborg,HB Koge,0,1,-1,L
185661,11,DNK1,2012-03-11,FC Kobenhavn,SonderjyskE,2,0,2,W
185662,11,DNK1,2012-03-11,Brondby,Aarhus,0,0,0,D
185663,11,DNK1,2012-03-12,Midtjylland,Horsens,4,1,3,W
185664,11,DNK1,2012-03-17,Aarhus,Horsens,1,3,-2,L
185665,11,DNK1,2012-03-18,Lyngby,Odense,1,0,1,W
185666,11,DNK1,2012-03-18,Nordsjalland,Brondby,1,2,-1,L
185667,11,DNK1,2012-03-18,SonderjyskE,Silkeborg,2,4,-2,L
185668,11,DNK1,2012-03-18,FC Kobenhavn,Midtjylland,0,0,0,D
185669,11,DNK1,2012-03-19,HB Koge,Aalborg,1,1,0,D
185670,11,DNK1,2012-03-24,Aalborg,SonderjyskE,1,2,-1,L
185671,11,DNK1,2012-03-25,Odense,HB Koge,2,4,-2,L
185672,11,DNK1,2012-03-25,Horsens,Nordsjalland,0,2,-2,L
185673,11,DNK1,2012-03-25,Silkeborg,FC Kobenhavn,0,0,0,D
185674,11,DNK1,2012-03-25,Brondby,Lyngby,2,1,1,W
185675,11,DNK1,2012-03-26,Midtjylland,Aarhus,0,2,-2,L
185676,11,DNK1,2012-03-31,Horsens,Aalborg,1,0,1,W
185677,11,DNK1,2012-04-01,Midtjylland,Silkeborg,2,2,0,D
185678,11,DNK1,2012-04-01,Nordsjalland,HB Koge,2,0,2,W
185679,11,DNK1,2012-04-01,Lyngby,FC Kobenhavn,1,3,-2,L
185680,11,DNK1,2012-04-01,Brondby,Odense,1,0,1,W
185681,11,DNK1,2012-04-02,Aarhus,SonderjyskE,1,3,-2,L
185682,11,DNK1,2012-04-04,Aalborg,Midtjylland,1,2,-1,L
185683,11,DNK1,2012-04-05,SonderjyskE,Nordsjalland,1,0,1,W
185684,11,DNK1,2012-04-05,HB Koge,Lyngby,1,4,-3,L
185685,11,DNK1,2012-04-05,Silkeborg,Aarhus,2,1,1,W
185686,11,DNK1,2012-04-05,FC Kobenhavn,Brondby,3,1,2,W
185687,11,DNK1,2012-04-06,Odense,Horsens,0,1,-1,L
185688,11,DNK1,2012-04-08,Aalborg,Silkeborg,3,1,2,W
185689,11,DNK1,2012-04-08,Midtjylland,Nordsjalland,1,1,0,D
185690,11,DNK1,2012-04-09,Odense,SonderjyskE,1,1,0,D
185691,11,DNK1,2012-04-09,Brondby,HB Koge,1,1,0,D
185692,11,DNK1,2012-04-09,Horsens,Lyngby,0,0,0,D
185693,11,DNK1,2012-04-09,Aarhus,FC Kobenhavn,0,0,0,D
185694,11,DNK1,2012-04-14,Midtjylland,Odense,2,0,2,W
185695,11,DNK1,2012-04-15,Nordsjalland,Silkeborg,2,1,1,W
185696,11,DNK1,2012-04-15,Lyngby,SonderjyskE,0,4,-4,L
185697,11,DNK1,2012-04-15,HB Koge,FC Kobenhavn,0,5,-5,L
185698,11,DNK1,2012-04-15,Horsens,Brondby,2,0,2,W
185699,11,DNK1,2012-04-16,Aarhus,Aalborg,1,1,0,D
185700,11,DNK1,2012-04-21,Aalborg,Nordsjalland,0,2,-2,L
185701,11,DNK1,2012-04-22,Silkeborg,Lyngby,3,0,3,W
185702,11,DNK1,2012-04-22,FC Kobenhavn,Horsens,2,1,1,W
185703,11,DNK1,2012-04-22,SonderjyskE,HB Koge,2,1,1,W
185704,11,DNK1,2012-04-22,Brondby,Midtjylland,0,2,-2,L
185705,11,DNK1,2012-04-23,Odense,Aarhus,1,2,-1,L
185706,11,DNK1,2012-04-28,Nordsjalland,Aarhus,5,3,2,W
185707,11,DNK1,2012-04-29,Lyngby,Midtjylland,1,2,-1,L
185708,11,DNK1,2012-04-29,HB Koge,Horsens,2,1,1,W
185709,11,DNK1,2012-04-29,SonderjyskE,Brondby,3,3,0,D
185710,11,DNK1,2012-04-29,FC Kobenhavn,Aalborg,3,0,3,W
185711,11,DNK1,2012-04-30,Silkeborg,Odense,1,1,0,D
185712,11,DNK1,2012-05-02,Aarhus,Lyngby,2,1,1,W
185713,11,DNK1,2012-05-02,Nordsjalland,FC Kobenhavn,1,0,1,W
185714,11,DNK1,2012-05-03,Horsens,SonderjyskE,5,0,5,W
185715,11,DNK1,2012-05-03,Midtjylland,HB Koge,2,1,1,W
185716,11,DNK1,2012-05-03,Brondby,Silkeborg,3,2,1,W
185717,11,DNK1,2012-05-03,Odense,Aalborg,1,2,-1,L
185718,11,DNK1,2012-05-05,Lyngby,Nordsjalland,0,2,-2,L
185719,11,DNK1,2012-05-06,HB Koge,Aarhus,1,3,-2,L
185720,11,DNK1,2012-05-06,Silkeborg,Horsens,0,1,-1,L
185721,11,DNK1,2012-05-06,Aalborg,Brondby,1,0,1,W
185722,11,DNK1,2012-05-06,FC Kobenhavn,Odense,1,1,0,D
185723,11,DNK1,2012-05-07,SonderjyskE,Midtjylland,1,1,0,D
185724,11,DNK1,2012-05-12,Horsens,Midtjylland,2,1,1,W
185725,11,DNK1,2012-05-13,Lyngby,Aalborg,3,2,1,W
185726,11,DNK1,2012-05-13,SonderjyskE,FC Kobenhavn,2,2,0,D
185727,11,DNK1,2012-05-13,HB Koge,Silkeborg,1,3,-2,L
185728,11,DNK1,2012-05-13,Aarhus,Brondby,5,1,4,W
185729,11,DNK1,2012-05-14,Nordsjalland,Odense,0,0,0,D
185730,11,DNK1,2012-05-20,Midtjylland,FC Kobenhavn,1,0,1,W
185731,11,DNK1,2012-05-20,Silkeborg,SonderjyskE,1,1,0,D
185732,11,DNK1,2012-05-20,Horsens,Aarhus,3,1,2,W
185733,11,DNK1,2012-05-20,Brondby,Nordsjalland,0,1,-1,L
185734,11,DNK1,2012-05-20,Aalborg,HB Koge,1,0,1,W
185735,11,DNK1,2012-05-20,Odense,Lyngby,4,0,4,W
185736,11,DNK1,2012-05-23,Nordsjalland,Horsens,3,0,3,W
185737,11,DNK1,2012-05-23,Lyngby,Brondby,1,0,1,W
185738,11,DNK1,2012-05-23,SonderjyskE,Aalborg,5,0,5,W
185739,11,DNK1,2012-05-23,HB Koge,Odense,1,1,0,D
185740,11,DNK1,2012-05-23,FC Kobenhavn,Silkeborg,2,1,1,W
185741,11,DNK1,2012-05-23,Aarhus,Midtjylland,0,2,-2,L
185742,12,DNK1,2012-07-13,Aarhus,Aalborg,1,1,0,D
185743,12,DNK1,2012-07-14,SonderjyskE,Randers FC,6,1,5,W
185744,12,DNK1,2012-07-15,Esbjerg fB,Silkeborg,2,3,-1,L
185745,12,DNK1,2012-07-15,Brondby,Odense,0,1,-1,L
185746,12,DNK1,2012-07-15,FC Kobenhavn,Midtjylland,4,2,2,W
185747,12,DNK1,2012-07-16,Horsens,Nordsjalland,0,4,-4,L
185748,12,DNK1,2012-07-20,Silkeborg,Horsens,0,2,-2,L
185749,12,DNK1,2012-07-21,Midtjylland,Nordsjalland,3,1,2,W
185750,12,DNK1,2012-07-22,Odense,Randers FC,0,1,-1,L
185751,12,DNK1,2012-07-22,SonderjyskE,FC Kobenhavn,1,1,0,D
185752,12,DNK1,2012-07-22,Aalborg,Brondby,2,1,1,W
185753,12,DNK1,2012-07-23,Aarhus,Esbjerg fB,0,0,0,D
185754,12,DNK1,2012-07-27,Horsens,Midtjylland,2,2,0,D
185755,12,DNK1,2012-07-28,FC Kobenhavn,Aalborg,3,0,3,W
185756,12,DNK1,2012-07-28,Esbjerg fB,SonderjyskE,1,2,-1,L
185757,12,DNK1,2012-07-29,Randers FC,Aarhus,2,1,1,W
185758,12,DNK1,2012-07-29,Nordsjalland,Odense,1,1,0,D
185759,12,DNK1,2012-07-30,Brondby,Silkeborg,2,1,1,W
185760,12,DNK1,2012-08-03,Silkeborg,Odense,0,1,-1,L
185761,12,DNK1,2012-08-04,Aalborg,Nordsjalland,1,1,0,D
185762,12,DNK1,2012-08-04,Esbjerg fB,FC Kobenhavn,1,2,-1,L
185763,12,DNK1,2012-08-05,Midtjylland,Randers FC,2,1,1,W
185764,12,DNK1,2012-08-05,Aarhus,Brondby,3,1,2,W
185765,12,DNK1,2012-08-06,SonderjyskE,Horsens,0,2,-2,L
185766,12,DNK1,2012-08-10,Odense,Midtjylland,2,1,1,W
185767,12,DNK1,2012-08-11,Nordsjalland,Silkeborg,6,1,5,W
185768,12,DNK1,2012-08-12,Horsens,Aalborg,1,4,-3,L
185769,12,DNK1,2012-08-12,Brondby,SonderjyskE,0,1,-1,L
185770,12,DNK1,2012-08-12,FC Kobenhavn,Aarhus,3,0,3,W
185771,12,DNK1,2012-08-13,Randers FC,Esbjerg fB,1,0,1,W
185772,12,DNK1,2012-08-17,Aalborg,Midtjylland,3,0,3,W
185773,12,DNK1,2012-08-18,Silkeborg,Randers FC,0,1,-1,L
185774,12,DNK1,2012-08-18,FC Kobenhavn,Brondby,1,1,0,D
185775,12,DNK1,2012-08-19,Esbjerg fB,Horsens,0,0,0,D
185776,12,DNK1,2012-08-19,Aarhus,Nordsjalland,0,1,-1,L
185777,12,DNK1,2012-08-20,SonderjyskE,Odense,1,2,-1,L
185778,12,DNK1,2012-08-24,Nordsjalland,SonderjyskE,4,1,3,W
185779,12,DNK1,2012-08-25,Randers FC,FC Kobenhavn,2,3,-1,L
185780,12,DNK1,2012-08-26,Midtjylland,Silkeborg,1,1,0,D
185781,12,DNK1,2012-08-26,Odense,Aalborg,0,4,-4,L
185782,12,DNK1,2012-08-26,Brondby,Esbjerg fB,1,1,0,D
185783,12,DNK1,2012-08-27,Horsens,Aarhus,1,4,-3,L
185784,12,DNK1,2012-08-31,SonderjyskE,Aalborg,0,4,-4,L
185785,12,DNK1,2012-09-01,Silkeborg,Aarhus,0,4,-4,L
185786,12,DNK1,2012-09-02,Randers FC,Horsens,0,1,-1,L
185787,12,DNK1,2012-09-02,Midtjylland,Esbjerg fB,1,0,1,W
185788,12,DNK1,2012-09-02,Nordsjalland,Brondby,0,0,0,D
185789,12,DNK1,2012-09-02,Odense,FC Kobenhavn,2,2,0,D
185790,12,DNK1,2012-09-14,Esbjerg fB,Odense,3,0,3,W
185791,12,DNK1,2012-09-15,SonderjyskE,Silkeborg,0,2,-2,L
185792,12,DNK1,2012-09-15,FC Kobenhavn,Nordsjalland,2,1,1,W
185793,12,DNK1,2012-09-16,Aalborg,Randers FC,4,0,4,W
185794,12,DNK1,2012-09-16,Brondby,Horsens,2,2,0,D
185795,12,DNK1,2012-09-17,Aarhus,Midtjylland,3,2,1,W
185796,12,DNK1,2012-09-21,Aarhus,SonderjyskE,2,2,0,D
185797,12,DNK1,2012-09-22,Nordsjalland,Randers FC,1,1,0,D
185798,12,DNK1,2012-09-23,Horsens,Odense,2,2,0,D
185799,12,DNK1,2012-09-23,Midtjylland,Brondby,1,1,0,D
185800,12,DNK1,2012-09-23,FC Kobenhavn,Silkeborg,5,0,5,W
185801,12,DNK1,2012-09-24,Aalborg,Esbjerg fB,0,2,-2,L
185802,12,DNK1,2012-09-28,Nordsjalland,Esbjerg fB,3,0,3,W
185803,12,DNK1,2012-09-29,Horsens,FC Kobenhavn,1,1,0,D
185804,12,DNK1,2012-09-30,Silkeborg,Aalborg,2,1,1,W
185805,12,DNK1,2012-09-30,Odense,Aarhus,1,2,-1,L
185806,12,DNK1,2012-09-30,Randers FC,Brondby,3,2,1,W
185807,12,DNK1,2012-10-01,Midtjylland,SonderjyskE,1,3,-2,L
185808,12,DNK1,2012-10-05,Odense,Nordsjalland,3,0,3,W
185809,12,DNK1,2012-10-06,SonderjyskE,Aarhus,0,3,-3,L
185810,12,DNK1,2012-10-07,Silkeborg,Horsens,1,1,0,D
185811,12,DNK1,2012-10-07,Randers FC,Midtjylland,2,1,1,W
185812,12,DNK1,2012-10-07,Esbjerg fB,FC Kobenhavn,2,2,0,D
185813,12,DNK1,2012-10-07,Brondby,Aalborg,1,3,-2,L
185814,12,DNK1,2012-10-19,Nordsjalland,Silkeborg,3,0,3,W
185815,12,DNK1,2012-10-20,Aalborg,SonderjyskE,2,1,1,W
185816,12,DNK1,2012-10-21,Horsens,Esbjerg fB,0,0,0,D
185817,12,DNK1,2012-10-21,Midtjylland,Odense,1,1,0,D
185818,12,DNK1,2012-10-21,FC Kobenhavn,Brondby,1,0,1,W
185819,12,DNK1,2012-10-22,Aarhus,Randers FC,1,1,0,D
185820,12,DNK1,2012-10-26,Nordsjalland,Aalborg,1,0,1,W
185821,12,DNK1,2012-10-27,Silkeborg,Randers FC,1,2,-1,L
185822,12,DNK1,2012-10-28,Esbjerg fB,SonderjyskE,1,2,-1,L
185823,12,DNK1,2012-10-28,Odense,Aarhus,2,4,-2,L
185824,12,DNK1,2012-10-28,Midtjylland,Brondby,1,1,0,D
185825,12,DNK1,2012-10-29,Horsens,FC Kobenhavn,1,0,1,W
185826,12,DNK1,2012-11-02,Esbjerg fB,Silkeborg,1,0,1,W
185827,12,DNK1,2012-11-03,SonderjyskE,Nordsjalland,1,2,-1,L
185828,12,DNK1,2012-11-04,Randers FC,Horsens,0,0,0,D
185829,12,DNK1,2012-11-04,Brondby,Odense,0,3,-3,L
185830,12,DNK1,2012-11-04,Aarhus,FC Kobenhavn,0,2,-2,L
185831,12,DNK1,2012-11-05,Aalborg,Midtjylland,1,3,-2,L
185832,12,DNK1,2012-11-09,Horsens,Aarhus,2,0,2,W
185833,12,DNK1,2012-11-10,Nordsjalland,Randers FC,2,2,0,D
185834,12,DNK1,2012-11-11,Odense,SonderjyskE,5,0,5,W
185835,12,DNK1,2012-11-11,Silkeborg,Brondby,1,2,-1,L
185836,12,DNK1,2012-11-11,FC Kobenhavn,Aalborg,4,0,4,W
185837,12,DNK1,2012-11-12,Midtjylland,Esbjerg fB,0,0,0,D
185838,12,DNK1,2012-11-16,Aarhus,Nordsjalland,0,2,-2,L
185839,12,DNK1,2012-11-17,SonderjyskE,Silkeborg,2,3,-1,L
185840,12,DNK1,2012-11-18,Aalborg,Horsens,2,0,2,W
185841,12,DNK1,2012-11-18,Brondby,Esbjerg fB,2,2,0,D
185842,12,DNK1,2012-11-18,FC Kobenhavn,Midtjylland,2,1,1,W
185843,12,DNK1,2012-11-19,Randers FC,Odense,3,2,1,W
185844,12,DNK1,2012-11-23,Randers FC,Aalborg,0,1,-1,L
185845,12,DNK1,2012-11-24,Silkeborg,Odense,0,2,-2,L
185846,12,DNK1,2012-11-25,Esbjerg fB,Nordsjalland,1,0,1,W
185847,12,DNK1,2012-11-25,SonderjyskE,FC Kobenhavn,1,2,-1,L
185848,12,DNK1,2012-11-25,Brondby,Horsens,2,0,2,W
185849,12,DNK1,2012-11-26,Aarhus,Midtjylland,1,1,0,D
185850,12,DNK1,2012-11-30,Horsens,SonderjyskE,1,3,-2,L
185851,12,DNK1,2012-12-01,Odense,Esbjerg fB,3,0,3,W
185852,12,DNK1,2012-12-02,Midtjylland,Silkeborg,1,3,-2,L
185853,12,DNK1,2012-12-02,FC Kobenhavn,Randers FC,2,0,2,W
185854,12,DNK1,2012-12-02,Nordsjalland,Brondby,3,0,3,W
185855,12,DNK1,2012-12-03,Aalborg,Aarhus,0,3,-3,L
185856,12,DNK1,2012-12-07,SonderjyskE,Brondby,2,2,0,D
185857,12,DNK1,2012-12-08,Randers FC,Esbjerg fB,2,1,1,W
185858,12,DNK1,2012-12-09,Horsens,Midtjylland,0,2,-2,L
185859,12,DNK1,2012-12-09,FC Kobenhavn,Nordsjalland,4,1,3,W
185860,12,DNK1,2012-12-10,Aarhus,Silkeborg,3,3,0,D
185861,12,DNK1,2013-03-01,Silkeborg,Aalborg,3,2,1,W
185862,12,DNK1,2013-03-02,Midtjylland,SonderjyskE,1,0,1,W
185863,12,DNK1,2013-03-03,Nordsjalland,Horsens,1,0,1,W
185864,12,DNK1,2013-03-03,Brondby,Randers FC,0,2,-2,L
185865,12,DNK1,2013-03-03,Odense,FC Kobenhavn,2,3,-1,L
185866,12,DNK1,2013-03-04,Esbjerg fB,Aarhus,2,1,1,W
185867,12,DNK1,2013-03-06,Aalborg,Odense,2,2,0,D
185868,12,DNK1,2013-03-08,Randers FC,SonderjyskE,2,0,2,W
185869,12,DNK1,2013-03-09,Aalborg,Esbjerg fB,0,0,0,D
185870,12,DNK1,2013-03-10,Horsens,Odense,2,0,2,W
185871,12,DNK1,2013-03-10,FC Kobenhavn,Silkeborg,3,1,2,W
185872,12,DNK1,2013-03-10,Aarhus,Brondby,0,3,-3,L
185873,12,DNK1,2013-03-11,Midtjylland,Nordsjalland,1,1,0,D
185874,12,DNK1,2013-03-15,FC Kobenhavn,Horsens,2,1,1,W
185875,12,DNK1,2013-03-17,Randers FC,Silkeborg,1,0,1,W
185876,12,DNK1,2013-03-17,Aarhus,Odense,2,1,1,W
185877,12,DNK1,2013-03-17,Brondby,Midtjylland,1,1,0,D
185878,12,DNK1,2013-03-28,Horsens,Aalborg,2,2,0,D
185879,12,DNK1,2013-03-28,Silkeborg,SonderjyskE,0,5,-5,L
185880,12,DNK1,2013-03-28,Odense,Randers FC,0,0,0,D
185881,12,DNK1,2013-03-29,Nordsjalland,Aarhus,4,2,2,W
185882,12,DNK1,2013-03-29,Esbjerg fB,Brondby,1,0,1,W
185883,12,DNK1,2013-03-29,Midtjylland,FC Kobenhavn,2,2,0,D
185884,12,DNK1,2013-03-31,SonderjyskE,Randers FC,0,2,-2,L
185885,12,DNK1,2013-03-31,Odense,Horsens,2,0,2,W
185886,12,DNK1,2013-04-01,Esbjerg fB,Aalborg,1,0,1,W
185887,12,DNK1,2013-04-01,Nordsjalland,Midtjylland,3,1,2,W
185888,12,DNK1,2013-04-01,Silkeborg,FC Kobenhavn,1,0,1,W
185889,12,DNK1,2013-04-01,Brondby,Aarhus,3,2,1,W
185890,12,DNK1,2013-04-04,Aalborg,Nordsjalland,0,1,-1,L
185891,12,DNK1,2013-04-05,Aarhus,Esbjerg fB,0,1,-1,L
185892,12,DNK1,2013-04-06,SonderjyskE,Midtjylland,0,2,-2,L
185893,12,DNK1,2013-04-07,Horsens,Nordsjalland,0,2,-2,L
185894,12,DNK1,2013-04-07,Randers FC,Brondby,0,1,-1,L
185895,12,DNK1,2013-04-07,FC Kobenhavn,Odense,1,1,0,D
185896,12,DNK1,2013-04-08,Aalborg,Silkeborg,1,0,1,W
185897,12,DNK1,2013-04-09,SonderjyskE,Esbjerg fB,3,1,2,W
185898,12,DNK1,2013-04-12,Silkeborg,Aarhus,3,1,2,W
185899,12,DNK1,2013-04-13,Midtjylland,Horsens,5,2,3,W
185900,12,DNK1,2013-04-14,Esbjerg fB,Randers FC,4,0,4,W
185901,12,DNK1,2013-04-14,Brondby,SonderjyskE,0,3,-3,L
185902,12,DNK1,2013-04-14,Odense,Aalborg,3,4,-1,L
185903,12,DNK1,2013-04-15,Nordsjalland,FC Kobenhavn,2,3,-1,L
185904,12,DNK1,2013-04-20,Aarhus,Horsens,0,0,0,D
185905,12,DNK1,2013-04-21,Randers FC,Nordsjalland,0,0,0,D
185906,12,DNK1,2013-04-21,SonderjyskE,Odense,4,1,3,W
185907,12,DNK1,2013-04-21,Brondby,Silkeborg,2,2,0,D
185908,12,DNK1,2013-04-21,Aalborg,FC Kobenhavn,1,1,0,D
185909,12,DNK1,2013-04-22,Esbjerg fB,Midtjylland,0,1,-1,L
185910,12,DNK1,2013-04-26,Silkeborg,Esbjerg fB,0,1,-1,L
185911,12,DNK1,2013-04-27,Nordsjalland,SonderjyskE,2,2,0,D
185912,12,DNK1,2013-04-28,Horsens,Randers FC,1,0,1,W
185913,12,DNK1,2013-04-28,Odense,Brondby,1,2,-1,L
185914,12,DNK1,2013-04-28,FC Kobenhavn,Aarhus,0,0,0,D
185915,12,DNK1,2013-04-29,Midtjylland,Aalborg,2,3,-1,L
185916,12,DNK1,2013-05-03,Silkeborg,Nordsjalland,2,2,0,D
185917,12,DNK1,2013-05-04,SonderjyskE,Aalborg,1,0,1,W
185918,12,DNK1,2013-05-05,Esbjerg fB,Horsens,1,0,1,W
185919,12,DNK1,2013-05-05,Randers FC,Aarhus,1,0,1,W
185920,12,DNK1,2013-05-05,Brondby,FC Kobenhavn,0,0,0,D
185921,12,DNK1,2013-05-06,Odense,Midtjylland,0,1,-1,L
185922,12,DNK1,2013-05-10,Nordsjalland,Odense,4,1,3,W
185923,12,DNK1,2013-05-11,Aarhus,SonderjyskE,2,1,1,W
185924,12,DNK1,2013-05-12,Midtjylland,Randers FC,3,0,3,W
185925,12,DNK1,2013-05-12,Aalborg,Brondby,1,1,0,D
185926,12,DNK1,2013-05-12,FC Kobenhavn,Esbjerg fB,0,2,-2,L
185927,12,DNK1,2013-05-13,Horsens,Silkeborg,2,0,2,W
185928,12,DNK1,2013-05-16,Silkeborg,Midtjylland,1,1,0,D
185929,12,DNK1,2013-05-16,Esbjerg fB,Odense,6,2,4,W
185930,12,DNK1,2013-05-16,Brondby,Nordsjalland,4,0,4,W
185931,12,DNK1,2013-05-16,SonderjyskE,Horsens,4,2,2,W
185932,12,DNK1,2013-05-16,Randers FC,FC Kobenhavn,1,0,1,W
185933,12,DNK1,2013-05-16,Aarhus,Aalborg,3,0,3,W
185934,12,DNK1,2013-05-20,Nordsjalland,Esbjerg fB,1,0,1,W
185935,12,DNK1,2013-05-20,Odense,Silkeborg,3,3,0,D
185936,12,DNK1,2013-05-20,Aalborg,Randers FC,2,2,0,D
185937,12,DNK1,2013-05-20,FC Kobenhavn,SonderjyskE,1,1,0,D
185938,12,DNK1,2013-05-20,Horsens,Brondby,0,1,-1,L
185939,12,DNK1,2013-05-20,Midtjylland,Aarhus,3,2,1,W
185940,13,DNK1,2013-07-19,Aarhus,Midtjylland,0,2,-2,L
185941,13,DNK1,2013-07-20,Viborg,Randers FC,2,2,0,D
185942,13,DNK1,2013-07-21,Odense,SonderjyskE,1,1,0,D
185943,13,DNK1,2013-07-21,Brondby,Vestsjalland,1,1,0,D
185944,13,DNK1,2013-07-21,Aalborg,FC Kobenhavn,2,1,1,W
185945,13,DNK1,2013-07-22,Esbjerg fB,Nordsjalland,4,0,4,W
185946,13,DNK1,2013-07-26,Nordsjalland,Viborg,1,1,0,D
185947,13,DNK1,2013-07-27,Vestsjalland,Aarhus,0,2,-2,L
185948,13,DNK1,2013-07-28,Randers FC,Odense,1,1,0,D
185949,13,DNK1,2013-07-28,SonderjyskE,Brondby,1,0,1,W
185950,13,DNK1,2013-07-28,Midtjylland,FC Kobenhavn,1,0,1,W
185951,13,DNK1,2013-07-29,Esbjerg fB,Aalborg,1,2,-1,L
185952,13,DNK1,2013-08-02,Midtjylland,SonderjyskE,2,1,1,W
185953,13,DNK1,2013-08-03,Aarhus,Nordsjalland,2,1,1,W
185954,13,DNK1,2013-08-04,Odense,Viborg,4,2,2,W
185955,13,DNK1,2013-08-04,FC Kobenhavn,Randers FC,1,3,-2,L
185956,13,DNK1,2013-08-04,Brondby,Esbjerg fB,0,2,-2,L
185957,13,DNK1,2013-08-05,Vestsjalland,Aalborg,2,1,1,W
185958,13,DNK1,2013-08-09,Viborg,Brondby,2,2,0,D
185959,13,DNK1,2013-08-10,Esbjerg fB,Aarhus,5,1,4,W
185960,13,DNK1,2013-08-11,Randers FC,Midtjylland,1,3,-2,L
185961,13,DNK1,2013-08-11,Aalborg,Odense,0,0,0,D
185962,13,DNK1,2013-08-11,Nordsjalland,FC Kobenhavn,2,2,0,D
185963,13,DNK1,2013-08-12,SonderjyskE,Vestsjalland,0,0,0,D
185964,13,DNK1,2013-08-16,Midtjylland,Brondby,5,2,3,W
185965,13,DNK1,2013-08-17,Nordsjalland,Aalborg,2,1,1,W
185966,13,DNK1,2013-08-18,Vestsjalland,Odense,1,1,0,D
185967,13,DNK1,2013-08-18,SonderjyskE,Viborg,0,3,-3,L
185968,13,DNK1,2013-08-18,FC Kobenhavn,Aarhus,1,1,0,D
185969,13,DNK1,2013-08-19,Randers FC,Esbjerg fB,3,2,1,W
185970,13,DNK1,2013-08-23,Aarhus,SonderjyskE,3,1,2,W
185971,13,DNK1,2013-08-25,Odense,Nordsjalland,1,0,1,W
185972,13,DNK1,2013-08-25,Viborg,Esbjerg fB,3,1,2,W
185973,13,DNK1,2013-08-25,FC Kobenhavn,Vestsjalland,1,1,0,D
185974,13,DNK1,2013-08-25,Brondby,Randers FC,0,0,0,D
185975,13,DNK1,2013-08-26,Aalborg,Midtjylland,1,1,0,D
185976,13,DNK1,2013-08-30,Odense,Aarhus,3,6,-3,L
185977,13,DNK1,2013-09-01,Nordsjalland,Vestsjalland,1,2,-1,L
185978,13,DNK1,2013-09-01,Esbjerg fB,Midtjylland,1,1,0,D
185979,13,DNK1,2013-09-01,Viborg,FC Kobenhavn,1,4,-3,L
185980,13,DNK1,2013-09-01,Aalborg,Brondby,2,1,1,W
185981,13,DNK1,2013-09-02,Randers FC,SonderjyskE,0,2,-2,L
185982,13,DNK1,2013-09-13,SonderjyskE,Aalborg,1,3,-2,L
185983,13,DNK1,2013-09-14,FC Kobenhavn,Esbjerg fB,1,1,0,D
185984,13,DNK1,2013-09-15,Aarhus,Viborg,0,1,-1,L
185985,13,DNK1,2013-09-15,Vestsjalland,Randers FC,2,0,2,W
185986,13,DNK1,2013-09-15,Brondby,Odense,2,1,1,W
185987,13,DNK1,2013-09-16,Midtjylland,Nordsjalland,2,1,1,W
185988,13,DNK1,2013-09-20,Randers FC,Aalborg,3,2,1,W
185989,13,DNK1,2013-09-21,Midtjylland,Viborg,0,0,0,D
185990,13,DNK1,2013-09-22,SonderjyskE,Nordsjalland,2,0,2,W
185991,13,DNK1,2013-09-22,Aarhus,Brondby,1,3,-2,L
185992,13,DNK1,2013-09-22,FC Kobenhavn,Odense,2,1,1,W
185993,13,DNK1,2013-09-23,Vestsjalland,Esbjerg fB,1,3,-2,L
185994,13,DNK1,2013-09-27,Viborg,Vestsjalland,2,0,2,W
185995,13,DNK1,2013-09-28,Brondby,FC Kobenhavn,3,2,1,W
185996,13,DNK1,2013-09-29,Esbjerg fB,SonderjyskE,4,1,3,W
185997,13,DNK1,2013-09-29,Aalborg,Aarhus,0,0,0,D
185998,13,DNK1,2013-09-29,Odense,Midtjylland,1,1,0,D
185999,13,DNK1,2013-09-30,Nordsjalland,Randers FC,1,0,1,W
186000,13,DNK1,2013-10-05,Randers FC,Aarhus,2,2,0,D
186001,13,DNK1,2013-10-06,Esbjerg fB,Odense,1,3,-2,L
186002,13,DNK1,2013-10-06,Aalborg,Viborg,3,1,2,W
186003,13,DNK1,2013-10-06,FC Kobenhavn,SonderjyskE,2,1,1,W
186004,13,DNK1,2013-10-06,Nordsjalland,Brondby,1,1,0,D
186005,13,DNK1,2013-10-07,Midtjylland,Vestsjalland,2,2,0,D
186006,13,DNK1,2013-10-18,Aarhus,Nordsjalland,0,1,-1,L
186007,13,DNK1,2013-10-19,Midtjylland,Randers FC,1,1,0,D
186008,13,DNK1,2013-10-20,Vestsjalland,Esbjerg fB,2,1,1,W
186009,13,DNK1,2013-10-20,Brondby,Viborg,0,0,0,D
186010,13,DNK1,2013-10-20,FC Kobenhavn,Aalborg,3,0,3,W
186011,13,DNK1,2013-10-21,SonderjyskE,Odense,1,5,-4,L
186012,13,DNK1,2013-10-25,Viborg,Vestsjalland,4,1,3,W
186013,13,DNK1,2013-10-26,Nordsjalland,Midtjylland,2,1,1,W
186014,13,DNK1,2013-10-27,Aalborg,SonderjyskE,2,0,2,W
186015,13,DNK1,2013-10-27,Randers FC,FC Kobenhavn,1,1,0,D
186016,13,DNK1,2013-10-27,Odense,Brondby,0,0,0,D
186017,13,DNK1,2013-10-28,Esbjerg fB,Aarhus,0,2,-2,L
186018,13,DNK1,2013-11-01,SonderjyskE,Randers FC,1,3,-2,L
186019,13,DNK1,2013-11-02,FC Kobenhavn,Nordsjalland,4,0,4,W
186020,13,DNK1,2013-11-02,Aalborg,Odense,1,0,1,W
186021,13,DNK1,2013-11-03,Aarhus,Viborg,2,1,1,W
186022,13,DNK1,2013-11-03,Midtjylland,Esbjerg fB,3,0,3,W
186023,13,DNK1,2013-11-04,Vestsjalland,Brondby,0,2,-2,L
186024,13,DNK1,2013-11-08,Viborg,Midtjylland,2,3,-1,L
186025,13,DNK1,2013-11-09,Nordsjalland,SonderjyskE,3,0,3,W
186026,13,DNK1,2013-11-10,Odense,Vestsjalland,1,3,-2,L
186027,13,DNK1,2013-11-10,Esbjerg fB,FC Kobenhavn,1,1,0,D
186028,13,DNK1,2013-11-10,Brondby,Aarhus,3,0,3,W
186029,13,DNK1,2013-11-11,Randers FC,Aalborg,1,4,-3,L
186030,13,DNK1,2013-11-22,SonderjyskE,Esbjerg fB,1,0,1,W
186031,13,DNK1,2013-11-23,Randers FC,Odense,1,1,0,D
186032,13,DNK1,2013-11-24,Aarhus,Vestsjalland,2,2,0,D
186033,13,DNK1,2013-11-24,FC Kobenhavn,Viborg,4,1,3,W
186034,13,DNK1,2013-11-24,Midtjylland,Brondby,0,1,-1,L
186035,13,DNK1,2013-11-25,Aalborg,Nordsjalland,1,1,0,D
186036,13,DNK1,2013-11-29,Vestsjalland,Midtjylland,0,1,-1,L
186037,13,DNK1,2013-11-30,Viborg,SonderjyskE,2,2,0,D
186038,13,DNK1,2013-12-01,Nordsjalland,Randers FC,1,1,0,D
186039,13,DNK1,2013-12-01,Odense,Aarhus,4,1,3,W
186040,13,DNK1,2013-12-01,Brondby,FC Kobenhavn,1,3,-2,L
186041,13,DNK1,2013-12-02,Esbjerg fB,Aalborg,2,2,0,D
186042,13,DNK1,2013-12-06,Nordsjalland,Odense,2,0,2,W
186043,13,DNK1,2013-12-07,FC Kobenhavn,Vestsjalland,1,0,1,W
186044,13,DNK1,2013-12-08,Randers FC,Esbjerg fB,1,0,1,W
186045,13,DNK1,2013-12-08,Midtjylland,Aarhus,3,0,3,W
186046,13,DNK1,2013-12-08,SonderjyskE,Brondby,1,1,0,D
186047,13,DNK1,2013-12-09,Aalborg,Viborg,5,0,5,W
186048,13,DNK1,2014-02-21,Vestsjalland,SonderjyskE,0,4,-4,L
186049,13,DNK1,2014-02-22,Odense,Midtjylland,2,1,1,W
186050,13,DNK1,2014-02-23,Viborg,Randers FC,1,1,0,D
186051,13,DNK1,2014-02-23,Aarhus,FC Kobenhavn,1,1,0,D
186052,13,DNK1,2014-02-23,Brondby,Aalborg,2,2,0,D
186053,13,DNK1,2014-02-24,Esbjerg fB,Nordsjalland,2,1,1,W
186054,13,DNK1,2014-02-28,Nordsjalland,Viborg,2,0,2,W
186055,13,DNK1,2014-03-01,SonderjyskE,Aarhus,1,2,-1,L
186056,13,DNK1,2014-03-02,Esbjerg fB,Odense,1,0,1,W
186057,13,DNK1,2014-03-02,Aalborg,Vestsjalland,0,0,0,D
186058,13,DNK1,2014-03-02,Randers FC,Brondby,0,1,-1,L
186059,13,DNK1,2014-03-02,FC Kobenhavn,Midtjylland,1,5,-4,L
186060,13,DNK1,2014-03-07,Vestsjalland,Randers FC,1,1,0,D
186061,13,DNK1,2014-03-08,Aarhus,Aalborg,2,5,-3,L
186062,13,DNK1,2014-03-09,Viborg,Esbjerg fB,1,3,-2,L
186063,13,DNK1,2014-03-09,Brondby,Nordsjalland,4,1,3,W
186064,13,DNK1,2014-03-09,Odense,FC Kobenhavn,0,1,-1,L
186065,13,DNK1,2014-03-10,Midtjylland,SonderjyskE,2,0,2,W
186066,13,DNK1,2014-03-14,SonderjyskE,FC Kobenhavn,0,0,0,D
186067,13,DNK1,2014-03-15,Nordsjalland,Vestsjalland,1,2,-1,L
186068,13,DNK1,2014-03-16,Odense,Viborg,1,1,0,D
186069,13,DNK1,2014-03-16,Aalborg,Midtjylland,1,0,1,W
186070,13,DNK1,2014-03-16,Esbjerg fB,Brondby,0,0,0,D
186071,13,DNK1,2014-03-17,Randers FC,Aarhus,1,3,-2,L
186072,13,DNK1,2014-03-21,Vestsjalland,Viborg,0,1,-1,L
186073,13,DNK1,2014-03-22,Midtjylland,Nordsjalland,0,1,-1,L
186074,13,DNK1,2014-03-23,SonderjyskE,Aalborg,3,2,1,W
186075,13,DNK1,2014-03-23,FC Kobenhavn,Randers FC,1,1,0,D
186076,13,DNK1,2014-03-23,Brondby,Odense,1,2,-1,L
186077,13,DNK1,2014-03-24,Aarhus,Esbjerg fB,0,3,-3,L
186078,13,DNK1,2014-03-28,Odense,SonderjyskE,2,2,0,D
186079,13,DNK1,2014-03-29,Esbjerg fB,Vestsjalland,0,0,0,D
186080,13,DNK1,2014-03-30,Randers FC,Midtjylland,0,3,-3,L
186081,13,DNK1,2014-03-30,Viborg,Brondby,0,1,-1,L
186082,13,DNK1,2014-03-30,Aalborg,FC Kobenhavn,2,1,1,W
186083,13,DNK1,2014-03-31,Nordsjalland,Aarhus,1,0,1,W
186084,13,DNK1,2014-04-04,Aarhus,Randers FC,0,1,-1,L
186085,13,DNK1,2014-04-05,Midtjylland,Aalborg,2,3,-1,L
186086,13,DNK1,2014-04-06,Viborg,Odense,2,2,0,D
186087,13,DNK1,2014-04-06,FC Kobenhavn,SonderjyskE,2,0,2,W
186088,13,DNK1,2014-04-06,Brondby,Esbjerg fB,1,0,1,W
186089,13,DNK1,2014-04-07,Vestsjalland,Nordsjalland,0,0,0,D
186090,13,DNK1,2014-04-11,SonderjyskE,Vestsjalland,1,1,0,D
186091,13,DNK1,2014-04-12,Midtjylland,Odense,0,2,-2,L
186092,13,DNK1,2014-04-13,Randers FC,Viborg,3,1,2,W
186093,13,DNK1,2014-04-13,FC Kobenhavn,Aarhus,1,0,1,W
186094,13,DNK1,2014-04-13,Aalborg,Brondby,2,0,2,W
186095,13,DNK1,2014-04-14,Nordsjalland,Esbjerg fB,0,1,-1,L
186096,13,DNK1,2014-04-16,Viborg,Aalborg,0,2,-2,L
186097,13,DNK1,2014-04-17,Odense,Nordsjalland,0,1,-1,L
186098,13,DNK1,2014-04-17,Esbjerg fB,Randers FC,0,3,-3,L
186099,13,DNK1,2014-04-17,Vestsjalland,FC Kobenhavn,0,1,-1,L
186100,13,DNK1,2014-04-18,Brondby,SonderjyskE,3,1,2,W
186101,13,DNK1,2014-04-18,Aarhus,Midtjylland,0,4,-4,L
186102,13,DNK1,2014-04-20,Vestsjalland,Odense,1,0,1,W
186103,13,DNK1,2014-04-20,Aalborg,Randers FC,1,2,-1,L
186104,13,DNK1,2014-04-21,SonderjyskE,Nordsjalland,3,1,2,W
186105,13,DNK1,2014-04-21,Midtjylland,Viborg,5,2,3,W
186106,13,DNK1,2014-04-21,Aarhus,Brondby,1,2,-1,L
186107,13,DNK1,2014-04-21,FC Kobenhavn,Esbjerg fB,2,2,0,D
186108,13,DNK1,2014-04-25,Randers FC,SonderjyskE,1,1,0,D
186109,13,DNK1,2014-04-26,Odense,Aalborg,2,3,-1,L
186110,13,DNK1,2014-04-27,Viborg,Aarhus,0,3,-3,L
186111,13,DNK1,2014-04-27,Brondby,Vestsjalland,2,2,0,D
186112,13,DNK1,2014-04-27,Nordsjalland,FC Kobenhavn,1,0,1,W
186113,13,DNK1,2014-04-28,Esbjerg fB,Midtjylland,0,0,0,D
186114,13,DNK1,2014-05-02,Randers FC,Nordsjalland,0,1,-1,L
186115,13,DNK1,2014-05-03,Aalborg,Esbjerg fB,0,2,-2,L
186116,13,DNK1,2014-05-04,SonderjyskE,Viborg,1,0,1,W
186117,13,DNK1,2014-05-04,Midtjylland,Vestsjalland,3,1,2,W
186118,13,DNK1,2014-05-04,FC Kobenhavn,Brondby,1,1,0,D
186119,13,DNK1,2014-05-05,Aarhus,Odense,0,1,-1,L
186120,13,DNK1,2014-05-07,Esbjerg fB,SonderjyskE,2,1,1,W
186121,13,DNK1,2014-05-07,Nordsjalland,Aalborg,2,4,-2,L
186122,13,DNK1,2014-05-08,Viborg,FC Kobenhavn,0,2,-2,L
186123,13,DNK1,2014-05-08,Odense,Randers FC,2,1,1,W
186124,13,DNK1,2014-05-08,Brondby,Midtjylland,3,1,2,W
186125,13,DNK1,2014-05-08,Vestsjalland,Aarhus,2,1,1,W
186126,13,DNK1,2014-05-11,Viborg,Nordsjalland,1,3,-2,L
186127,13,DNK1,2014-05-11,Brondby,Randers FC,1,1,0,D
186128,13,DNK1,2014-05-11,Vestsjalland,Aalborg,0,0,0,D
186129,13,DNK1,2014-05-11,Aarhus,SonderjyskE,0,3,-3,L
186130,13,DNK1,2014-05-11,Midtjylland,FC Kobenhavn,2,3,-1,L
186131,13,DNK1,2014-05-11,Odense,Esbjerg fB,1,2,-1,L
186132,13,DNK1,2014-05-18,FC Kobenhavn,Odense,3,2,1,W
186133,13,DNK1,2014-05-18,SonderjyskE,Midtjylland,3,1,2,W
186134,13,DNK1,2014-05-18,Aalborg,Aarhus,1,0,1,W
186135,13,DNK1,2014-05-18,Randers FC,Vestsjalland,1,1,0,D
186136,13,DNK1,2014-05-18,Nordsjalland,Brondby,2,2,0,D
186137,13,DNK1,2014-05-18,Esbjerg fB,Viborg,0,0,0,D
186138,14,DNK1,2014-07-18,Nordsjalland,Vestsjalland,3,2,1,W
186139,14,DNK1,2014-07-19,SonderjyskE,Aalborg,0,0,0,D
186140,14,DNK1,2014-07-20,Odense,Hobro,1,2,-1,L
186141,14,DNK1,2014-07-20,Silkeborg,FC Kobenhavn,0,0,0,D
186142,14,DNK1,2014-07-20,Midtjylland,Brondby,3,1,2,W
186143,14,DNK1,2014-07-21,Esbjerg fB,Randers FC,0,1,-1,L
186144,14,DNK1,2014-07-25,Vestsjalland,Odense,3,1,2,W
186145,14,DNK1,2014-07-26,Aalborg,Midtjylland,2,0,2,W
186146,14,DNK1,2014-07-26,FC Kobenhavn,Nordsjalland,2,1,1,W
186147,14,DNK1,2014-07-27,Randers FC,Hobro,2,1,1,W
186148,14,DNK1,2014-07-27,Esbjerg fB,SonderjyskE,1,1,0,D
186149,14,DNK1,2014-07-28,Brondby,Silkeborg,2,0,2,W
186150,14,DNK1,2014-08-01,Silkeborg,SonderjyskE,0,2,-2,L
186151,14,DNK1,2014-08-02,Vestsjalland,FC Kobenhavn,2,2,0,D
186152,14,DNK1,2014-08-02,Odense,Aalborg,1,1,0,D
186153,14,DNK1,2014-08-03,Nordsjalland,Esbjerg fB,3,2,1,W
186154,14,DNK1,2014-08-03,Hobro,Brondby,2,0,2,W
186155,14,DNK1,2014-08-04,Midtjylland,Randers FC,3,1,2,W
186156,14,DNK1,2014-08-08,Randers FC,Vestsjalland,1,0,1,W
186157,14,DNK1,2014-08-09,Aalborg,Nordsjalland,1,2,-1,L
186158,14,DNK1,2014-08-10,SonderjyskE,Midtjylland,1,3,-2,L
186159,14,DNK1,2014-08-10,FC Kobenhavn,Hobro,0,3,-3,L
186160,14,DNK1,2014-08-10,Brondby,Odense,1,1,0,D
186161,14,DNK1,2014-08-11,Esbjerg fB,Silkeborg,0,0,0,D
186162,14,DNK1,2014-08-15,FC Kobenhavn,Midtjylland,1,2,-1,L
186163,14,DNK1,2014-08-16,Aalborg,Esbjerg fB,1,1,0,D
186164,14,DNK1,2014-08-17,Vestsjalland,Silkeborg,2,0,2,W
186165,14,DNK1,2014-08-17,Brondby,SonderjyskE,2,0,2,W
186166,14,DNK1,2014-08-17,Randers FC,Odense,0,2,-2,L
186167,14,DNK1,2014-08-18,Hobro,Nordsjalland,0,0,0,D
186168,14,DNK1,2014-08-30,SonderjyskE,Randers FC,1,1,0,D
186169,14,DNK1,2014-08-31,Silkeborg,Aalborg,2,2,0,D
186170,14,DNK1,2014-08-31,Midtjylland,Esbjerg fB,2,0,2,W
186171,14,DNK1,2014-08-31,Nordsjalland,Brondby,0,3,-3,L
186172,14,DNK1,2014-08-31,Odense,FC Kobenhavn,0,1,-1,L
186173,14,DNK1,2014-09-01,Hobro,Vestsjalland,3,1,2,W
186174,14,DNK1,2014-09-12,Midtjylland,Odense,3,2,1,W
186175,14,DNK1,2014-09-13,Aalborg,FC Kobenhavn,1,0,1,W
186176,14,DNK1,2014-09-14,Silkeborg,Nordsjalland,1,2,-1,L
186177,14,DNK1,2014-09-14,Brondby,Randers FC,0,2,-2,L
186178,14,DNK1,2014-09-14,Esbjerg fB,Vestsjalland,3,0,3,W
186179,14,DNK1,2014-09-15,SonderjyskE,Hobro,1,1,0,D
186180,14,DNK1,2014-09-19,Randers FC,Silkeborg,1,0,1,W
186181,14,DNK1,2014-09-20,Hobro,Esbjerg fB,1,1,0,D
186182,14,DNK1,2014-09-21,Odense,SonderjyskE,1,1,0,D
186183,14,DNK1,2014-09-21,FC Kobenhavn,Brondby,1,0,1,W
186184,14,DNK1,2014-09-21,Nordsjalland,Midtjylland,2,1,1,W
186185,14,DNK1,2014-09-22,Vestsjalland,Aalborg,1,0,1,W
186186,14,DNK1,2014-09-26,Aalborg,Randers FC,0,0,0,D
186187,14,DNK1,2014-09-27,SonderjyskE,FC Kobenhavn,1,1,0,D
186188,14,DNK1,2014-09-27,Silkeborg,Hobro,2,2,0,D
186189,14,DNK1,2014-09-28,Midtjylland,Vestsjalland,1,0,1,W
186190,14,DNK1,2014-09-28,Esbjerg fB,Brondby,2,2,0,D
186191,14,DNK1,2014-09-29,Nordsjalland,Odense,2,1,1,W
186192,14,DNK1,2014-10-03,Hobro,Midtjylland,1,5,-4,L
186193,14,DNK1,2014-10-04,Odense,Silkeborg,2,0,2,W
186194,14,DNK1,2014-10-05,Vestsjalland,SonderjyskE,1,1,0,D
186195,14,DNK1,2014-10-05,Randers FC,Nordsjalland,0,0,0,D
186196,14,DNK1,2014-10-05,FC Kobenhavn,Esbjerg fB,2,1,1,W
186197,14,DNK1,2014-10-05,Brondby,Aalborg,2,1,1,W
186198,14,DNK1,2014-10-17,Aalborg,Hobro,1,1,0,D
186199,14,DNK1,2014-10-18,Nordsjalland,SonderjyskE,2,3,-1,L
186200,14,DNK1,2014-10-19,Midtjylland,Silkeborg,2,1,1,W
186201,14,DNK1,2014-10-19,Brondby,Vestsjalland,5,0,5,W
186202,14,DNK1,2014-10-19,FC Kobenhavn,Randers FC,1,0,1,W
186203,14,DNK1,2014-10-20,Esbjerg fB,Odense,2,0,2,W
186204,14,DNK1,2014-10-24,Silkeborg,Vestsjalland,1,2,-1,L
186205,14,DNK1,2014-10-25,SonderjyskE,Midtjylland,1,1,0,D
186206,14,DNK1,2014-10-26,Randers FC,Odense,3,0,3,W
186207,14,DNK1,2014-10-26,Hobro,FC Kobenhavn,0,2,-2,L
186208,14,DNK1,2014-10-26,Esbjerg fB,Brondby,0,0,0,D
186209,14,DNK1,2014-10-27,Nordsjalland,Aalborg,0,1,-1,L
186210,14,DNK1,2014-10-31,Midtjylland,Nordsjalland,2,0,2,W
186211,14,DNK1,2014-11-01,Vestsjalland,Esbjerg fB,1,4,-3,L
186212,14,DNK1,2014-11-02,Odense,Hobro,3,1,2,W
186213,14,DNK1,2014-11-02,FC Kobenhavn,SonderjyskE,1,1,0,D
186214,14,DNK1,2014-11-02,Brondby,Randers FC,1,0,1,W
186215,14,DNK1,2014-11-03,Aalborg,Silkeborg,2,0,2,W
186216,14,DNK1,2014-11-07,Silkeborg,Midtjylland,1,2,-1,L
186217,14,DNK1,2014-11-08,Randers FC,Esbjerg fB,3,2,1,W
186218,14,DNK1,2014-11-09,SonderjyskE,Odense,2,1,1,W
186219,14,DNK1,2014-11-09,Aalborg,Vestsjalland,2,0,2,W
186220,14,DNK1,2014-11-09,Hobro,Brondby,3,0,3,W
186221,14,DNK1,2014-11-09,Nordsjalland,FC Kobenhavn,0,0,0,D
186222,14,DNK1,2014-11-21,Vestsjalland,Randers FC,0,1,-1,L
186223,14,DNK1,2014-11-22,Esbjerg fB,Hobro,4,2,2,W
186224,14,DNK1,2014-11-22,FC Kobenhavn,Silkeborg,1,0,1,W
186225,14,DNK1,2014-11-23,Odense,Nordsjalland,1,0,1,W
186226,14,DNK1,2014-11-23,Brondby,SonderjyskE,1,0,1,W
186227,14,DNK1,2014-11-23,Midtjylland,Aalborg,2,0,2,W
186228,14,DNK1,2014-11-28,SonderjyskE,Esbjerg fB,0,0,0,D
186229,14,DNK1,2014-11-29,Silkeborg,Odense,0,1,-1,L
186230,14,DNK1,2014-11-30,Hobro,Randers FC,0,1,-1,L
186231,14,DNK1,2014-11-30,Nordsjalland,Brondby,2,0,2,W
186232,14,DNK1,2014-11-30,Aalborg,FC Kobenhavn,0,1,-1,L
186233,14,DNK1,2014-12-01,Midtjylland,Vestsjalland,2,1,1,W
186234,14,DNK1,2014-12-05,Randers FC,SonderjyskE,0,0,0,D
186235,14,DNK1,2014-12-06,Odense,Aalborg,1,1,0,D
186236,14,DNK1,2014-12-07,Vestsjalland,Hobro,1,1,0,D
186237,14,DNK1,2014-12-07,Brondby,Silkeborg,1,0,1,W
186238,14,DNK1,2014-12-07,FC Kobenhavn,Midtjylland,3,0,3,W
186239,14,DNK1,2014-12-08,Esbjerg fB,Nordsjalland,0,0,0,D
186240,14,DNK1,2015-02-20,Nordsjalland,Randers FC,0,3,-3,L
186241,14,DNK1,2015-02-21,Silkeborg,Esbjerg fB,1,3,-2,L
186242,14,DNK1,2015-02-22,SonderjyskE,Hobro,1,0,1,W
186243,14,DNK1,2015-02-22,FC Kobenhavn,Vestsjalland,2,0,2,W
186244,14,DNK1,2015-02-22,Aalborg,Brondby,1,0,1,W
186245,14,DNK1,2015-02-23,Midtjylland,Odense,3,0,3,W
186246,14,DNK1,2015-02-27,Vestsjalland,SonderjyskE,0,1,-1,L
186247,14,DNK1,2015-02-28,Hobro,Nordsjalland,1,0,1,W
186248,14,DNK1,2015-03-01,Randers FC,Silkeborg,1,2,-1,L
186249,14,DNK1,2015-03-01,Odense,FC Kobenhavn,1,0,1,W
186250,14,DNK1,2015-03-01,Brondby,Midtjylland,1,1,0,D
186251,14,DNK1,2015-03-02,Esbjerg fB,Aalborg,1,3,-2,L
186252,14,DNK1,2015-03-07,Nordsjalland,SonderjyskE,4,0,4,W
186253,14,DNK1,2015-03-08,Silkeborg,Hobro,0,1,-1,L
186254,14,DNK1,2015-03-08,FC Kobenhavn,Brondby,3,1,2,W
186255,14,DNK1,2015-03-08,Midtjylland,Esbjerg fB,3,0,3,W
186256,14,DNK1,2015-03-08,Aalborg,Randers FC,2,1,1,W
186257,14,DNK1,2015-03-09,Vestsjalland,Odense,1,2,-1,L
186258,14,DNK1,2015-03-13,Randers FC,Midtjylland,1,2,-1,L
186259,14,DNK1,2015-03-14,SonderjyskE,Silkeborg,1,4,-3,L
186260,14,DNK1,2015-03-15,Nordsjalland,Vestsjalland,2,0,2,W
186261,14,DNK1,2015-03-15,Esbjerg fB,FC Kobenhavn,0,1,-1,L
186262,14,DNK1,2015-03-15,Brondby,Odense,2,0,2,W
186263,14,DNK1,2015-03-16,Hobro,Aalborg,1,0,1,W
186264,14,DNK1,2015-03-20,Odense,Esbjerg fB,0,2,-2,L
186265,14,DNK1,2015-03-21,Midtjylland,Hobro,3,0,3,W
186266,14,DNK1,2015-03-22,Silkeborg,Nordsjalland,2,2,0,D
186267,14,DNK1,2015-03-22,Aalborg,SonderjyskE,1,4,-3,L
186268,14,DNK1,2015-03-22,Vestsjalland,Brondby,0,1,-1,L
186269,14,DNK1,2015-03-22,FC Kobenhavn,Randers FC,1,1,0,D
186270,14,DNK1,2015-04-04,SonderjyskE,Nordsjalland,1,2,-1,L
186271,14,DNK1,2015-04-05,Hobro,Silkeborg,2,2,0,D
186272,14,DNK1,2015-04-05,Esbjerg fB,Midtjylland,3,3,0,D
186273,14,DNK1,2015-04-06,Brondby,FC Kobenhavn,0,0,0,D
186274,14,DNK1,2015-04-06,Randers FC,Aalborg,1,1,0,D
186275,14,DNK1,2015-04-07,Odense,Vestsjalland,1,2,-1,L
186276,14,DNK1,2015-04-10,Hobro,Esbjerg fB,3,1,2,W
186277,14,DNK1,2015-04-11,Randers FC,Vestsjalland,1,1,0,D
186278,14,DNK1,2015-04-12,Nordsjalland,Odense,1,2,-1,L
186279,14,DNK1,2015-04-12,Aalborg,Midtjylland,1,2,-1,L
186280,14,DNK1,2015-04-12,SonderjyskE,Brondby,0,1,-1,L
186281,14,DNK1,2015-04-13,Silkeborg,FC Kobenhavn,0,4,-4,L
186282,14,DNK1,2015-04-17,Midtjylland,Silkeborg,1,0,1,W
186283,14,DNK1,2015-04-18,Vestsjalland,Aalborg,2,1,1,W
186284,14,DNK1,2015-04-19,Odense,SonderjyskE,0,0,0,D
186285,14,DNK1,2015-04-19,Brondby,Hobro,0,1,-1,L
186286,14,DNK1,2015-04-19,FC Kobenhavn,Nordsjalland,2,0,2,W
186287,14,DNK1,2015-04-20,Esbjerg fB,Randers FC,0,0,0,D
186288,14,DNK1,2015-04-24,Esbjerg fB,Odense,0,2,-2,L
186289,14,DNK1,2015-04-25,Nordsjalland,Silkeborg,1,0,1,W
186290,14,DNK1,2015-04-26,SonderjyskE,Aalborg,0,3,-3,L
186291,14,DNK1,2015-04-26,Brondby,Vestsjalland,4,0,4,W
186292,14,DNK1,2015-04-26,Randers FC,FC Kobenhavn,3,0,3,W
186293,14,DNK1,2015-04-27,Hobro,Midtjylland,0,0,0,D
186294,14,DNK1,2015-05-01,Aalborg,Hobro,5,0,5,W
186295,14,DNK1,2015-05-02,Silkeborg,SonderjyskE,2,2,0,D
186296,14,DNK1,2015-05-03,Vestsjalland,Nordsjalland,2,1,1,W
186297,14,DNK1,2015-05-03,FC Kobenhavn,Esbjerg fB,2,1,1,W
186298,14,DNK1,2015-05-03,Odense,Brondby,0,2,-2,L
186299,14,DNK1,2015-05-04,Midtjylland,Randers FC,5,2,3,W
186300,14,DNK1,2015-05-08,Randers FC,Nordsjalland,2,0,2,W
186301,14,DNK1,2015-05-09,Esbjerg fB,Silkeborg,5,2,3,W
186302,14,DNK1,2015-05-10,Hobro,SonderjyskE,2,2,0,D
186303,14,DNK1,2015-05-10,Odense,Midtjylland,3,1,2,W
186304,14,DNK1,2015-05-10,Brondby,Aalborg,1,1,0,D
186305,14,DNK1,2015-05-11,Vestsjalland,FC Kobenhavn,0,1,-1,L
186306,14,DNK1,2015-05-15,Aalborg,Odense,0,2,-2,L
186307,14,DNK1,2015-05-17,Hobro,Vestsjalland,0,1,-1,L
186308,14,DNK1,2015-05-17,Silkeborg,Brondby,0,2,-2,L
186309,14,DNK1,2015-05-17,Midtjylland,FC Kobenhavn,2,0,2,W
186310,14,DNK1,2015-05-18,Nordsjalland,Esbjerg fB,1,3,-2,L
186311,14,DNK1,2015-05-18,SonderjyskE,Randers FC,1,1,0,D
186312,14,DNK1,2015-05-20,Odense,Silkeborg,1,1,0,D
186313,14,DNK1,2015-05-20,FC Kobenhavn,Aalborg,1,0,1,W
186314,14,DNK1,2015-05-21,Randers FC,Hobro,0,1,-1,L
186315,14,DNK1,2015-05-21,Vestsjalland,Midtjylland,0,0,0,D
186316,14,DNK1,2015-05-21,Brondby,Nordsjalland,3,1,2,W
186317,14,DNK1,2015-05-21,Esbjerg fB,SonderjyskE,2,3,-1,L
186318,14,DNK1,2015-05-24,SonderjyskE,Vestsjalland,1,1,0,D
186319,14,DNK1,2015-05-25,Nordsjalland,Hobro,4,2,2,W
186320,14,DNK1,2015-05-25,Silkeborg,Randers FC,0,2,-2,L
186321,14,DNK1,2015-05-25,FC Kobenhavn,Odense,1,0,1,W
186322,14,DNK1,2015-05-25,Midtjylland,Brondby,2,3,-1,L
186323,14,DNK1,2015-05-26,Aalborg,Esbjerg fB,1,0,1,W
186324,14,DNK1,2015-05-31,Esbjerg fB,Vestsjalland,2,1,1,W
186325,14,DNK1,2015-05-31,Randers FC,Brondby,1,1,0,D
186326,14,DNK1,2015-05-31,Hobro,Odense,2,2,0,D
186327,14,DNK1,2015-05-31,SonderjyskE,FC Kobenhavn,1,2,-1,L
186328,14,DNK1,2015-05-31,Nordsjalland,Midtjylland,1,0,1,W
186329,14,DNK1,2015-05-31,Silkeborg,Aalborg,1,2,-1,L
186330,14,DNK1,2015-06-07,Odense,Randers FC,0,2,-2,L
186331,14,DNK1,2015-06-07,Brondby,Esbjerg fB,0,1,-1,L
186332,14,DNK1,2015-06-07,Aalborg,Nordsjalland,1,0,1,W
186333,14,DNK1,2015-06-07,Midtjylland,SonderjyskE,2,1,1,W
186334,14,DNK1,2015-06-07,FC Kobenhavn,Hobro,1,0,1,W
186335,14,DNK1,2015-06-07,Vestsjalland,Silkeborg,3,1,2,W
186336,15,DNK1,2015-07-17,Nordsjalland,SonderjyskE,0,2,-2,L
186337,15,DNK1,2015-07-18,Midtjylland,Viborg,2,0,2,W
186338,15,DNK1,2015-07-19,Odense,Hobro,3,0,3,W
186339,15,DNK1,2015-07-19,Aarhus,Brondby,2,1,1,W
186340,15,DNK1,2015-07-20,Aalborg,Esbjerg fB,1,1,0,D
186341,15,DNK1,2015-07-24,Hobro,Aalborg,0,1,-1,L
186342,15,DNK1,2015-07-24,SonderjyskE,Midtjylland,1,2,-1,L
186343,15,DNK1,2015-07-26,Randers FC,Nordsjalland,3,0,3,W
186344,15,DNK1,2015-07-26,Brondby,Odense,1,2,-1,L
186345,15,DNK1,2015-07-26,Esbjerg fB,FC Kobenhavn,1,2,-1,L
186346,15,DNK1,2015-07-27,Viborg,Aarhus,0,0,0,D
186347,15,DNK1,2015-07-31,Viborg,Esbjerg fB,2,1,1,W
186348,15,DNK1,2015-07-31,Midtjylland,Odense,1,0,1,W
186349,15,DNK1,2015-08-02,Aarhus,Randers FC,3,2,1,W
186350,15,DNK1,2015-08-02,SonderjyskE,FC Kobenhavn,1,3,-2,L
186351,15,DNK1,2015-08-02,Brondby,Hobro,0,2,-2,L
186352,15,DNK1,2015-08-03,Nordsjalland,Aalborg,2,1,1,W
186353,15,DNK1,2015-08-07,Odense,Aarhus,2,2,0,D
186354,15,DNK1,2015-08-08,Hobro,Viborg,1,1,0,D
186355,15,DNK1,2015-08-09,Esbjerg fB,SonderjyskE,0,4,-4,L
186356,15,DNK1,2015-08-09,FC Kobenhavn,Nordsjalland,1,1,0,D
186357,15,DNK1,2015-08-09,Randers FC,Brondby,3,3,0,D
186358,15,DNK1,2015-08-10,Aalborg,Midtjylland,0,2,-2,L
186359,15,DNK1,2015-08-14,Midtjylland,FC Kobenhavn,0,0,0,D
186360,15,DNK1,2015-08-15,Aarhus,Aalborg,2,3,-1,L
186361,15,DNK1,2015-08-16,Nordsjalland,Esbjerg fB,1,2,-1,L
186362,15,DNK1,2015-08-16,Viborg,Brondby,0,4,-4,L
186363,15,DNK1,2015-08-16,Odense,Randers FC,2,3,-1,L
186364,15,DNK1,2015-08-17,SonderjyskE,Hobro,3,0,3,W
186365,15,DNK1,2015-08-21,Hobro,Nordsjalland,1,3,-2,L
186366,15,DNK1,2015-08-23,Randers FC,Viborg,0,1,-1,L
186367,15,DNK1,2015-08-23,Brondby,SonderjyskE,1,0,1,W
186368,15,DNK1,2015-08-23,FC Kobenhavn,Aarhus,2,2,0,D
186369,15,DNK1,2015-08-23,Esbjerg fB,Midtjylland,1,1,0,D
186370,15,DNK1,2015-08-24,Aalborg,Odense,5,1,4,W
186371,15,DNK1,2015-08-28,Aarhus,Esbjerg fB,0,0,0,D
186372,15,DNK1,2015-08-29,SonderjyskE,Viborg,2,1,1,W
186373,15,DNK1,2015-08-30,Aalborg,Randers FC,0,2,-2,L
186374,15,DNK1,2015-08-30,Nordsjalland,Brondby,0,2,-2,L
186375,15,DNK1,2015-08-30,Odense,FC Kobenhavn,1,0,1,W
186376,15,DNK1,2015-08-30,Midtjylland,Hobro,2,0,2,W
186377,15,DNK1,2015-09-11,Hobro,Aarhus,0,3,-3,L
186378,15,DNK1,2015-09-12,Viborg,Nordsjalland,0,1,-1,L
186379,15,DNK1,2015-09-13,Randers FC,SonderjyskE,1,0,1,W
186380,15,DNK1,2015-09-13,FC Kobenhavn,Aalborg,4,2,2,W
186381,15,DNK1,2015-09-13,Brondby,Midtjylland,0,0,0,D
186382,15,DNK1,2015-09-14,Esbjerg fB,Odense,4,2,2,W
186383,15,DNK1,2015-09-16,FC Kobenhavn,Randers FC,3,0,3,W
186384,15,DNK1,2015-09-18,Aarhus,SonderjyskE,1,2,-1,L
186385,15,DNK1,2015-09-19,Odense,Viborg,2,0,2,W
186386,15,DNK1,2015-09-20,Midtjylland,Nordsjalland,0,1,-1,L
186387,15,DNK1,2015-09-20,FC Kobenhavn,Hobro,1,0,1,W
186388,15,DNK1,2015-09-20,Aalborg,Brondby,4,1,3,W
186389,15,DNK1,2015-09-21,Esbjerg fB,Randers FC,0,2,-2,L
186390,15,DNK1,2015-09-25,SonderjyskE,Odense,4,0,4,W
186391,15,DNK1,2015-09-25,Viborg,Aalborg,1,0,1,W
186392,15,DNK1,2015-09-27,Brondby,FC Kobenhavn,1,0,1,W
186393,15,DNK1,2015-09-27,Randers FC,Midtjylland,0,2,-2,L
186394,15,DNK1,2015-09-27,Nordsjalland,Aarhus,2,0,2,W
186395,15,DNK1,2015-09-28,Hobro,Esbjerg fB,2,2,0,D
186396,15,DNK1,2015-10-02,Nordsjalland,Odense,1,5,-4,L
186397,15,DNK1,2015-10-03,Randers FC,Hobro,2,1,1,W
186398,15,DNK1,2015-10-04,Aalborg,SonderjyskE,5,0,5,W
186399,15,DNK1,2015-10-04,FC Kobenhavn,Viborg,1,0,1,W
186400,15,DNK1,2015-10-04,Brondby,Esbjerg fB,1,1,0,D
186401,15,DNK1,2015-10-04,Midtjylland,Aarhus,2,0,2,W
186402,15,DNK1,2015-10-16,Midtjylland,Randers FC,2,1,1,W
186403,15,DNK1,2015-10-17,Odense,SonderjyskE,1,2,-1,L
186404,15,DNK1,2015-10-18,Aarhus,Nordsjalland,3,0,3,W
186405,15,DNK1,2015-10-18,Viborg,Brondby,0,2,-2,L
186406,15,DNK1,2015-10-18,FC Kobenhavn,Hobro,3,1,2,W
186407,15,DNK1,2015-10-19,Esbjerg fB,Aalborg,1,2,-1,L
186408,15,DNK1,2015-10-23,Hobro,Aarhus,3,1,2,W
186409,15,DNK1,2015-10-24,Viborg,Esbjerg fB,4,2,2,W
186410,15,DNK1,2015-10-25,Nordsjalland,Aalborg,3,0,3,W
186411,15,DNK1,2015-10-25,SonderjyskE,FC Kobenhavn,1,2,-1,L
186412,15,DNK1,2015-10-25,Brondby,Midtjylland,2,1,1,W
186413,15,DNK1,2015-10-26,Randers FC,Odense,1,1,0,D
186414,15,DNK1,2015-10-30,Esbjerg fB,Nordsjalland,2,1,1,W
186415,15,DNK1,2015-10-31,Midtjylland,Viborg,2,4,-2,L
186416,15,DNK1,2015-11-01,Aalborg,Hobro,6,0,6,W
186417,15,DNK1,2015-11-01,FC Kobenhavn,Randers FC,4,0,4,W
186418,15,DNK1,2015-11-01,Odense,Brondby,2,5,-3,L
186419,15,DNK1,2015-11-02,Aarhus,SonderjyskE,0,0,0,D
186420,15,DNK1,2015-11-06,SonderjyskE,Aalborg,1,2,-1,L
186421,15,DNK1,2015-11-06,Randers FC,Aarhus,4,1,3,W
186422,15,DNK1,2015-11-07,Hobro,Nordsjalland,0,1,-1,L
186423,15,DNK1,2015-11-08,Viborg,Odense,0,1,-1,L
186424,15,DNK1,2015-11-08,Midtjylland,Esbjerg fB,5,1,4,W
186425,15,DNK1,2015-11-08,Brondby,FC Kobenhavn,0,0,0,D
186426,15,DNK1,2015-11-20,Odense,Midtjylland,1,1,0,D
186427,15,DNK1,2015-11-21,Nordsjalland,SonderjyskE,1,2,-1,L
186428,15,DNK1,2015-11-22,Esbjerg fB,Hobro,4,4,0,D
186429,15,DNK1,2015-11-22,FC Kobenhavn,Viborg,0,0,0,D
186430,15,DNK1,2015-11-22,Aarhus,Brondby,1,1,0,D
186431,15,DNK1,2015-11-23,Aalborg,Randers FC,3,2,1,W
186432,15,DNK1,2015-11-27,Viborg,Aarhus,1,0,1,W
186433,15,DNK1,2015-11-28,Randers FC,Nordsjalland,1,0,1,W
186434,15,DNK1,2015-11-29,SonderjyskE,Hobro,2,0,2,W
186435,15,DNK1,2015-11-29,Brondby,Aalborg,0,2,-2,L
186436,15,DNK1,2015-11-30,Odense,Esbjerg fB,2,1,1,W
186437,15,DNK1,2015-12-04,Aarhus,Midtjylland,2,1,1,W
186438,15,DNK1,2015-12-05,Hobro,Randers FC,0,0,0,D
186439,15,DNK1,2015-12-06,Esbjerg fB,SonderjyskE,0,1,-1,L
186440,15,DNK1,2015-12-06,Nordsjalland,Brondby,0,2,-2,L
186441,15,DNK1,2015-12-06,FC Kobenhavn,Odense,4,1,3,W
186442,15,DNK1,2015-12-07,Aalborg,Viborg,2,0,2,W
186443,15,DNK1,2016-02-26,Odense,Aarhus,2,2,0,D
186444,15,DNK1,2016-02-27,Randers FC,SonderjyskE,1,1,0,D
186445,15,DNK1,2016-02-28,Viborg,Nordsjalland,1,1,0,D
186446,15,DNK1,2016-02-28,FC Kobenhavn,Esbjerg fB,2,1,1,W
186447,15,DNK1,2016-02-28,Brondby,Hobro,1,0,1,W
186448,15,DNK1,2016-02-29,Midtjylland,Aalborg,1,1,0,D
186449,15,DNK1,2016-03-03,Midtjylland,FC Kobenhavn,0,1,-1,L
186450,15,DNK1,2016-03-04,Aalborg,Odense,0,1,-1,L
186451,15,DNK1,2016-03-05,Hobro,Viborg,0,6,-6,L
186452,15,DNK1,2016-03-06,Esbjerg fB,Randers FC,1,0,1,W
186453,15,DNK1,2016-03-06,SonderjyskE,Brondby,3,1,2,W
186454,15,DNK1,2016-03-06,Aarhus,FC Kobenhavn,0,0,0,D
186455,15,DNK1,2016-03-07,Nordsjalland,Midtjylland,2,1,1,W
186456,15,DNK1,2016-03-11,Esbjerg fB,Aarhus,2,1,1,W
186457,15,DNK1,2016-03-12,Viborg,SonderjyskE,0,0,0,D
186458,15,DNK1,2016-03-13,Odense,Nordsjalland,3,1,2,W
186459,15,DNK1,2016-03-13,Brondby,Randers FC,1,0,1,W
186460,15,DNK1,2016-03-13,FC Kobenhavn,Aalborg,6,2,4,W
186461,15,DNK1,2016-03-14,Midtjylland,Hobro,3,0,3,W
186462,15,DNK1,2016-03-18,Aalborg,Aarhus,2,2,0,D
186463,15,DNK1,2016-03-19,Hobro,Odense,0,2,-2,L
186464,15,DNK1,2016-03-20,SonderjyskE,Midtjylland,3,2,1,W
186465,15,DNK1,2016-03-20,Randers FC,Viborg,1,3,-2,L
186466,15,DNK1,2016-03-20,Nordsjalland,FC Kobenhavn,2,0,2,W
186467,15,DNK1,2016-03-20,Brondby,Esbjerg fB,0,0,0,D
186468,15,DNK1,2016-04-01,Aalborg,Nordsjalland,1,0,1,W
186469,15,DNK1,2016-04-02,Aarhus,Hobro,1,1,0,D
186470,15,DNK1,2016-04-03,Odense,Randers FC,0,1,-1,L
186471,15,DNK1,2016-04-03,FC Kobenhavn,SonderjyskE,1,0,1,W
186472,15,DNK1,2016-04-03,Midtjylland,Brondby,2,0,2,W
186473,15,DNK1,2016-04-04,Esbjerg fB,Viborg,1,0,1,W
186474,15,DNK1,2016-04-08,Viborg,Midtjylland,1,1,0,D
186475,15,DNK1,2016-04-09,SonderjyskE,Aarhus,2,2,0,D
186476,15,DNK1,2016-04-10,Hobro,Aalborg,0,2,-2,L
186477,15,DNK1,2016-04-10,Randers FC,FC Kobenhavn,1,1,0,D
186478,15,DNK1,2016-04-10,Brondby,Odense,1,0,1,W
186479,15,DNK1,2016-04-11,Nordsjalland,Esbjerg fB,0,0,0,D
186480,15,DNK1,2016-04-15,Nordsjalland,Hobro,2,1,1,W
186481,15,DNK1,2016-04-16,Aarhus,Randers FC,0,2,-2,L
186482,15,DNK1,2016-04-17,Odense,Viborg,5,1,4,W
186483,15,DNK1,2016-04-17,Aalborg,SonderjyskE,1,2,-1,L
186484,15,DNK1,2016-04-17,FC Kobenhavn,Brondby,2,0,2,W
186485,15,DNK1,2016-04-18,Esbjerg fB,Midtjylland,0,2,-2,L
186486,15,DNK1,2016-04-22,Midtjylland,Odense,2,0,2,W
186487,15,DNK1,2016-04-23,Hobro,Esbjerg fB,2,2,0,D
186488,15,DNK1,2016-04-24,SonderjyskE,Nordsjalland,3,1,2,W
186489,15,DNK1,2016-04-24,Viborg,FC Kobenhavn,1,1,0,D
186490,15,DNK1,2016-04-24,Brondby,Aarhus,2,1,1,W
186491,15,DNK1,2016-04-25,Randers FC,Aalborg,0,0,0,D
186492,15,DNK1,2016-04-29,Aarhus,Viborg,1,2,-1,L
186493,15,DNK1,2016-04-30,Hobro,SonderjyskE,1,2,-1,L
186494,15,DNK1,2016-05-01,Nordsjalland,Randers FC,2,2,0,D
186495,15,DNK1,2016-05-01,Aalborg,Brondby,3,0,3,W
186496,15,DNK1,2016-05-01,FC Kobenhavn,Midtjylland,5,3,2,W
186497,15,DNK1,2016-05-02,Esbjerg fB,Odense,0,2,-2,L
186498,15,DNK1,2016-05-06,SonderjyskE,Esbjerg fB,2,0,2,W
186499,15,DNK1,2016-05-07,Randers FC,Hobro,2,0,2,W
186500,15,DNK1,2016-05-08,Viborg,Aalborg,0,2,-2,L
186501,15,DNK1,2016-05-08,Odense,FC Kobenhavn,0,1,-1,L
186502,15,DNK1,2016-05-08,Midtjylland,Aarhus,1,1,0,D
186503,15,DNK1,2016-05-09,Brondby,Nordsjalland,2,1,1,W
186504,15,DNK1,2016-05-11,SonderjyskE,Viborg,2,0,2,W
186505,15,DNK1,2016-05-11,Hobro,Midtjylland,1,4,-3,L
186506,15,DNK1,2016-05-11,Aarhus,Esbjerg fB,5,1,4,W
186507,15,DNK1,2016-05-12,Randers FC,Brondby,0,2,-2,L
186508,15,DNK1,2016-05-12,Nordsjalland,Odense,0,1,-1,L
186509,15,DNK1,2016-05-12,Aalborg,FC Kobenhavn,0,2,-2,L
186510,15,DNK1,2016-05-14,Midtjylland,SonderjyskE,3,2,1,W
186511,15,DNK1,2016-05-15,Odense,Hobro,0,1,-1,L
186512,15,DNK1,2016-05-16,Viborg,Randers FC,2,3,-1,L
186513,15,DNK1,2016-05-16,FC Kobenhavn,Nordsjalland,2,0,2,W
186514,15,DNK1,2016-05-16,Esbjerg fB,Brondby,2,3,-1,L
186515,15,DNK1,2016-05-17,Aarhus,Aalborg,2,0,2,W
186516,15,DNK1,2016-05-20,SonderjyskE,Odense,3,1,2,W
186517,15,DNK1,2016-05-21,Nordsjalland,Aarhus,3,3,0,D
186518,15,DNK1,2016-05-22,Randers FC,Midtjylland,1,2,-1,L
186519,15,DNK1,2016-05-22,Hobro,FC Kobenhavn,4,2,2,W
186520,15,DNK1,2016-05-22,Aalborg,Esbjerg fB,1,2,-1,L
186521,15,DNK1,2016-05-23,Brondby,Viborg,0,1,-1,L
186522,15,DNK1,2016-05-26,Aarhus,Odense,2,1,1,W
186523,15,DNK1,2016-05-26,Nordsjalland,Viborg,1,0,1,W
186524,15,DNK1,2016-05-26,Aalborg,Midtjylland,0,0,0,D
186525,15,DNK1,2016-05-26,Hobro,Brondby,0,2,-2,L
186526,15,DNK1,2016-05-26,SonderjyskE,Randers FC,1,1,0,D
186527,15,DNK1,2016-05-26,Esbjerg fB,FC Kobenhavn,1,4,-3,L
186528,15,DNK1,2016-05-29,Randers FC,Esbjerg fB,3,1,2,W
186529,15,DNK1,2016-05-29,Brondby,SonderjyskE,1,2,-1,L
186530,15,DNK1,2016-05-29,Odense,Aalborg,3,2,1,W
186531,15,DNK1,2016-05-29,Viborg,Hobro,1,0,1,W
186532,15,DNK1,2016-05-29,Midtjylland,Nordsjalland,4,1,3,W
186533,15,DNK1,2016-05-29,FC Kobenhavn,Aarhus,2,1,1,W
186534,16,DNK1,2016-07-15,Viborg,Nordsjalland,0,4,-4,L
186535,16,DNK1,2016-07-15,Odense,Silkeborg,0,0,0,D
186536,16,DNK1,2016-07-16,FC Kobenhavn,Lyngby,3,0,3,W
186537,16,DNK1,2016-07-17,SonderjyskE,Aarhus,1,2,-1,L
186538,16,DNK1,2016-07-17,Aalborg,Horsens,1,1,0,D
186539,16,DNK1,2016-07-17,Brondby,Esbjerg fB,4,0,4,W
186540,16,DNK1,2016-07-18,Midtjylland,Randers FC,2,2,0,D
186541,16,DNK1,2016-07-22,Aarhus,Viborg,2,1,1,W
186542,16,DNK1,2016-07-23,Esbjerg fB,FC Kobenhavn,0,4,-4,L
186543,16,DNK1,2016-07-24,Horsens,SonderjyskE,1,1,0,D
186544,16,DNK1,2016-07-24,Lyngby,Odense,2,2,0,D
186545,16,DNK1,2016-07-24,Silkeborg,Brondby,0,2,-2,L
186546,16,DNK1,2016-07-24,Nordsjalland,Midtjylland,0,4,-4,L
186547,16,DNK1,2016-07-24,Randers FC,Aalborg,0,1,-1,L
186548,16,DNK1,2016-07-29,Viborg,Esbjerg fB,2,1,1,W
186549,16,DNK1,2016-07-30,FC Kobenhavn,Nordsjalland,4,0,4,W
186550,16,DNK1,2016-07-31,SonderjyskE,Lyngby,0,1,-1,L
186551,16,DNK1,2016-07-31,Midtjylland,Silkeborg,3,0,3,W
186552,16,DNK1,2016-07-31,Brondby,Horsens,2,2,0,D
186553,16,DNK1,2016-07-31,Aarhus,Randers FC,1,2,-1,L
186554,16,DNK1,2016-08-01,Aalborg,Odense,2,2,0,D
186555,16,DNK1,2016-08-05,Randers FC,Horsens,1,0,1,W
186556,16,DNK1,2016-08-05,Silkeborg,Lyngby,0,4,-4,L
186557,16,DNK1,2016-08-06,Odense,Viborg,0,0,0,D
186558,16,DNK1,2016-08-07,Nordsjalland,Aalborg,1,2,-1,L
186559,16,DNK1,2016-08-07,SonderjyskE,FC Kobenhavn,1,1,0,D
186560,16,DNK1,2016-08-07,Midtjylland,Brondby,3,3,0,D
186561,16,DNK1,2016-08-08,Esbjerg fB,Aarhus,2,2,0,D
186562,16,DNK1,2016-08-12,Viborg,Randers FC,0,1,-1,L
186563,16,DNK1,2016-08-12,Lyngby,Aarhus,0,0,0,D
186564,16,DNK1,2016-08-13,Horsens,Silkeborg,3,3,0,D
186565,16,DNK1,2016-08-13,FC Kobenhavn,Midtjylland,3,1,2,W
186566,16,DNK1,2016-08-14,Odense,Nordsjalland,3,1,2,W
186567,16,DNK1,2016-08-14,Brondby,SonderjyskE,4,0,4,W
186568,16,DNK1,2016-08-15,Aalborg,Esbjerg fB,2,1,1,W
186569,16,DNK1,2016-08-19,Nordsjalland,Randers FC,1,1,0,D
186570,16,DNK1,2016-08-19,Horsens,Lyngby,2,1,1,W
186571,16,DNK1,2016-08-20,FC Kobenhavn,Aalborg,1,1,0,D
186572,16,DNK1,2016-08-21,Silkeborg,Viborg,1,5,-4,L
186573,16,DNK1,2016-08-21,Aarhus,Brondby,0,7,-7,L
186574,16,DNK1,2016-08-21,Midtjylland,SonderjyskE,2,2,0,D
186575,16,DNK1,2016-08-22,Esbjerg fB,Odense,3,2,1,W
186576,16,DNK1,2016-08-26,Randers FC,Silkeborg,1,0,1,W
186577,16,DNK1,2016-08-26,Lyngby,Nordsjalland,0,1,-1,L
186578,16,DNK1,2016-08-28,SonderjyskE,Esbjerg fB,1,1,0,D
186579,16,DNK1,2016-08-28,Odense,Horsens,0,1,-1,L
186580,16,DNK1,2016-08-28,Brondby,FC Kobenhavn,1,1,0,D
186581,16,DNK1,2016-08-28,Aalborg,Aarhus,2,1,1,W
186582,16,DNK1,2016-08-28,Viborg,Midtjylland,0,0,0,D
186583,16,DNK1,2016-09-09,Randers FC,Lyngby,2,0,2,W
186584,16,DNK1,2016-09-09,Midtjylland,Esbjerg fB,3,0,3,W
186585,16,DNK1,2016-09-10,Viborg,Horsens,2,4,-2,L
186586,16,DNK1,2016-09-10,FC Kobenhavn,Odense,2,0,2,W
186587,16,DNK1,2016-09-11,SonderjyskE,Silkeborg,2,2,0,D
186588,16,DNK1,2016-09-11,Aalborg,Brondby,0,1,-1,L
186589,16,DNK1,2016-09-12,Aarhus,Nordsjalland,3,1,2,W
186590,16,DNK1,2016-09-16,Esbjerg fB,Randers FC,1,1,0,D
186591,16,DNK1,2016-09-17,Silkeborg,Aarhus,1,0,1,W
186592,16,DNK1,2016-09-18,Nordsjalland,SonderjyskE,2,3,-1,L
186593,16,DNK1,2016-09-18,Odense,Midtjylland,0,1,-1,L
186594,16,DNK1,2016-09-18,Brondby,Viborg,1,2,-1,L
186595,16,DNK1,2016-09-18,Horsens,FC Kobenhavn,0,2,-2,L
186596,16,DNK1,2016-09-19,Lyngby,Aalborg,1,0,1,W
186597,16,DNK1,2016-09-20,Esbjerg fB,Silkeborg,0,0,0,D
186598,16,DNK1,2016-09-21,Randers FC,FC Kobenhavn,2,2,0,D
186599,16,DNK1,2016-09-21,Horsens,Nordsjalland,0,0,0,D
186600,16,DNK1,2016-09-21,Aarhus,Midtjylland,1,1,0,D
186601,16,DNK1,2016-09-22,SonderjyskE,Odense,1,0,1,W
186602,16,DNK1,2016-09-22,Lyngby,Brondby,1,0,1,W
186603,16,DNK1,2016-09-22,Aalborg,Viborg,1,0,1,W
186604,16,DNK1,2016-09-24,FC Kobenhavn,Aarhus,2,0,2,W
186605,16,DNK1,2016-09-25,Viborg,Lyngby,0,1,-1,L
186606,16,DNK1,2016-09-25,Randers FC,SonderjyskE,0,4,-4,L
186607,16,DNK1,2016-09-25,Brondby,Odense,3,0,3,W
186608,16,DNK1,2016-09-25,Midtjylland,Horsens,5,2,3,W
186609,16,DNK1,2016-09-25,Nordsjalland,Esbjerg fB,3,0,3,W
186610,16,DNK1,2016-09-26,Silkeborg,Aalborg,5,3,2,W
186611,16,DNK1,2016-09-30,Odense,Aarhus,2,1,1,W
186612,16,DNK1,2016-09-30,Silkeborg,Nordsjalland,2,2,0,D
186613,16,DNK1,2016-10-01,Horsens,Esbjerg fB,1,0,1,W
186614,16,DNK1,2016-10-02,Aalborg,SonderjyskE,0,1,-1,L
186615,16,DNK1,2016-10-02,Lyngby,Midtjylland,1,0,1,W
186616,16,DNK1,2016-10-02,Viborg,FC Kobenhavn,0,0,0,D
186617,16,DNK1,2016-10-02,Brondby,Randers FC,2,2,0,D
186618,16,DNK1,2016-10-14,SonderjyskE,Viborg,1,0,1,W
186619,16,DNK1,2016-10-14,Aarhus,Horsens,1,1,0,D
186620,16,DNK1,2016-10-15,FC Kobenhavn,Silkeborg,2,0,2,W
186621,16,DNK1,2016-10-16,Randers FC,Odense,3,0,3,W
186622,16,DNK1,2016-10-16,Nordsjalland,Brondby,1,1,0,D
186623,16,DNK1,2016-10-16,Midtjylland,Aalborg,2,0,2,W
186624,16,DNK1,2016-10-17,Esbjerg fB,Lyngby,2,2,0,D
186625,16,DNK1,2016-10-21,Aalborg,Nordsjalland,1,1,0,D
186626,16,DNK1,2016-10-21,Viborg,Silkeborg,1,3,-2,L
186627,16,DNK1,2016-10-22,Lyngby,SonderjyskE,2,0,2,W
186628,16,DNK1,2016-10-23,Horsens,Randers FC,1,0,1,W
186629,16,DNK1,2016-10-23,Odense,FC Kobenhavn,0,3,-3,L
186630,16,DNK1,2016-10-23,Brondby,Aarhus,1,0,1,W
186631,16,DNK1,2016-10-24,Esbjerg fB,Midtjylland,1,3,-2,L
186632,16,DNK1,2016-10-28,Silkeborg,Odense,1,1,0,D
186633,16,DNK1,2016-10-28,Nordsjalland,Viborg,4,3,1,W
186634,16,DNK1,2016-10-29,Lyngby,Randers FC,0,2,-2,L
186635,16,DNK1,2016-10-30,SonderjyskE,Horsens,2,0,2,W
186636,16,DNK1,2016-10-30,Brondby,Aalborg,2,0,2,W
186637,16,DNK1,2016-10-30,Midtjylland,FC Kobenhavn,1,3,-2,L
186638,16,DNK1,2016-10-31,Aarhus,Esbjerg fB,6,2,4,W
186639,16,DNK1,2016-11-04,Esbjerg fB,Aalborg,3,0,3,W
186640,16,DNK1,2016-11-04,Aarhus,Silkeborg,0,0,0,D
186641,16,DNK1,2016-11-05,Randers FC,Nordsjalland,2,1,1,W
186642,16,DNK1,2016-11-06,Odense,Lyngby,1,2,-1,L
186643,16,DNK1,2016-11-06,Horsens,Midtjylland,1,5,-4,L
186644,16,DNK1,2016-11-06,Viborg,Brondby,1,2,-1,L
186645,16,DNK1,2016-11-06,FC Kobenhavn,SonderjyskE,4,0,4,W
186646,16,DNK1,2016-11-18,Lyngby,Horsens,0,1,-1,L
186647,16,DNK1,2016-11-18,Aalborg,FC Kobenhavn,1,2,-1,L
186648,16,DNK1,2016-11-19,Nordsjalland,Aarhus,3,2,1,W
186649,16,DNK1,2016-11-20,Randers FC,Viborg,2,1,1,W
186650,16,DNK1,2016-11-20,Odense,Brondby,1,0,1,W
186651,16,DNK1,2016-11-20,SonderjyskE,Midtjylland,1,0,1,W
186652,16,DNK1,2016-11-21,Silkeborg,Esbjerg fB,3,0,3,W
186653,16,DNK1,2016-11-25,Aalborg,Randers FC,2,1,1,W
186654,16,DNK1,2016-11-25,Horsens,Aarhus,1,5,-4,L
186655,16,DNK1,2016-11-26,Viborg,SonderjyskE,2,2,0,D
186656,16,DNK1,2016-11-26,Lyngby,FC Kobenhavn,0,1,-1,L
186657,16,DNK1,2016-11-27,Esbjerg fB,Nordsjalland,2,2,0,D
186658,16,DNK1,2016-11-27,Brondby,Silkeborg,3,1,2,W
186659,16,DNK1,2016-11-28,Midtjylland,Odense,1,0,1,W
186660,16,DNK1,2016-11-29,Aarhus,Lyngby,0,1,-1,L
186661,16,DNK1,2016-11-29,SonderjyskE,Aalborg,1,1,0,D
186662,16,DNK1,2016-11-29,FC Kobenhavn,Viborg,4,0,4,W
186663,16,DNK1,2016-11-30,Nordsjalland,Horsens,2,1,1,W
186664,16,DNK1,2016-11-30,Randers FC,Brondby,0,1,-1,L
186665,16,DNK1,2016-12-01,Silkeborg,Midtjylland,2,1,1,W
186666,16,DNK1,2016-12-01,Odense,Esbjerg fB,0,1,-1,L
186667,16,DNK1,2016-12-03,Horsens,Viborg,1,2,-1,L
186668,16,DNK1,2016-12-03,FC Kobenhavn,Randers FC,1,0,1,W
186669,16,DNK1,2016-12-04,Nordsjalland,Odense,0,1,-1,L
186670,16,DNK1,2016-12-04,Esbjerg fB,Brondby,1,1,0,D
186671,16,DNK1,2016-12-04,Midtjylland,Aarhus,0,1,-1,L
186672,16,DNK1,2016-12-05,Silkeborg,SonderjyskE,1,1,0,D
186673,16,DNK1,2016-12-05,Aalborg,Lyngby,1,0,1,W
186674,16,DNK1,2016-12-09,Horsens,Aalborg,3,0,3,W
186675,16,DNK1,2016-12-09,SonderjyskE,Nordsjalland,0,0,0,D
186676,16,DNK1,2016-12-10,Lyngby,Silkeborg,1,1,0,D
186677,16,DNK1,2016-12-11,Randers FC,Esbjerg fB,0,2,-2,L
186678,16,DNK1,2016-12-11,Aarhus,FC Kobenhavn,0,1,-1,L
186679,16,DNK1,2016-12-11,Brondby,Midtjylland,2,1,1,W
186680,16,DNK1,2016-12-12,Viborg,Odense,1,1,0,D
186681,16,DNK1,2017-02-17,Nordsjalland,Lyngby,0,1,-1,L
186682,16,DNK1,2017-02-17,Esbjerg fB,SonderjyskE,3,0,3,W
186683,16,DNK1,2017-02-18,Silkeborg,Horsens,1,0,1,W
186684,16,DNK1,2017-02-19,FC Kobenhavn,Brondby,0,0,0,D
186685,16,DNK1,2017-02-19,Aarhus,Aalborg,1,2,-1,L
186686,16,DNK1,2017-02-19,Midtjylland,Viborg,0,0,0,D
186687,16,DNK1,2017-02-20,Odense,Randers FC,3,0,3,W
186688,16,DNK1,2017-02-24,Randers FC,Midtjylland,0,2,-2,L
186689,16,DNK1,2017-02-25,Horsens,Odense,1,1,0,D
186690,16,DNK1,2017-02-26,Aalborg,Silkeborg,3,0,3,W
186691,16,DNK1,2017-02-26,Nordsjalland,FC Kobenhavn,1,1,0,D
186692,16,DNK1,2017-02-26,SonderjyskE,Brondby,1,2,-1,L
186693,16,DNK1,2017-02-27,Lyngby,Esbjerg fB,0,0,0,D
186694,16,DNK1,2017-02-27,Viborg,Aarhus,1,1,0,D
186695,16,DNK1,2017-03-03,Esbjerg fB,Viborg,1,3,-2,L
186696,16,DNK1,2017-03-03,Midtjylland,Lyngby,1,1,0,D
186697,16,DNK1,2017-03-04,Aarhus,SonderjyskE,1,2,-1,L
186698,16,DNK1,2017-03-05,Silkeborg,Randers FC,2,0,2,W
186699,16,DNK1,2017-03-05,FC Kobenhavn,Horsens,5,0,5,W
186700,16,DNK1,2017-03-05,Brondby,Nordsjalland,2,3,-1,L
186701,16,DNK1,2017-03-06,Odense,Aalborg,4,0,4,W
186702,16,DNK1,2017-03-10,Randers FC,Aarhus,1,1,0,D
186703,16,DNK1,2017-03-10,Nordsjalland,Silkeborg,5,1,4,W
186704,16,DNK1,2017-03-11,Lyngby,Viborg,1,0,1,W
186705,16,DNK1,2017-03-12,Odense,SonderjyskE,0,1,-1,L
186706,16,DNK1,2017-03-12,Horsens,Brondby,0,2,-2,L
186707,16,DNK1,2017-03-12,FC Kobenhavn,Esbjerg fB,2,0,2,W
186708,16,DNK1,2017-03-13,Aalborg,Midtjylland,1,1,0,D
186709,16,DNK1,2017-03-19,Viborg,Aalborg,2,1,1,W
186710,16,DNK1,2017-03-19,Midtjylland,Nordsjalland,1,2,-1,L
186711,16,DNK1,2017-03-19,Esbjerg fB,Horsens,1,1,0,D
186712,16,DNK1,2017-03-19,Brondby,Lyngby,3,2,1,W
186713,16,DNK1,2017-03-19,Aarhus,Odense,1,2,-1,L
186714,16,DNK1,2017-03-19,Silkeborg,FC Kobenhavn,1,3,-2,L
186715,16,DNK1,2017-03-19,SonderjyskE,Randers FC,1,0,1,W
186716,17,DNK1,2017-07-14,Aarhus,Horsens,1,2,-1,L
186717,17,DNK1,2017-07-15,FC Kobenhavn,Aalborg,1,1,0,D
186718,17,DNK1,2017-07-15,SonderjyskE,Randers FC,0,0,0,D
186719,17,DNK1,2017-07-16,Lyngby,Silkeborg,2,1,1,W
186720,17,DNK1,2017-07-16,Hobro,Helisngor,2,1,1,W
186721,17,DNK1,2017-07-16,Brondby,Midtjylland,4,0,4,W
186722,17,DNK1,2017-07-17,Odense,Nordsjalland,1,2,-1,L
186723,17,DNK1,2017-07-21,Aarhus,Hobro,2,0,2,W
186724,17,DNK1,2017-07-22,Randers FC,FC Kobenhavn,0,3,-3,L
186725,17,DNK1,2017-07-23,Horsens,Lyngby,4,1,3,W
186726,17,DNK1,2017-07-23,Aalborg,SonderjyskE,1,4,-3,L
186727,17,DNK1,2017-07-23,Nordsjalland,Brondby,3,2,1,W
186728,17,DNK1,2017-07-23,Midtjylland,Silkeborg,2,0,2,W
186729,17,DNK1,2017-07-24,Helisngor,Odense,0,2,-2,L
186730,17,DNK1,2017-07-28,SonderjyskE,Helisngor,1,2,-1,L
186731,17,DNK1,2017-07-29,Odense,Horsens,1,0,1,W
186732,17,DNK1,2017-07-29,FC Kobenhavn,Hobro,0,0,0,D
186733,17,DNK1,2017-07-30,Midtjylland,Randers FC,2,1,1,W
186734,17,DNK1,2017-07-30,Nordsjalland,Aalborg,3,2,1,W
186735,17,DNK1,2017-07-30,Brondby,Lyngby,5,3,2,W
186736,17,DNK1,2017-07-31,Silkeborg,Aarhus,2,1,1,W
186737,17,DNK1,2017-08-04,Horsens,Silkeborg,1,0,1,W
186738,17,DNK1,2017-08-05,Hobro,Randers FC,2,0,2,W
186739,17,DNK1,2017-08-06,Lyngby,Nordsjalland,1,4,-3,L
186740,17,DNK1,2017-08-06,Helisngor,Midtjylland,2,1,1,W
186741,17,DNK1,2017-08-06,Odense,Aalborg,0,0,0,D
186742,17,DNK1,2017-08-06,Brondby,FC Kobenhavn,1,0,1,W
186743,17,DNK1,2017-08-07,SonderjyskE,Aarhus,3,0,3,W
186744,17,DNK1,2017-08-11,Silkeborg,Helisngor,4,1,3,W
186745,17,DNK1,2017-08-12,Lyngby,SonderjyskE,1,1,0,D
186746,17,DNK1,2017-08-12,FC Kobenhavn,Horsens,1,1,0,D
186747,17,DNK1,2017-08-13,Midtjylland,Nordsjalland,4,3,1,W
186748,17,DNK1,2017-08-13,Randers FC,Brondby,0,0,0,D
186749,17,DNK1,2017-08-13,Aarhus,Odense,0,0,0,D
186750,17,DNK1,2017-08-14,Aalborg,Hobro,1,1,0,D
186751,17,DNK1,2017-08-18,Horsens,Aalborg,0,0,0,D
186752,17,DNK1,2017-08-18,Randers FC,Silkeborg,1,1,0,D
186753,17,DNK1,2017-08-19,FC Kobenhavn,SonderjyskE,3,2,1,W
186754,17,DNK1,2017-08-20,Odense,Midtjylland,0,2,-2,L
186755,17,DNK1,2017-08-20,Hobro,Lyngby,3,0,3,W
186756,17,DNK1,2017-08-20,Aarhus,Brondby,2,0,2,W
186757,17,DNK1,2017-08-21,Nordsjalland,Helisngor,1,0,1,W
186758,17,DNK1,2017-08-25,SonderjyskE,Odense,2,2,0,D
186759,17,DNK1,2017-08-25,Silkeborg,Hobro,0,2,-2,L
186760,17,DNK1,2017-08-26,Helisngor,Randers FC,2,0,2,W
186761,17,DNK1,2017-08-26,Aalborg,Aarhus,0,0,0,D
186762,17,DNK1,2017-08-27,Midtjylland,Lyngby,1,1,0,D
186763,17,DNK1,2017-08-27,Brondby,Horsens,2,0,2,W
186764,17,DNK1,2017-08-27,Nordsjalland,FC Kobenhavn,3,0,3,W
186765,17,DNK1,2017-09-08,Horsens,Nordsjalland,2,2,0,D
186766,17,DNK1,2017-09-08,Hobro,SonderjyskE,3,2,1,W
186767,17,DNK1,2017-09-09,Aarhus,Randers FC,1,4,-3,L
186768,17,DNK1,2017-09-10,Lyngby,Helisngor,3,1,2,W
186769,17,DNK1,2017-09-10,FC Kobenhavn,Midtjylland,4,3,1,W
186770,17,DNK1,2017-09-10,Odense,Brondby,1,1,0,D
186771,17,DNK1,2017-09-11,Aalborg,Silkeborg,2,1,1,W
186772,17,DNK1,2017-09-15,Silkeborg,Odense,1,0,1,W
186773,17,DNK1,2017-09-15,Randers FC,Lyngby,0,0,0,D
186774,17,DNK1,2017-09-16,SonderjyskE,Horsens,2,2,0,D
186775,17,DNK1,2017-09-17,Midtjylland,Hobro,5,1,4,W
186776,17,DNK1,2017-09-17,Helisngor,FC Kobenhavn,0,4,-4,L
186777,17,DNK1,2017-09-17,Brondby,Aalborg,0,0,0,D
186778,17,DNK1,2017-09-18,Nordsjalland,Aarhus,1,2,-1,L
186779,17,DNK1,2017-09-22,Nordsjalland,SonderjyskE,2,2,0,D
186780,17,DNK1,2017-09-23,Horsens,Helisngor,2,0,2,W
186781,17,DNK1,2017-09-23,FC Kobenhavn,Silkeborg,4,0,4,W
186782,17,DNK1,2017-09-24,Aalborg,Lyngby,3,1,2,W
186783,17,DNK1,2017-09-24,Odense,Randers FC,3,1,2,W
186784,17,DNK1,2017-09-24,Hobro,Brondby,1,2,-1,L
186785,17,DNK1,2017-09-25,Aarhus,Midtjylland,0,3,-3,L
186786,17,DNK1,2017-09-29,Helisngor,Aarhus,1,5,-4,L
186787,17,DNK1,2017-09-29,Randers FC,Horsens,0,1,-1,L
186788,17,DNK1,2017-09-30,Hobro,Odense,1,1,0,D
186789,17,DNK1,2017-10-01,Silkeborg,Nordsjalland,2,4,-2,L
186790,17,DNK1,2017-10-01,Midtjylland,Aalborg,4,1,3,W
186791,17,DNK1,2017-10-01,Brondby,SonderjyskE,4,0,4,W
186792,17,DNK1,2017-10-01,Lyngby,FC Kobenhavn,3,1,2,W
186793,17,DNK1,2017-10-13,SonderjyskE,Midtjylland,0,1,-1,L
186794,17,DNK1,2017-10-14,Nordsjalland,Randers FC,3,2,1,W
186795,17,DNK1,2017-10-15,Horsens,Hobro,2,2,0,D
186796,17,DNK1,2017-10-15,Aalborg,Helisngor,1,0,1,W
186797,17,DNK1,2017-10-15,Brondby,Silkeborg,4,1,3,W
186798,17,DNK1,2017-10-15,Odense,FC Kobenhavn,1,0,1,W
186799,17,DNK1,2017-10-16,Aarhus,Lyngby,0,2,-2,L
186800,17,DNK1,2017-10-20,Midtjylland,Horsens,4,2,2,W
186801,17,DNK1,2017-10-21,Silkeborg,SonderjyskE,1,0,1,W
186802,17,DNK1,2017-10-22,Hobro,Nordsjalland,4,0,4,W
186803,17,DNK1,2017-10-22,Lyngby,Odense,1,1,0,D
186804,17,DNK1,2017-10-22,Helisngor,Brondby,0,1,-1,L
186805,17,DNK1,2017-10-22,FC Kobenhavn,Aarhus,4,0,4,W
186806,17,DNK1,2017-10-23,Randers FC,Aalborg,1,1,0,D
186807,17,DNK1,2017-10-27,Aarhus,Nordsjalland,1,4,-3,L
186808,17,DNK1,2017-10-28,Helisngor,Silkeborg,2,0,2,W
186809,17,DNK1,2017-10-29,SonderjyskE,Hobro,1,1,0,D
186810,17,DNK1,2017-10-29,Lyngby,Midtjylland,2,2,0,D
186811,17,DNK1,2017-10-29,Horsens,FC Kobenhavn,1,1,0,D
186812,17,DNK1,2017-10-29,Aalborg,Odense,0,2,-2,L
186813,17,DNK1,2017-10-30,Brondby,Randers FC,3,1,2,W
186814,17,DNK1,2017-11-03,Midtjylland,Helisngor,2,1,1,W
186815,17,DNK1,2017-11-03,Silkeborg,Horsens,2,2,0,D
186816,17,DNK1,2017-11-04,Nordsjalland,Lyngby,2,2,0,D
186817,17,DNK1,2017-11-05,FC Kobenhavn,Brondby,0,1,-1,L
186818,17,DNK1,2017-11-05,Odense,SonderjyskE,0,3,-3,L
186819,17,DNK1,2017-11-05,Randers FC,Aarhus,1,0,1,W
186820,17,DNK1,2017-11-05,Hobro,Aalborg,0,1,-1,L
186821,17,DNK1,2017-11-17,Helisngor,Hobro,0,1,-1,L
186822,17,DNK1,2017-11-18,Aarhus,Silkeborg,3,1,2,W
186823,17,DNK1,2017-11-19,Lyngby,Randers FC,1,3,-2,L
186824,17,DNK1,2017-11-19,Horsens,Odense,0,0,0,D
186825,17,DNK1,2017-11-19,SonderjyskE,FC Kobenhavn,3,0,3,W
186826,17,DNK1,2017-11-19,Brondby,Nordsjalland,4,2,2,W
186827,17,DNK1,2017-11-20,Aalborg,Midtjylland,0,1,-1,L
186828,17,DNK1,2017-11-24,Randers FC,SonderjyskE,0,2,-2,L
186829,17,DNK1,2017-11-25,Helisngor,Aalborg,0,1,-1,L
186830,17,DNK1,2017-11-26,Nordsjalland,Horsens,6,0,6,W
186831,17,DNK1,2017-11-26,Odense,Hobro,3,0,3,W
186832,17,DNK1,2017-11-26,FC Kobenhavn,Lyngby,5,1,4,W
186833,17,DNK1,2017-11-26,Silkeborg,Brondby,1,3,-2,L
186834,17,DNK1,2017-11-27,Midtjylland,Aarhus,4,0,4,W
186835,17,DNK1,2017-12-01,Aarhus,Helisngor,0,0,0,D
186836,17,DNK1,2017-12-02,Lyngby,Aalborg,1,2,-1,L
186837,17,DNK1,2017-12-03,Hobro,Horsens,1,1,0,D
186838,17,DNK1,2017-12-03,Silkeborg,Randers FC,3,2,1,W
186839,17,DNK1,2017-12-03,SonderjyskE,Brondby,1,3,-2,L
186840,17,DNK1,2017-12-03,FC Kobenhavn,Nordsjalland,1,3,-2,L
186841,17,DNK1,2017-12-04,Midtjylland,Odense,3,1,2,W
186842,17,DNK1,2017-12-08,Horsens,SonderjyskE,2,1,1,W
186843,17,DNK1,2017-12-09,Helisngor,Lyngby,2,1,1,W
186844,17,DNK1,2017-12-10,Odense,Silkeborg,1,2,-1,L
186845,17,DNK1,2017-12-10,Nordsjalland,Hobro,3,2,1,W
186846,17,DNK1,2017-12-10,Aalborg,FC Kobenhavn,1,1,0,D
186847,17,DNK1,2017-12-10,Brondby,Aarhus,2,2,0,D
186848,17,DNK1,2017-12-11,Randers FC,Midtjylland,0,4,-4,L
186849,17,DNK1,2018-02-09,Horsens,Midtjylland,0,2,-2,L
186850,17,DNK1,2018-02-10,Silkeborg,Aalborg,3,2,1,W
186851,17,DNK1,2018-02-10,FC Kobenhavn,Randers FC,5,1,4,W
186852,17,DNK1,2018-02-11,Odense,Helisngor,6,1,5,W
186853,17,DNK1,2018-02-11,SonderjyskE,Nordsjalland,2,1,1,W
186854,17,DNK1,2018-02-11,Lyngby,Brondby,1,3,-2,L
186855,17,DNK1,2018-02-12,Hobro,Aarhus,0,1,-1,L
186856,17,DNK1,2018-02-16,Nordsjalland,Odense,2,1,1,W
186857,17,DNK1,2018-02-17,Silkeborg,Lyngby,1,1,0,D
186858,17,DNK1,2018-02-18,Helisngor,Horsens,0,2,-2,L
186859,17,DNK1,2018-02-18,Randers FC,Hobro,0,0,0,D
186860,17,DNK1,2018-02-18,Midtjylland,FC Kobenhavn,3,1,2,W
186861,17,DNK1,2018-02-18,Aalborg,Brondby,1,1,0,D
186862,17,DNK1,2018-02-19,Aarhus,SonderjyskE,0,0,0,D
186863,17,DNK1,2018-02-23,Horsens,Randers FC,1,1,0,D
186864,17,DNK1,2018-02-24,Lyngby,Aarhus,0,0,0,D
186865,17,DNK1,2018-02-25,Hobro,Midtjylland,1,2,-1,L
186866,17,DNK1,2018-02-25,Aalborg,Nordsjalland,1,1,0,D
186867,17,DNK1,2018-02-25,Brondby,Helisngor,6,1,5,W
186868,17,DNK1,2018-02-25,FC Kobenhavn,Odense,1,0,1,W
186869,17,DNK1,2018-02-26,SonderjyskE,Silkeborg,0,1,-1,L
186870,17,DNK1,2018-02-27,Horsens,Aarhus,1,1,0,D
186871,17,DNK1,2018-02-28,Randers FC,Helisngor,0,0,0,D
186872,17,DNK1,2018-02-28,Odense,Lyngby,3,1,2,W
186873,17,DNK1,2018-02-28,Hobro,FC Kobenhavn,0,2,-2,L
186874,17,DNK1,2018-03-01,Nordsjalland,Silkeborg,3,1,2,W
186875,17,DNK1,2018-03-01,SonderjyskE,Aalborg,0,1,-1,L
186876,17,DNK1,2018-03-01,Midtjylland,Brondby,0,1,-1,L
186877,17,DNK1,2018-03-03,Lyngby,Hobro,0,3,-3,L
186878,17,DNK1,2018-03-04,Helisngor,SonderjyskE,1,2,-1,L
186879,17,DNK1,2018-03-04,Randers FC,Nordsjalland,0,3,-3,L
186880,17,DNK1,2018-03-04,Aarhus,FC Kobenhavn,0,1,-1,L
186881,17,DNK1,2018-03-04,Brondby,Odense,2,1,1,W
186882,17,DNK1,2018-03-05,Aalborg,Horsens,1,1,0,D
186883,17,DNK1,2018-03-05,Silkeborg,Midtjylland,1,2,-1,L
186884,17,DNK1,2018-03-09,Odense,Aarhus,0,1,-1,L
186885,17,DNK1,2018-03-10,Hobro,Silkeborg,1,1,0,D
186886,17,DNK1,2018-03-11,SonderjyskE,Lyngby,1,0,1,W
186887,17,DNK1,2018-03-11,Aalborg,Randers FC,4,0,4,W
186888,17,DNK1,2018-03-11,Nordsjalland,Midtjylland,1,1,0,D
186889,17,DNK1,2018-03-11,Horsens,Brondby,1,1,0,D
186890,17,DNK1,2018-03-12,FC Kobenhavn,Helisngor,4,3,1,W
186891,17,DNK1,2018-03-18,Brondby,Hobro,2,1,1,W
186892,17,DNK1,2018-03-18,Helisngor,Nordsjalland,1,0,1,W
186893,17,DNK1,2018-03-18,Midtjylland,SonderjyskE,2,1,1,W
186894,17,DNK1,2018-03-18,Aarhus,Aalborg,0,0,0,D
186895,17,DNK1,2018-03-18,Lyngby,Horsens,1,1,0,D
186896,17,DNK1,2018-03-18,Silkeborg,FC Kobenhavn,1,3,-2,L
186897,17,DNK1,2018-03-18,Randers FC,Odense,4,1,3,W
186898,18,DNK1,2018-07-13,Vejle,Hobro,3,1,2,W
186899,18,DNK1,2018-07-13,SonderjyskE,Aalborg,0,1,-1,L
186900,18,DNK1,2018-07-14,Midtjylland,Aarhus,0,0,0,D
186901,18,DNK1,2018-07-15,Nordsjalland,Esbjerg fB,1,1,0,D
186902,18,DNK1,2018-07-15,Vendsyssel,Odense,3,2,1,W
186903,18,DNK1,2018-07-16,FC Kobenhavn,Horsens,1,2,-1,L
186904,18,DNK1,2018-07-16,Randers FC,Brondby,0,2,-2,L
186905,18,DNK1,2018-07-20,Aalborg,Midtjylland,2,1,1,W
186906,18,DNK1,2018-07-21,Esbjerg fB,Vendsyssel,2,3,-1,L
186907,18,DNK1,2018-07-22,Horsens,Randers FC,1,1,0,D
186908,18,DNK1,2018-07-22,Odense,SonderjyskE,2,2,0,D
186909,18,DNK1,2018-07-22,Aarhus,Nordsjalland,1,1,0,D
186910,18,DNK1,2018-07-22,Brondby,Vejle,1,1,0,D
186911,18,DNK1,2018-07-23,Hobro,FC Kobenhavn,0,3,-3,L
186912,18,DNK1,2018-07-27,SonderjyskE,Horsens,2,0,2,W
186913,18,DNK1,2018-07-28,Midtjylland,Esbjerg fB,3,1,2,W
186914,18,DNK1,2018-07-29,Nordsjalland,Vendsyssel,3,0,3,W
186915,18,DNK1,2018-07-29,Randers FC,Odense,1,0,1,W
186916,18,DNK1,2018-07-29,Hobro,Brondby,1,2,-1,L
186917,18,DNK1,2018-07-29,FC Kobenhavn,Aalborg,4,0,4,W
186918,18,DNK1,2018-07-30,Vejle,Aarhus,1,1,0,D
186919,18,DNK1,2018-08-03,Aarhus,SonderjyskE,1,0,1,W
186920,18,DNK1,2018-08-04,Esbjerg fB,Randers FC,3,3,0,D
186921,18,DNK1,2018-08-04,Vejle,Midtjylland,1,3,-2,L
186922,18,DNK1,2018-08-05,Horsens,Hobro,2,2,0,D
186923,18,DNK1,2018-08-05,Odense,FC Kobenhavn,0,1,-1,L
186924,18,DNK1,2018-08-05,Brondby,Nordsjalland,2,0,2,W
186925,18,DNK1,2018-08-06,Vendsyssel,Aalborg,0,1,-1,L
186926,18,DNK1,2018-08-10,Vendsyssel,Vejle,1,1,0,D
186927,18,DNK1,2018-08-11,Hobro,Odense,3,2,1,W
186928,18,DNK1,2018-08-12,Aalborg,Nordsjalland,1,0,1,W
186929,18,DNK1,2018-08-12,FC Kobenhavn,Brondby,3,1,2,W
186930,18,DNK1,2018-08-12,Randers FC,Aarhus,0,0,0,D
186931,18,DNK1,2018-08-12,Midtjylland,Horsens,3,0,3,W
186932,18,DNK1,2018-08-13,Esbjerg fB,SonderjyskE,1,0,1,W
186933,18,DNK1,2018-08-17,SonderjyskE,Vendsyssel,2,1,1,W
186934,18,DNK1,2018-08-19,Nordsjalland,Vejle,2,0,2,W
186935,18,DNK1,2018-08-19,Randers FC,Hobro,3,0,3,W
186936,18,DNK1,2018-08-19,Aarhus,FC Kobenhavn,1,1,0,D
186937,18,DNK1,2018-08-19,Brondby,Esbjerg fB,0,1,-1,L
186938,18,DNK1,2018-08-19,Odense,Midtjylland,1,1,0,D
186939,18,DNK1,2018-08-20,Horsens,Aalborg,0,0,0,D
186940,18,DNK1,2018-08-24,Hobro,Aarhus,0,2,-2,L
186941,18,DNK1,2018-08-26,Nordsjalland,Horsens,0,1,-1,L
186942,18,DNK1,2018-08-26,Vejle,Odense,0,2,-2,L
186943,18,DNK1,2018-08-26,Vendsyssel,Brondby,1,2,-1,L
186944,18,DNK1,2018-08-26,FC Kobenhavn,SonderjyskE,3,2,1,W
186945,18,DNK1,2018-08-26,Midtjylland,Randers FC,3,0,3,W
186946,18,DNK1,2018-08-27,Aalborg,Esbjerg fB,0,1,-1,L
186947,18,DNK1,2018-08-31,Horsens,Vejle,0,0,0,D
186948,18,DNK1,2018-09-01,SonderjyskE,Hobro,1,1,0,D
186949,18,DNK1,2018-09-02,Odense,Nordsjalland,0,0,0,D
186950,18,DNK1,2018-09-02,Randers FC,Aalborg,2,2,0,D
186951,18,DNK1,2018-09-02,Esbjerg fB,FC Kobenhavn,0,2,-2,L
186952,18,DNK1,2018-09-02,Aarhus,Vendsyssel,1,1,0,D
186953,18,DNK1,2018-09-02,Brondby,Midtjylland,2,2,0,D
186954,18,DNK1,2018-09-14,Esbjerg fB,Odense,2,0,2,W
186955,18,DNK1,2018-09-15,Nordsjalland,Randers FC,4,1,3,W
186956,18,DNK1,2018-09-16,Vendsyssel,Hobro,1,1,0,D
186957,18,DNK1,2018-09-16,Horsens,Aarhus,3,2,1,W
186958,18,DNK1,2018-09-16,Brondby,SonderjyskE,2,4,-2,L
186959,18,DNK1,2018-09-16,Midtjylland,FC Kobenhavn,3,1,2,W
186960,18,DNK1,2018-09-17,Aalborg,Vejle,1,1,0,D
186961,18,DNK1,2018-09-21,Vejle,Esbjerg fB,1,0,1,W
186962,18,DNK1,2018-09-22,Randers FC,Vendsyssel,2,0,2,W
186963,18,DNK1,2018-09-23,SonderjyskE,Midtjylland,0,0,0,D
186964,18,DNK1,2018-09-23,Hobro,Aalborg,0,5,-5,L
186965,18,DNK1,2018-09-23,FC Kobenhavn,Nordsjalland,2,1,1,W
186966,18,DNK1,2018-09-23,Aarhus,Brondby,3,2,1,W
186967,18,DNK1,2018-09-24,Odense,Horsens,4,0,4,W
186968,18,DNK1,2018-09-28,Vejle,Randers FC,1,1,0,D
186969,18,DNK1,2018-09-29,Midtjylland,Hobro,5,2,3,W
186970,18,DNK1,2018-09-30,Vendsyssel,FC Kobenhavn,2,1,1,W
186971,18,DNK1,2018-09-30,Esbjerg fB,Aarhus,0,0,0,D
186972,18,DNK1,2018-09-30,Aalborg,Odense,0,1,-1,L
186973,18,DNK1,2018-09-30,Brondby,Horsens,1,2,-1,L
186974,18,DNK1,2018-10-01,Nordsjalland,SonderjyskE,4,1,3,W
186975,18,DNK1,2018-10-05,SonderjyskE,Vejle,3,0,3,W
186976,18,DNK1,2018-10-06,Odense,Aarhus,2,2,0,D
186977,18,DNK1,2018-10-07,Hobro,Nordsjalland,3,2,1,W
186978,18,DNK1,2018-10-07,Horsens,Esbjerg fB,1,2,-1,L
186979,18,DNK1,2018-10-07,FC Kobenhavn,Randers FC,4,0,4,W
186980,18,DNK1,2018-10-07,Aalborg,Brondby,1,3,-2,L
186981,18,DNK1,2018-10-07,Midtjylland,Vendsyssel,3,0,3,W
186982,18,DNK1,2018-10-19,Esbjerg fB,Hobro,2,0,2,W
186983,18,DNK1,2018-10-20,Nordsjalland,Midtjylland,1,4,-3,L
186984,18,DNK1,2018-10-21,Vendsyssel,Horsens,0,1,-1,L
186985,18,DNK1,2018-10-21,Randers FC,SonderjyskE,1,1,0,D
186986,18,DNK1,2018-10-21,Vejle,FC Kobenhavn,1,3,-2,L
186987,18,DNK1,2018-10-21,Aarhus,Aalborg,2,2,0,D
186988,18,DNK1,2018-10-22,Brondby,Odense,1,1,0,D
186989,18,DNK1,2018-10-26,SonderjyskE,Odense,0,0,0,D
186990,18,DNK1,2018-10-27,Horsens,Nordsjalland,3,3,0,D
186991,18,DNK1,2018-10-28,Hobro,Vejle,1,0,1,W
186992,18,DNK1,2018-10-28,Randers FC,Esbjerg fB,0,2,-2,L
186993,18,DNK1,2018-10-28,FC Kobenhavn,Aarhus,4,2,2,W
186994,18,DNK1,2018-10-28,Aalborg,Vendsyssel,0,1,-1,L
186995,18,DNK1,2018-10-29,Midtjylland,Brondby,3,2,1,W
186996,18,DNK1,2018-11-02,Odense,Hobro,1,0,1,W
186997,18,DNK1,2018-11-02,Vendsyssel,SonderjyskE,2,3,-1,L
186998,18,DNK1,2018-11-04,Brondby,FC Kobenhavn,0,1,-1,L
186999,18,DNK1,2018-11-04,Nordsjalland,Aalborg,1,1,0,D
187000,18,DNK1,2018-11-04,Aarhus,Randers FC,0,2,-2,L
187001,18,DNK1,2018-11-04,Esbjerg fB,Midtjylland,2,2,0,D
187002,18,DNK1,2018-11-05,Vejle,Horsens,3,1,2,W
187003,18,DNK1,2018-11-09,Brondby,Aarhus,2,0,2,W
187004,18,DNK1,2018-11-10,Horsens,SonderjyskE,1,1,0,D
187005,18,DNK1,2018-11-11,Hobro,Vendsyssel,1,0,1,W
187006,18,DNK1,2018-11-11,Randers FC,Nordsjalland,1,1,0,D
187007,18,DNK1,2018-11-11,Aalborg,FC Kobenhavn,1,1,0,D
187008,18,DNK1,2018-11-11,Midtjylland,Vejle,5,0,5,W
187009,18,DNK1,2018-11-11,Odense,Esbjerg fB,2,1,1,W
187010,18,DNK1,2018-11-23,Vejle,Aalborg,1,1,0,D
187011,18,DNK1,2018-11-24,Hobro,Randers FC,0,1,-1,L
187012,18,DNK1,2018-11-25,Vendsyssel,Esbjerg fB,1,1,0,D
187013,18,DNK1,2018-11-25,Nordsjalland,Odense,1,3,-2,L
187014,18,DNK1,2018-11-25,SonderjyskE,Brondby,0,2,-2,L
187015,18,DNK1,2018-11-25,FC Kobenhavn,Midtjylland,2,1,1,W
187016,18,DNK1,2018-11-26,Aarhus,Horsens,1,2,-1,L
187017,18,DNK1,2018-11-30,Esbjerg fB,Aalborg,1,4,-3,L
187018,18,DNK1,2018-12-01,Odense,Vendsyssel,2,0,2,W
187019,18,DNK1,2018-12-02,SonderjyskE,Nordsjalland,1,2,-1,L
187020,18,DNK1,2018-12-02,Randers FC,Midtjylland,1,2,-1,L
187021,18,DNK1,2018-12-02,Horsens,FC Kobenhavn,1,6,-5,L
187022,18,DNK1,2018-12-02,Brondby,Hobro,1,0,1,W
187023,18,DNK1,2018-12-03,Aarhus,Vejle,2,1,1,W
187024,18,DNK1,2018-12-07,Midtjylland,Odense,3,0,3,W
187025,18,DNK1,2018-12-08,Hobro,SonderjyskE,0,0,0,D
187026,18,DNK1,2018-12-09,Vendsyssel,Randers FC,0,1,-1,L
187027,18,DNK1,2018-12-09,Aalborg,Horsens,2,4,-2,L
187028,18,DNK1,2018-12-09,FC Kobenhavn,Esbjerg fB,3,0,3,W
187029,18,DNK1,2018-12-09,Vejle,Brondby,1,2,-1,L
187030,18,DNK1,2018-12-10,Nordsjalland,Aarhus,1,0,1,W
187031,18,DNK1,2018-12-14,Odense,Aalborg,1,2,-1,L
187032,18,DNK1,2018-12-15,Randers FC,Vejle,2,0,2,W
187033,18,DNK1,2018-12-16,Esbjerg fB,Nordsjalland,3,0,3,W
187034,18,DNK1,2018-12-16,Horsens,Midtjylland,1,3,-2,L
187035,18,DNK1,2018-12-16,SonderjyskE,FC Kobenhavn,0,3,-3,L
187036,18,DNK1,2018-12-16,Brondby,Vendsyssel,2,3,-1,L
187037,18,DNK1,2018-12-17,Aarhus,Hobro,1,0,1,W
187038,18,DNK1,2019-02-08,Aarhus,Esbjerg fB,2,0,2,W
187039,18,DNK1,2019-02-09,Vejle,SonderjyskE,2,0,2,W
187040,18,DNK1,2019-02-10,Hobro,Horsens,0,0,0,D
187041,18,DNK1,2019-02-10,Aalborg,Randers FC,0,3,-3,L
187042,18,DNK1,2019-02-10,Nordsjalland,Brondby,3,3,0,D
187043,18,DNK1,2019-02-10,FC Kobenhavn,Odense,6,1,5,W
187044,18,DNK1,2019-02-11,Vendsyssel,Midtjylland,0,1,-1,L
187045,18,DNK1,2019-02-15,SonderjyskE,Aarhus,0,2,-2,L
187046,18,DNK1,2019-02-16,Nordsjalland,Hobro,2,1,1,W
187047,18,DNK1,2019-02-17,Horsens,Vendsyssel,3,0,3,W
187048,18,DNK1,2019-02-17,Odense,Vejle,1,0,1,W
187049,18,DNK1,2019-02-17,Randers FC,FC Kobenhavn,0,2,-2,L
187050,18,DNK1,2019-02-17,Esbjerg fB,Brondby,2,1,1,W
187051,18,DNK1,2019-02-18,Midtjylland,Aalborg,2,1,1,W
187052,18,DNK1,2019-02-22,Aalborg,SonderjyskE,3,0,3,W
187053,18,DNK1,2019-02-23,Vejle,Nordsjalland,1,3,-2,L
187054,18,DNK1,2019-02-24,Hobro,Esbjerg fB,2,0,2,W
187055,18,DNK1,2019-02-24,Horsens,Odense,1,2,-1,L
187056,18,DNK1,2019-02-24,Aarhus,Midtjylland,1,2,-1,L
187057,18,DNK1,2019-02-24,Brondby,Randers FC,2,1,1,W
187058,18,DNK1,2019-02-25,FC Kobenhavn,Vendsyssel,1,1,0,D
187059,18,DNK1,2019-03-01,Aalborg,Hobro,1,1,0,D
187060,18,DNK1,2019-03-02,Esbjerg fB,Horsens,1,0,1,W
187061,18,DNK1,2019-03-03,SonderjyskE,Randers FC,3,0,3,W
187062,18,DNK1,2019-03-03,Vendsyssel,Aarhus,2,2,0,D
187063,18,DNK1,2019-03-03,FC Kobenhavn,Vejle,2,0,2,W
187064,18,DNK1,2019-03-03,Odense,Brondby,2,0,2,W
187065,18,DNK1,2019-03-04,Midtjylland,Nordsjalland,3,3,0,D
187066,18,DNK1,2019-03-08,Hobro,Midtjylland,1,2,-1,L
187067,18,DNK1,2019-03-09,Vejle,Vendsyssel,1,1,0,D
187068,18,DNK1,2019-03-10,Randers FC,Horsens,2,0,2,W
187069,18,DNK1,2019-03-10,SonderjyskE,Esbjerg fB,3,1,2,W
187070,18,DNK1,2019-03-10,Nordsjalland,FC Kobenhavn,2,2,0,D
187071,18,DNK1,2019-03-10,Brondby,Aalborg,3,3,0,D
187072,18,DNK1,2019-03-11,Aarhus,Odense,1,2,-1,L
187073,18,DNK1,2019-03-17,Aalborg,Aarhus,3,1,2,W
187074,18,DNK1,2019-03-17,Vendsyssel,Nordsjalland,0,1,-1,L
187075,18,DNK1,2019-03-17,Midtjylland,SonderjyskE,2,1,1,W
187076,18,DNK1,2019-03-17,Odense,Randers FC,1,0,1,W
187077,18,DNK1,2019-03-17,Esbjerg fB,Vejle,2,1,1,W
187078,18,DNK1,2019-03-17,Horsens,Brondby,1,3,-2,L
187079,18,DNK1,2019-03-17,FC Kobenhavn,Hobro,3,1,2,W
187080,19,DNK1,2019-07-12,Midtjylland,Esbjerg fB,1,0,1,W
187081,19,DNK1,2019-07-14,SonderjyskE,Randers FC,2,1,1,W
187082,19,DNK1,2019-07-14,Horsens,Nordsjalland,0,3,-3,L
187083,19,DNK1,2019-07-14,Lyngby,Aalborg,2,0,2,W
187084,19,DNK1,2019-07-14,Odense,FC Kobenhavn,2,3,-1,L
187085,19,DNK1,2019-07-14,Brondby,Silkeborg,3,0,3,W
187086,19,DNK1,2019-07-15,Hobro,Aarhus,1,1,0,D
187087,19,DNK1,2019-07-19,FC Kobenhavn,Aarhus,2,1,1,W
187088,19,DNK1,2019-07-21,Silkeborg,Horsens,0,3,-3,L
187089,19,DNK1,2019-07-21,Aalborg,SonderjyskE,1,1,0,D
187090,19,DNK1,2019-07-21,Esbjerg fB,Hobro,1,1,0,D
187091,19,DNK1,2019-07-21,Randers FC,Brondby,2,2,0,D
187092,19,DNK1,2019-07-21,Midtjylland,Nordsjalland,2,1,1,W
187093,19,DNK1,2019-07-22,Odense,Lyngby,4,1,3,W
187094,19,DNK1,2019-07-26,Lyngby,SonderjyskE,0,3,-3,L
187095,19,DNK1,2019-07-27,Horsens,FC Kobenhavn,0,2,-2,L
187096,19,DNK1,2019-07-28,Hobro,Randers FC,2,2,0,D
187097,19,DNK1,2019-07-28,Nordsjalland,Esbjerg fB,2,0,2,W
187098,19,DNK1,2019-07-28,Aarhus,Midtjylland,0,1,-1,L
187099,19,DNK1,2019-07-28,Brondby,Odense,3,2,1,W
187100,19,DNK1,2019-07-29,Aalborg,Silkeborg,3,1,2,W
187101,19,DNK1,2019-08-02,Silkeborg,Hobro,2,3,-1,L
187102,19,DNK1,2019-08-03,SonderjyskE,FC Kobenhavn,1,2,-1,L
187103,19,DNK1,2019-08-04,Randers FC,Nordsjalland,3,1,2,W
187104,19,DNK1,2019-08-04,Esbjerg fB,Odense,0,1,-1,L
187105,19,DNK1,2019-08-04,Brondby,Horsens,1,2,-1,L
187106,19,DNK1,2019-08-04,Midtjylland,Aalborg,1,0,1,W
187107,19,DNK1,2019-08-05,Lyngby,Aarhus,2,1,1,W
187108,19,DNK1,2019-08-09,FC Kobenhavn,Lyngby,2,0,2,W
187109,19,DNK1,2019-08-09,Odense,Randers FC,1,0,1,W
187110,19,DNK1,2019-08-11,Nordsjalland,Silkeborg,2,2,0,D
187111,19,DNK1,2019-08-11,Aalborg,Esbjerg fB,4,0,4,W
187112,19,DNK1,2019-08-11,Horsens,Midtjylland,0,2,-2,L
187113,19,DNK1,2019-08-11,Hobro,Brondby,0,2,-2,L
187114,19,DNK1,2019-08-12,SonderjyskE,Aarhus,0,0,0,D
187115,19,DNK1,2019-08-16,Randers FC,FC Kobenhavn,0,1,-1,L
187116,19,DNK1,2019-08-16,Nordsjalland,Odense,2,0,2,W
187117,19,DNK1,2019-08-18,Silkeborg,SonderjyskE,3,3,0,D
187118,19,DNK1,2019-08-18,Esbjerg fB,Lyngby,1,0,1,W
187119,19,DNK1,2019-08-18,Midtjylland,Hobro,1,1,0,D
187120,19,DNK1,2019-08-18,Brondby,Aalborg,2,1,1,W
187121,19,DNK1,2019-08-19,Aarhus,Horsens,2,0,2,W
187122,19,DNK1,2019-08-23,Hobro,Odense,0,0,0,D
187123,19,DNK1,2019-08-25,Lyngby,Randers FC,2,0,2,W
187124,19,DNK1,2019-08-25,Esbjerg fB,Silkeborg,2,2,0,D
187125,19,DNK1,2019-08-25,SonderjyskE,Midtjylland,0,2,-2,L
187126,19,DNK1,2019-08-25,Brondby,Aarhus,0,3,-3,L
187127,19,DNK1,2019-08-25,FC Kobenhavn,Nordsjalland,3,1,2,W
187128,19,DNK1,2019-08-26,Horsens,Aalborg,0,5,-5,L
187129,19,DNK1,2019-08-30,Odense,SonderjyskE,0,0,0,D
187130,19,DNK1,2019-08-31,Nordsjalland,Hobro,2,1,1,W
187131,19,DNK1,2019-09-01,Aarhus,Esbjerg fB,1,0,1,W
187132,19,DNK1,2019-09-01,Randers FC,Silkeborg,2,0,2,W
187133,19,DNK1,2019-09-01,Horsens,Lyngby,2,1,1,W
187134,19,DNK1,2019-09-01,Aalborg,FC Kobenhavn,1,0,1,W
187135,19,DNK1,2019-09-01,Midtjylland,Brondby,1,0,1,W
187136,19,DNK1,2019-09-13,SonderjyskE,Horsens,0,0,0,D
187137,19,DNK1,2019-09-15,Aarhus,Aalborg,3,0,3,W
187138,19,DNK1,2019-09-15,Esbjerg fB,Randers FC,0,3,-3,L
187139,19,DNK1,2019-09-15,Lyngby,Midtjylland,0,3,-3,L
187140,19,DNK1,2019-09-15,Hobro,FC Kobenhavn,2,1,1,W
187141,19,DNK1,2019-09-15,Brondby,Nordsjalland,4,2,2,W
187142,19,DNK1,2019-09-16,Silkeborg,Odense,0,3,-3,L
187143,19,DNK1,2019-09-20,Odense,Aarhus,1,2,-1,L
187144,19,DNK1,2019-09-22,Hobro,SonderjyskE,1,1,0,D
187145,19,DNK1,2019-09-22,Nordsjalland,Aalborg,2,1,1,W
187146,19,DNK1,2019-09-22,Silkeborg,Lyngby,2,3,-1,L
187147,19,DNK1,2019-09-22,Esbjerg fB,Brondby,3,1,2,W
187148,19,DNK1,2019-09-22,FC Kobenhavn,Midtjylland,0,0,0,D
187149,19,DNK1,2019-09-23,Randers FC,Horsens,2,1,1,W
187150,19,DNK1,2019-09-27,Lyngby,Hobro,2,1,1,W
187151,19,DNK1,2019-09-28,FC Kobenhavn,Silkeborg,4,2,2,W
187152,19,DNK1,2019-09-29,Aarhus,Nordsjalland,3,1,2,W
187153,19,DNK1,2019-09-29,Aalborg,Randers FC,0,3,-3,L
187154,19,DNK1,2019-09-29,Midtjylland,Odense,0,1,-1,L
187155,19,DNK1,2019-09-29,SonderjyskE,Brondby,2,1,1,W
187156,19,DNK1,2019-09-30,Horsens,Esbjerg fB,1,1,0,D
187157,19,DNK1,2019-10-04,Nordsjalland,Lyngby,1,1,0,D
187158,19,DNK1,2019-10-05,Hobro,Aalborg,0,2,-2,L
187159,19,DNK1,2019-10-06,Esbjerg fB,SonderjyskE,1,2,-1,L
187160,19,DNK1,2019-10-06,Brondby,FC Kobenhavn,3,1,2,W
187161,19,DNK1,2019-10-06,Odense,Horsens,3,0,3,W
187162,19,DNK1,2019-10-06,Randers FC,Aarhus,2,0,2,W
187163,19,DNK1,2019-10-06,Silkeborg,Midtjylland,1,2,-1,L
187164,19,DNK1,2019-10-18,Aalborg,Odense,1,0,1,W
187165,19,DNK1,2019-10-20,Horsens,Hobro,1,0,1,W
187166,19,DNK1,2019-10-20,SonderjyskE,Nordsjalland,1,4,-3,L
187167,19,DNK1,2019-10-20,Aarhus,Silkeborg,3,4,-1,L
187168,19,DNK1,2019-10-20,FC Kobenhavn,Esbjerg fB,3,1,2,W
187169,19,DNK1,2019-10-20,Lyngby,Brondby,0,3,-3,L
187170,19,DNK1,2019-10-21,Midtjylland,Randers FC,2,1,1,W
187171,19,DNK1,2019-10-25,Esbjerg fB,Midtjylland,1,2,-1,L
187172,19,DNK1,2019-10-27,Hobro,Silkeborg,1,1,0,D
187173,19,DNK1,2019-10-27,Odense,Nordsjalland,3,1,2,W
187174,19,DNK1,2019-10-27,Lyngby,Horsens,2,1,1,W
187175,19,DNK1,2019-10-27,Brondby,Randers FC,5,2,3,W
187176,19,DNK1,2019-10-27,SonderjyskE,Aalborg,1,3,-2,L
187177,19,DNK1,2019-10-28,Aarhus,FC Kobenhavn,1,2,-1,L
187178,19,DNK1,2019-11-01,Esbjerg fB,Horsens,1,1,0,D
187179,19,DNK1,2019-11-03,Randers FC,Lyngby,2,1,1,W
187180,19,DNK1,2019-11-03,Odense,Hobro,2,1,1,W
187181,19,DNK1,2019-11-03,Nordsjalland,Aarhus,0,1,-1,L
187182,19,DNK1,2019-11-03,Aalborg,Midtjylland,0,1,-1,L
187183,19,DNK1,2019-11-03,FC Kobenhavn,SonderjyskE,3,0,3,W
187184,19,DNK1,2019-11-04,Silkeborg,Brondby,0,1,-1,L
187185,19,DNK1,2019-11-08,Randers FC,Aalborg,3,3,0,D
187186,19,DNK1,2019-11-09,Horsens,Silkeborg,2,1,1,W
187187,19,DNK1,2019-11-10,Hobro,Nordsjalland,2,2,0,D
187188,19,DNK1,2019-11-10,Aarhus,SonderjyskE,4,2,2,W
187189,19,DNK1,2019-11-10,Lyngby,Odense,4,3,1,W
187190,19,DNK1,2019-11-10,Brondby,Esbjerg fB,2,1,1,W
187191,19,DNK1,2019-11-10,Midtjylland,FC Kobenhavn,4,1,3,W
187192,19,DNK1,2019-11-22,Nordsjalland,Randers FC,3,0,3,W
187193,19,DNK1,2019-11-24,SonderjyskE,Lyngby,2,2,0,D
187194,19,DNK1,2019-11-24,Aalborg,Horsens,4,0,4,W
187195,19,DNK1,2019-11-24,Silkeborg,Esbjerg fB,1,2,-1,L
187196,19,DNK1,2019-11-24,FC Kobenhavn,Hobro,2,1,1,W
187197,19,DNK1,2019-11-24,Aarhus,Brondby,2,1,1,W
187198,19,DNK1,2019-11-25,Odense,Midtjylland,1,2,-1,L
187199,19,DNK1,2019-11-29,Lyngby,Nordsjalland,1,1,0,D
187200,19,DNK1,2019-12-01,FC Kobenhavn,Brondby,2,1,1,W
187201,19,DNK1,2019-12-01,Randers FC,SonderjyskE,3,0,3,W
187202,19,DNK1,2019-12-01,Horsens,Odense,2,1,1,W
187203,19,DNK1,2019-12-01,Esbjerg fB,Aarhus,1,2,-1,L
187204,19,DNK1,2019-12-01,Aalborg,Hobro,1,1,0,D
187205,19,DNK1,2019-12-02,Midtjylland,Silkeborg,2,1,1,W
187206,19,DNK1,2019-12-06,Hobro,Horsens,0,0,0,D
187207,19,DNK1,2019-12-08,Silkeborg,Randers FC,2,1,1,W
187208,19,DNK1,2019-12-08,SonderjyskE,Esbjerg fB,2,1,1,W
187209,19,DNK1,2019-12-08,Aarhus,Lyngby,1,1,0,D
187210,19,DNK1,2019-12-08,Nordsjalland,FC Kobenhavn,0,1,-1,L
187211,19,DNK1,2019-12-08,Brondby,Midtjylland,1,2,-1,L
187212,19,DNK1,2019-12-09,Odense,Aalborg,0,0,0,D
187213,19,DNK1,2019-12-13,Aalborg,Nordsjalland,1,3,-2,L
187214,19,DNK1,2019-12-15,Horsens,SonderjyskE,2,1,1,W
187215,19,DNK1,2019-12-15,Randers FC,Esbjerg fB,3,0,3,W
187216,19,DNK1,2019-12-15,Lyngby,Silkeborg,1,0,1,W
187217,19,DNK1,2019-12-15,Brondby,Hobro,1,1,0,D
187218,19,DNK1,2019-12-15,Midtjylland,Aarhus,1,3,-2,L
187219,19,DNK1,2019-12-16,FC Kobenhavn,Odense,2,1,1,W
187220,19,DNK1,2020-02-14,Esbjerg fB,FC Kobenhavn,1,0,1,W
187221,19,DNK1,2020-02-16,SonderjyskE,Hobro,3,1,2,W
187222,19,DNK1,2020-02-16,Silkeborg,Aalborg,0,2,-2,L
187223,19,DNK1,2020-02-16,Odense,Brondby,0,2,-2,L
187224,19,DNK1,2020-02-17,Midtjylland,Lyngby,2,0,2,W
187225,19,DNK1,2020-02-19,Nordsjalland,Horsens,6,0,6,W
187226,19,DNK1,2020-02-21,Hobro,Midtjylland,0,2,-2,L
187227,19,DNK1,2020-02-23,Nordsjalland,SonderjyskE,2,1,1,W
187228,19,DNK1,2020-02-23,Randers FC,Odense,0,0,0,D
187229,19,DNK1,2020-02-23,Lyngby,Esbjerg fB,2,0,2,W
187230,19,DNK1,2020-02-23,Silkeborg,FC Kobenhavn,1,1,0,D
187231,19,DNK1,2020-02-23,Aalborg,Brondby,3,2,1,W
187232,19,DNK1,2020-02-24,Horsens,Aarhus,1,2,-1,L
187233,19,DNK1,2020-02-28,Aarhus,Hobro,0,0,0,D
187234,19,DNK1,2020-02-29,Esbjerg fB,Nordsjalland,1,2,-1,L
187235,19,DNK1,2020-03-01,Horsens,Randers FC,1,2,-1,L
187236,19,DNK1,2020-03-01,Odense,Silkeborg,1,1,0,D
187237,19,DNK1,2020-03-01,Brondby,Lyngby,1,0,1,W
187238,19,DNK1,2020-03-01,FC Kobenhavn,Aalborg,3,2,1,W
187239,19,DNK1,2020-03-02,Midtjylland,SonderjyskE,3,0,3,W
187240,19,DNK1,2020-03-08,Hobro,Esbjerg fB,1,1,0,D
187241,19,DNK1,2020-03-08,SonderjyskE,Odense,1,1,0,D
187242,19,DNK1,2020-03-08,Aalborg,Lyngby,3,0,3,W
187243,19,DNK1,2020-03-08,FC Kobenhavn,Horsens,0,1,-1,L
187244,19,DNK1,2020-03-08,Nordsjalland,Brondby,2,2,0,D
187245,19,DNK1,2020-03-08,Randers FC,Midtjylland,0,2,-2,L
187246,19,DNK1,2020-03-09,Silkeborg,Aarhus,2,1,1,W
187247,19,DNK1,2020-05-28,Aarhus,Randers FC,1,1,0,D
187248,19,DNK1,2020-05-29,Silkeborg,Nordsjalland,0,2,-2,L
187249,19,DNK1,2020-05-31,Esbjerg fB,Aalborg,1,1,0,D
187250,19,DNK1,2020-06-01,Randers FC,Hobro,0,1,-1,L
187251,19,DNK1,2020-06-01,Midtjylland,Horsens,0,1,-1,L
187252,19,DNK1,2020-06-01,Lyngby,FC Kobenhavn,1,4,-3,L
187253,19,DNK1,2020-06-01,Aarhus,Odense,1,0,1,W
187254,19,DNK1,2020-06-02,Brondby,SonderjyskE,1,0,1,W
187255,19,DNK1,2020-06-07,FC Kobenhavn,Randers FC,2,1,1,W
187256,19,DNK1,2020-06-07,SonderjyskE,Silkeborg,2,2,0,D
187257,19,DNK1,2020-06-07,Aalborg,Aarhus,2,3,-1,L
187258,19,DNK1,2020-06-07,Odense,Esbjerg fB,3,1,2,W
187259,19,DNK1,2020-06-07,Horsens,Brondby,3,2,1,W
187260,19,DNK1,2020-06-07,Nordsjalland,Midtjylland,0,1,-1,L
187261,19,DNK1,2020-06-07,Hobro,Lyngby,2,2,0,D
187262,20,DNK1,2020-09-11,SonderjyskE,Midtjylland,2,0,2,W
187263,20,DNK1,2020-09-13,Horsens,Randers FC,0,3,-3,L
187264,20,DNK1,2020-09-13,Lyngby,Aalborg,0,0,0,D
187265,20,DNK1,2020-09-13,Brondby,Nordsjalland,3,2,1,W
187266,20,DNK1,2020-09-13,Odense,FC Kobenhavn,3,2,1,W
187267,20,DNK1,2020-09-14,Aarhus,Vejle,4,2,2,W
187268,20,DNK1,2020-09-19,Midtjylland,Lyngby,1,0,1,W
187269,20,DNK1,2020-09-20,FC Kobenhavn,Brondby,1,2,-1,L
187270,20,DNK1,2020-09-20,Odense,Nordsjalland,1,1,0,D
187271,20,DNK1,2020-09-20,Randers FC,Aarhus,1,1,0,D
187272,20,DNK1,2020-09-20,Vejle,SonderjyskE,4,1,3,W
187273,20,DNK1,2020-09-21,Aalborg,Horsens,1,0,1,W
187274,20,DNK1,2020-09-26,Midtjylland,Randers FC,1,0,1,W
187275,20,DNK1,2020-09-27,Aarhus,Odense,4,2,2,W
187276,20,DNK1,2020-09-27,SonderjyskE,Aalborg,3,1,2,W
187277,20,DNK1,2020-09-27,Brondby,Horsens,2,1,1,W
187278,20,DNK1,2020-09-27,Vejle,FC Kobenhavn,2,2,0,D
187279,20,DNK1,2020-09-28,Nordsjalland,Lyngby,4,1,3,W
187280,20,DNK1,2020-10-02,Randers FC,Brondby,1,2,-1,L
187281,20,DNK1,2020-10-04,Lyngby,SonderjyskE,2,2,0,D
187282,20,DNK1,2020-10-04,Odense,Vejle,0,1,-1,L
187283,20,DNK1,2020-10-04,Aalborg,Aarhus,1,1,0,D
187284,20,DNK1,2020-10-04,Horsens,Midtjylland,2,2,0,D
187285,20,DNK1,2020-10-04,FC Kobenhavn,Nordsjalland,3,2,1,W
187286,20,DNK1,2020-10-17,Midtjylland,Odense,3,1,2,W
187287,20,DNK1,2020-10-18,Aarhus,Horsens,3,0,3,W
187288,20,DNK1,2020-10-18,Vejle,Lyngby,3,2,1,W
187289,20,DNK1,2020-10-18,SonderjyskE,Brondby,2,0,2,W
187290,20,DNK1,2020-10-18,FC Kobenhavn,Aalborg,1,2,-1,L
187291,20,DNK1,2020-10-19,Nordsjalland,Randers FC,1,0,1,W
187292,20,DNK1,2020-10-23,Lyngby,Odense,0,3,-3,L
187293,20,DNK1,2020-10-24,Brondby,Midtjylland,2,3,-1,L
187294,20,DNK1,2020-10-25,Horsens,Nordsjalland,1,1,0,D
187295,20,DNK1,2020-10-25,Randers FC,SonderjyskE,1,2,-1,L
187296,20,DNK1,2020-10-25,Aarhus,FC Kobenhavn,0,1,-1,L
187297,20,DNK1,2020-10-26,Aalborg,Vejle,1,3,-2,L
187298,20,DNK1,2020-10-30,Vejle,Randers FC,0,3,-3,L
187299,20,DNK1,2020-10-31,Nordsjalland,Midtjylland,4,1,3,W
187300,20,DNK1,2020-11-01,Odense,Horsens,1,0,1,W
187301,20,DNK1,2020-11-01,FC Kobenhavn,Lyngby,4,2,2,W
187302,20,DNK1,2020-11-01,Aalborg,Brondby,2,1,1,W
187303,20,DNK1,2020-11-02,SonderjyskE,Aarhus,1,1,0,D
187304,20,DNK1,2020-11-06,Randers FC,Aalborg,1,2,-1,L
187305,20,DNK1,2020-11-08,Nordsjalland,Vejle,1,1,0,D
187306,20,DNK1,2020-11-08,Lyngby,Aarhus,1,2,-1,L
187307,20,DNK1,2020-11-08,Brondby,Odense,3,1,2,W
187308,20,DNK1,2020-11-08,Midtjylland,FC Kobenhavn,4,0,4,W
187309,20,DNK1,2020-11-08,Horsens,SonderjyskE,0,3,-3,L
187310,20,DNK1,2020-11-20,Lyngby,Horsens,1,1,0,D
187311,20,DNK1,2020-11-22,Aalborg,Nordsjalland,1,1,0,D
187312,20,DNK1,2020-11-22,Odense,SonderjyskE,1,1,0,D
187313,20,DNK1,2020-11-22,Aarhus,Midtjylland,1,2,-1,L
187314,20,DNK1,2020-11-22,Vejle,Brondby,0,2,-2,L
187315,20,DNK1,2020-11-23,FC Kobenhavn,Randers FC,1,2,-1,L
187316,20,DNK1,2020-11-27,Randers FC,Odense,2,1,1,W
187317,20,DNK1,2020-11-28,Midtjylland,Aalborg,0,0,0,D
187318,20,DNK1,2020-11-29,Horsens,Vejle,3,1,2,W
187319,20,DNK1,2020-11-29,SonderjyskE,FC Kobenhavn,1,3,-2,L
187320,20,DNK1,2020-11-29,Nordsjalland,Aarhus,3,1,2,W
187321,20,DNK1,2020-11-30,Brondby,Lyngby,4,1,3,W
187322,20,DNK1,2020-12-04,Odense,Aalborg,2,1,1,W
187323,20,DNK1,2020-12-05,Vejle,Midtjylland,0,2,-2,L
187324,20,DNK1,2020-12-06,SonderjyskE,Nordsjalland,2,1,1,W
187325,20,DNK1,2020-12-06,FC Kobenhavn,Horsens,2,0,2,W
187326,20,DNK1,2020-12-06,Lyngby,Randers FC,0,3,-3,L
187327,20,DNK1,2020-12-07,Aarhus,Brondby,3,1,2,W
187328,20,DNK1,2020-12-11,Randers FC,Vejle,3,1,2,W
187329,20,DNK1,2020-12-13,Aalborg,Lyngby,3,2,1,W
187330,20,DNK1,2020-12-13,Horsens,Aarhus,1,2,-1,L
187331,20,DNK1,2020-12-13,Nordsjalland,FC Kobenhavn,0,1,-1,L
187332,20,DNK1,2020-12-13,Brondby,SonderjyskE,2,1,1,W
187333,20,DNK1,2020-12-14,Odense,Midtjylland,1,1,0,D
187334,20,DNK1,2020-12-20,Lyngby,Vejle,0,0,0,D
187335,20,DNK1,2020-12-20,SonderjyskE,Randers FC,0,1,-1,L
187336,20,DNK1,2020-12-20,Aarhus,Aalborg,3,0,3,W
187337,20,DNK1,2020-12-20,FC Kobenhavn,Odense,1,1,0,D
187338,20,DNK1,2020-12-20,Horsens,Brondby,1,2,-1,L
187339,20,DNK1,2020-12-21,Midtjylland,Nordsjalland,3,1,2,W
187340,20,DNK1,2021-02-02,Randers FC,Horsens,3,0,3,W
187341,20,DNK1,2021-02-02,Vejle,Aarhus,0,0,0,D
187342,20,DNK1,2021-02-03,Odense,Lyngby,0,1,-1,L
187343,20,DNK1,2021-02-03,Aalborg,FC Kobenhavn,2,3,-1,L
187344,20,DNK1,2021-02-04,Midtjylland,SonderjyskE,1,2,-1,L
187345,20,DNK1,2021-02-04,Nordsjalland,Brondby,0,1,-1,L
187346,20,DNK1,2021-02-07,Nordsjalland,Odense,0,2,-2,L
187347,20,DNK1,2021-02-07,SonderjyskE,Vejle,0,1,-1,L
187348,20,DNK1,2021-02-07,Horsens,FC Kobenhavn,0,2,-2,L
187349,20,DNK1,2021-02-07,Aarhus,Lyngby,1,0,1,W
187350,20,DNK1,2021-02-07,Brondby,Aalborg,1,1,0,D
187351,20,DNK1,2021-02-08,Randers FC,Midtjylland,1,2,-1,L
187352,20,DNK1,2021-02-14,Aalborg,Randers FC,0,0,0,D
187353,20,DNK1,2021-02-14,Vejle,Nordsjalland,2,2,0,D
187354,20,DNK1,2021-02-14,Lyngby,Brondby,0,4,-4,L
187355,20,DNK1,2021-02-14,Midtjylland,Horsens,1,0,1,W
187356,20,DNK1,2021-02-14,Odense,Aarhus,0,0,0,D
187357,20,DNK1,2021-02-15,FC Kobenhavn,SonderjyskE,3,2,1,W
187358,20,DNK1,2021-02-19,Aalborg,Midtjylland,0,2,-2,L
187359,20,DNK1,2021-02-21,Horsens,Odense,0,0,0,D
187360,20,DNK1,2021-02-21,Randers FC,Nordsjalland,1,1,0,D
187361,20,DNK1,2021-02-21,Aarhus,SonderjyskE,2,0,2,W
187362,20,DNK1,2021-02-21,Brondby,Vejle,2,1,1,W
187363,20,DNK1,2021-02-22,Lyngby,FC Kobenhavn,2,2,0,D
187364,20,DNK1,2021-02-26,Vejle,Horsens,0,0,0,D
187365,20,DNK1,2021-02-28,Nordsjalland,Aalborg,2,2,0,D
187366,20,DNK1,2021-02-28,Odense,Randers FC,2,1,1,W
187367,20,DNK1,2021-02-28,FC Kobenhavn,Aarhus,3,3,0,D
187368,20,DNK1,2021-02-28,Midtjylland,Brondby,1,0,1,W
187369,20,DNK1,2021-03-01,SonderjyskE,Lyngby,1,4,-3,L
187370,20,DNK1,2021-03-03,Aarhus,Nordsjalland,0,1,-1,L
187371,20,DNK1,2021-03-03,Horsens,Aalborg,2,1,1,W
187372,20,DNK1,2021-03-03,FC Kobenhavn,Vejle,2,1,1,W
187373,20,DNK1,2021-03-04,Lyngby,Midtjylland,2,0,2,W
187374,20,DNK1,2021-03-04,SonderjyskE,Odense,1,1,0,D
187375,20,DNK1,2021-03-04,Brondby,Randers FC,0,0,0,D
187376,20,DNK1,2021-03-07,Randers FC,Lyngby,1,2,-1,L
187377,20,DNK1,2021-03-07,Brondby,FC Kobenhavn,2,1,1,W
187378,20,DNK1,2021-03-07,Midtjylland,Aarhus,0,1,-1,L
187379,20,DNK1,2021-03-07,Nordsjalland,Horsens,2,2,0,D
187380,20,DNK1,2021-03-07,Vejle,Odense,2,0,2,W
187381,20,DNK1,2021-03-08,Aalborg,SonderjyskE,1,0,1,W
187382,20,DNK1,2021-03-12,Lyngby,Nordsjalland,0,3,-3,L
187383,20,DNK1,2021-03-14,SonderjyskE,Horsens,2,0,2,W
187384,20,DNK1,2021-03-14,Vejle,Aalborg,0,2,-2,L
187385,20,DNK1,2021-03-14,Odense,Brondby,0,3,-3,L
187386,20,DNK1,2021-03-14,FC Kobenhavn,Midtjylland,0,0,0,D
187387,20,DNK1,2021-03-15,Aarhus,Randers FC,1,1,0,D
187388,20,DNK1,2021-03-21,Aalborg,Odense,0,2,-2,L
187389,20,DNK1,2021-03-21,Horsens,Lyngby,1,2,-1,L
187390,20,DNK1,2021-03-21,Brondby,Aarhus,1,1,0,D
187391,20,DNK1,2021-03-21,Midtjylland,Vejle,5,0,5,W
187392,20,DNK1,2021-03-21,Nordsjalland,SonderjyskE,2,1,1,W
187393,20,DNK1,2021-03-21,Randers FC,FC Kobenhavn,2,1,1,W
187394,20,DNK1,2021-04-04,Nordsjalland,Aarhus,2,0,2,W
187395,20,DNK1,2021-04-04,Horsens,Odense,1,1,0,D
187396,20,DNK1,2021-04-05,FC Kobenhavn,Randers FC,2,1,1,W
187397,20,DNK1,2021-04-05,Midtjylland,Brondby,1,0,1,W
187398,20,DNK1,2021-04-05,Aalborg,SonderjyskE,3,2,1,W
187399,20,DNK1,2021-04-06,Lyngby,Vejle,0,0,0,D
187400,20,DNK1,2021-04-09,Odense,Vejle,0,1,-1,L
187401,20,DNK1,2021-04-11,Randers FC,Nordsjalland,3,4,-1,L
187402,20,DNK1,2021-04-11,Brondby,FC Kobenhavn,1,3,-2,L
187403,20,DNK1,2021-04-11,Aarhus,Midtjylland,1,4,-3,L
187404,20,DNK1,2021-04-11,SonderjyskE,Horsens,2,3,-1,L
187405,20,DNK1,2021-04-12,Lyngby,Aalborg,2,2,0,D
187406,20,DNK1,2021-04-16,Vejle,Aalborg,1,1,0,D
187407,20,DNK1,2021-04-18,FC Kobenhavn,Nordsjalland,2,2,0,D
187408,20,DNK1,2021-04-18,Brondby,Aarhus,2,2,0,D
187409,20,DNK1,2021-04-18,Horsens,Lyngby,1,3,-2,L
187410,20,DNK1,2021-04-18,Odense,SonderjyskE,1,1,0,D
187411,20,DNK1,2021-04-19,Randers FC,Midtjylland,0,0,0,D
187412,20,DNK1,2021-04-21,Nordsjalland,Brondby,0,3,-3,L
187413,20,DNK1,2021-04-21,Lyngby,SonderjyskE,0,1,-1,L
187414,20,DNK1,2021-04-21,Aalborg,Odense,3,2,1,W
187415,20,DNK1,2021-04-22,Aarhus,Randers FC,2,0,2,W
187416,20,DNK1,2021-04-22,Midtjylland,FC Kobenhavn,4,1,3,W
187417,20,DNK1,2021-04-22,Vejle,Horsens,3,0,3,W
187418,20,DNK1,2021-04-25,Brondby,Randers FC,2,0,2,W
187419,20,DNK1,2021-04-25,Aarhus,FC Kobenhavn,1,2,-1,L
187420,20,DNK1,2021-04-25,Horsens,Aalborg,1,0,1,W
187421,20,DNK1,2021-04-25,SonderjyskE,Vejle,1,0,1,W
187422,20,DNK1,2021-04-25,Odense,Lyngby,2,0,2,W
187423,20,DNK1,2021-04-26,Nordsjalland,Midtjylland,3,2,1,W
187424,20,DNK1,2021-04-30,Horsens,Vejle,3,3,0,D
187425,20,DNK1,2021-04-30,Aalborg,Lyngby,4,0,4,W
187426,20,DNK1,2021-05-02,Randers FC,Brondby,4,2,2,W
187427,20,DNK1,2021-05-02,Midtjylland,Nordsjalland,3,0,3,W
187428,20,DNK1,2021-05-02,SonderjyskE,Odense,2,0,2,W
187429,20,DNK1,2021-05-03,FC Kobenhavn,Aarhus,3,2,1,W
187430,20,DNK1,2021-05-07,Odense,Aalborg,1,0,1,W
187431,20,DNK1,2021-05-09,Randers FC,Aarhus,0,1,-1,L
187432,20,DNK1,2021-05-09,Brondby,Midtjylland,3,1,2,W
187433,20,DNK1,2021-05-09,Lyngby,Horsens,3,4,-1,L
187434,20,DNK1,2021-05-09,Vejle,SonderjyskE,4,2,2,W
187435,20,DNK1,2021-05-10,Nordsjalland,FC Kobenhavn,2,2,0,D
187436,20,DNK1,2021-05-14,Vejle,Odense,2,2,0,D
187437,20,DNK1,2021-05-16,Midtjylland,Randers FC,1,1,0,D
187438,20,DNK1,2021-05-16,FC Kobenhavn,Brondby,2,1,1,W
187439,20,DNK1,2021-05-16,Aarhus,Nordsjalland,3,1,2,W
187440,20,DNK1,2021-05-16,Aalborg,Horsens,1,1,0,D
187441,20,DNK1,2021-05-17,SonderjyskE,Lyngby,2,0,2,W
187442,20,DNK1,2021-05-19,Nordsjalland,Randers FC,2,1,1,W
187443,20,DNK1,2021-05-19,FC Kobenhavn,Midtjylland,4,2,2,W
187444,20,DNK1,2021-05-19,Aalborg,Vejle,2,1,1,W
187445,20,DNK1,2021-05-20,Aarhus,Brondby,1,2,-1,L
187446,20,DNK1,2021-05-20,Horsens,SonderjyskE,1,2,-1,L
187447,20,DNK1,2021-05-20,Lyngby,Odense,1,2,-1,L
187448,20,DNK1,2021-05-24,Brondby,Nordsjalland,2,0,2,W
187449,20,DNK1,2021-05-24,Midtjylland,Aarhus,4,0,4,W
187450,20,DNK1,2021-05-24,Randers FC,FC Kobenhavn,2,1,1,W
187451,20,DNK1,2021-05-24,SonderjyskE,Aalborg,0,4,-4,L
187452,20,DNK1,2021-05-24,Vejle,Lyngby,2,2,0,D
187453,20,DNK1,2021-05-24,Odense,Horsens,4,0,4,W
187454,21,DNK1,2021-07-16,Midtjylland,Odense,1,2,-1,L
187455,21,DNK1,2021-07-18,Nordsjalland,Viborg,1,2,-1,L
187456,21,DNK1,2021-07-18,Vejle,Randers FC,0,2,-2,L
187457,21,DNK1,2021-07-18,FC Kobenhavn,Aalborg,2,2,0,D
187458,21,DNK1,2021-07-18,Aarhus,Brondby,1,1,0,D
187459,21,DNK1,2021-07-19,Silkeborg,SonderjyskE,0,0,0,D
187460,21,DNK1,2021-07-24,Aalborg,Midtjylland,0,1,-1,L
187461,21,DNK1,2021-07-25,Nordsjalland,Aarhus,0,0,0,D
187462,21,DNK1,2021-07-25,Randers FC,Odense,1,1,0,D
187463,21,DNK1,2021-07-25,FC Kobenhavn,Silkeborg,0,0,0,D
187464,21,DNK1,2021-07-25,Brondby,Viborg,1,1,0,D
187465,21,DNK1,2021-07-26,SonderjyskE,Vejle,1,0,1,W
187466,21,DNK1,2021-07-31,Viborg,Midtjylland,0,2,-2,L
187467,21,DNK1,2021-08-01,Aarhus,Randers FC,1,2,-1,L
187468,21,DNK1,2021-08-01,Silkeborg,Aalborg,0,0,0,D
187469,21,DNK1,2021-08-01,Vejle,Brondby,2,2,0,D
187470,21,DNK1,2021-08-01,Odense,FC Kobenhavn,0,2,-2,L
187471,21,DNK1,2021-08-02,SonderjyskE,Nordsjalland,0,2,-2,L
187472,21,DNK1,2021-08-06,Silkeborg,Viborg,4,1,3,W
187473,21,DNK1,2021-08-06,Midtjylland,Vejle,4,1,3,W
187474,21,DNK1,2021-08-08,Randers FC,SonderjyskE,1,0,1,W
187475,21,DNK1,2021-08-08,FC Kobenhavn,Brondby,4,2,2,W
187476,21,DNK1,2021-08-08,Aalborg,Aarhus,2,0,2,W
187477,21,DNK1,2021-08-09,Nordsjalland,Odense,3,1,2,W
187478,21,DNK1,2021-08-13,SonderjyskE,Midtjylland,0,2,-2,L
187479,21,DNK1,2021-08-13,Viborg,Randers FC,1,2,-1,L
187480,21,DNK1,2021-08-13,Brondby,Nordsjalland,0,1,-1,L
187481,21,DNK1,2021-08-15,Odense,Silkeborg,1,1,0,D
187482,21,DNK1,2021-08-15,Aarhus,FC Kobenhavn,1,3,-2,L
187483,21,DNK1,2021-08-16,Vejle,Aalborg,0,1,-1,L
187484,21,DNK1,2021-08-20,Midtjylland,Silkeborg,3,0,3,W
187485,21,DNK1,2021-08-21,Odense,Brondby,2,2,0,D
187486,21,DNK1,2021-08-22,Randers FC,Aalborg,1,1,0,D
187487,21,DNK1,2021-08-22,FC Kobenhavn,SonderjyskE,2,0,2,W
187488,21,DNK1,2021-08-22,Viborg,Aarhus,2,0,2,W
187489,21,DNK1,2021-08-23,Nordsjalland,Vejle,3,1,2,W
187490,21,DNK1,2021-08-27,Aalborg,Nordsjalland,2,1,1,W
187491,21,DNK1,2021-08-29,Silkeborg,Randers FC,2,1,1,W
187492,21,DNK1,2021-08-29,SonderjyskE,Viborg,2,2,0,D
187493,21,DNK1,2021-08-29,Vejle,FC Kobenhavn,0,4,-4,L
187494,21,DNK1,2021-08-29,Aarhus,Odense,2,2,0,D
187495,21,DNK1,2021-08-29,Brondby,Midtjylland,2,0,2,W
187496,21,DNK1,2021-09-10,Midtjylland,Nordsjalland,2,0,2,W
187497,21,DNK1,2021-09-10,Brondby,Silkeborg,1,1,0,D
187498,21,DNK1,2021-09-12,Viborg,Aalborg,2,3,-1,L
187499,21,DNK1,2021-09-12,Randers FC,FC Kobenhavn,0,2,-2,L
187500,21,DNK1,2021-09-12,Aarhus,Vejle,1,0,1,W
187501,21,DNK1,2021-09-13,Odense,SonderjyskE,2,1,1,W
187502,21,DNK1,2021-09-17,Aalborg,Odense,2,0,2,W
187503,21,DNK1,2021-09-19,Randers FC,Nordsjalland,3,2,1,W
187504,21,DNK1,2021-09-19,Vejle,Viborg,1,1,0,D
187505,21,DNK1,2021-09-19,SonderjyskE,Brondby,1,0,1,W
187506,21,DNK1,2021-09-19,FC Kobenhavn,Midtjylland,0,1,-1,L
187507,21,DNK1,2021-09-20,Silkeborg,Aarhus,0,2,-2,L
187508,21,DNK1,2021-09-26,Midtjylland,Randers FC,1,0,1,W
187509,21,DNK1,2021-09-26,Viborg,Odense,1,1,0,D
187510,21,DNK1,2021-09-26,Nordsjalland,FC Kobenhavn,1,5,-4,L
187511,21,DNK1,2021-09-26,Brondby,Aalborg,2,1,1,W
187512,21,DNK1,2021-09-26,Vejle,Silkeborg,2,4,-2,L
187513,21,DNK1,2021-09-27,Aarhus,SonderjyskE,1,0,1,W
187514,21,DNK1,2021-10-01,Odense,Vejle,6,0,6,W
187515,21,DNK1,2021-10-03,Aalborg,SonderjyskE,4,0,4,W
187516,21,DNK1,2021-10-03,Silkeborg,Nordsjalland,4,1,3,W
187517,21,DNK1,2021-10-03,Midtjylland,Aarhus,4,0,4,W
187518,21,DNK1,2021-10-03,Randers FC,Brondby,1,1,0,D
187519,21,DNK1,2021-10-03,FC Kobenhavn,Viborg,1,1,0,D
187520,21,DNK1,2021-10-15,Viborg,Silkeborg,1,1,0,D
187521,21,DNK1,2021-10-17,Nordsjalland,Midtjylland,2,2,0,D
187522,21,DNK1,2021-10-17,Odense,Randers FC,1,2,-1,L
187523,21,DNK1,2021-10-17,Brondby,Vejle,3,2,1,W
187524,21,DNK1,2021-10-17,SonderjyskE,FC Kobenhavn,1,1,0,D
187525,21,DNK1,2021-10-18,Aarhus,Aalborg,1,0,1,W
187526,21,DNK1,2021-10-22,Vejle,Nordsjalland,2,0,2,W
187527,21,DNK1,2021-10-24,Brondby,FC Kobenhavn,2,1,1,W
187528,21,DNK1,2021-10-24,Silkeborg,Odense,1,1,0,D
187529,21,DNK1,2021-10-24,Randers FC,Aarhus,1,0,1,W
187530,21,DNK1,2021-10-24,Midtjylland,SonderjyskE,3,2,1,W
187531,21,DNK1,2021-10-25,Aalborg,Viborg,2,5,-3,L
187532,21,DNK1,2021-10-31,Nordsjalland,Aalborg,0,2,-2,L
187533,21,DNK1,2021-10-31,Randers FC,Midtjylland,1,3,-2,L
187534,21,DNK1,2021-10-31,FC Kobenhavn,Vejle,3,0,3,W
187535,21,DNK1,2021-10-31,Viborg,Brondby,0,1,-1,L
187536,21,DNK1,2021-10-31,SonderjyskE,Silkeborg,0,6,-6,L
187537,21,DNK1,2021-11-01,Odense,Aarhus,0,0,0,D
187538,21,DNK1,2021-11-05,Viborg,Nordsjalland,2,2,0,D
187539,21,DNK1,2021-11-07,Aalborg,Randers FC,1,1,0,D
187540,21,DNK1,2021-11-07,Vejle,SonderjyskE,3,1,2,W
187541,21,DNK1,2021-11-07,Aarhus,Midtjylland,3,0,3,W
187542,21,DNK1,2021-11-07,Brondby,Odense,2,1,1,W
187543,21,DNK1,2021-11-07,Silkeborg,FC Kobenhavn,0,0,0,D
187544,21,DNK1,2021-11-19,Odense,Viborg,2,3,-1,L
187545,21,DNK1,2021-11-21,Nordsjalland,Silkeborg,1,1,0,D
187546,21,DNK1,2021-11-21,Randers FC,Vejle,4,1,3,W
187547,21,DNK1,2021-11-21,FC Kobenhavn,Aarhus,1,1,0,D
187548,21,DNK1,2021-11-21,Midtjylland,Brondby,1,2,-1,L
187549,21,DNK1,2021-11-22,SonderjyskE,Aalborg,1,3,-2,L
187550,21,DNK1,2021-11-26,Aarhus,Silkeborg,1,1,0,D
187551,21,DNK1,2021-11-28,Odense,Nordsjalland,2,0,2,W
187552,21,DNK1,2021-11-28,Viborg,SonderjyskE,1,1,0,D
187553,21,DNK1,2021-11-28,Brondby,Randers FC,1,0,1,W
187554,21,DNK1,2021-11-28,Aalborg,FC Kobenhavn,1,3,-2,L
187555,21,DNK1,2021-11-29,Vejle,Midtjylland,1,1,0,D
187556,21,DNK1,2022-02-18,SonderjyskE,Aarhus,2,3,-1,L
187557,21,DNK1,2022-02-20,Midtjylland,Aalborg,0,2,-2,L
187558,21,DNK1,2022-02-20,Silkeborg,Vejle,3,0,3,W
187559,21,DNK1,2022-02-20,Nordsjalland,Brondby,0,2,-2,L
187560,21,DNK1,2022-02-20,FC Kobenhavn,Odense,2,0,2,W
187561,21,DNK1,2022-02-21,Randers FC,Viborg,0,1,-1,L
187562,21,DNK1,2022-02-25,Vejle,Aarhus,3,2,1,W
187563,21,DNK1,2022-02-27,Aalborg,Silkeborg,1,4,-3,L
187564,21,DNK1,2022-02-27,Nordsjalland,Randers FC,0,0,0,D
187565,21,DNK1,2022-02-27,Viborg,FC Kobenhavn,0,2,-2,L
187566,21,DNK1,2022-02-27,Odense,Midtjylland,2,2,0,D
187567,21,DNK1,2022-02-28,Brondby,SonderjyskE,1,0,1,W
187568,21,DNK1,2022-03-04,Midtjylland,Viborg,3,1,2,W
187569,21,DNK1,2022-03-04,FC Kobenhavn,Randers FC,3,0,3,W
187570,21,DNK1,2022-03-06,SonderjyskE,Odense,2,2,0,D
187571,21,DNK1,2022-03-06,Aalborg,Vejle,0,0,0,D
187572,21,DNK1,2022-03-06,Silkeborg,Brondby,0,1,-1,L
187573,21,DNK1,2022-03-07,Aarhus,Nordsjalland,2,3,-1,L
187574,21,DNK1,2022-03-11,Nordsjalland,SonderjyskE,1,1,0,D
187575,21,DNK1,2022-03-13,Randers FC,Silkeborg,2,1,1,W
187576,21,DNK1,2022-03-13,Viborg,Vejle,2,0,2,W
187577,21,DNK1,2022-03-13,Brondby,Aarhus,1,1,0,D
187578,21,DNK1,2022-03-13,Midtjylland,FC Kobenhavn,0,1,-1,L
187579,21,DNK1,2022-03-14,Odense,Aalborg,2,3,-1,L
187580,21,DNK1,2022-03-20,Aalborg,Brondby,3,0,3,W
187581,21,DNK1,2022-03-20,Aarhus,Viborg,1,1,0,D
187582,21,DNK1,2022-03-20,FC Kobenhavn,Nordsjalland,1,0,1,W
187583,21,DNK1,2022-03-20,Silkeborg,Midtjylland,0,1,-1,L
187584,21,DNK1,2022-03-20,SonderjyskE,Randers FC,1,1,0,D
187585,21,DNK1,2022-03-20,Vejle,Odense,2,0,2,W
187586,21,DNK1,2022-04-01,Viborg,SonderjyskE,2,1,1,W
187587,21,DNK1,2022-04-03,Aarhus,Vejle,0,0,0,D
187588,21,DNK1,2022-04-03,Odense,Nordsjalland,2,1,1,W
187589,21,DNK1,2022-04-03,Brondby,Randers FC,0,1,-1,L
187590,21,DNK1,2022-04-03,Aalborg,FC Kobenhavn,0,1,-1,L
187591,21,DNK1,2022-04-04,Midtjylland,Silkeborg,3,2,1,W
187592,21,DNK1,2022-04-08,Aalborg,Randers FC,3,0,3,W
187593,21,DNK1,2022-04-10,SonderjyskE,Odense,2,2,0,D
187594,21,DNK1,2022-04-10,Nordsjalland,Aarhus,2,2,0,D
187595,21,DNK1,2022-04-10,Silkeborg,Brondby,3,0,3,W
187596,21,DNK1,2022-04-10,FC Kobenhavn,Midtjylland,1,0,1,W
187597,21,DNK1,2022-04-11,Vejle,Viborg,2,2,0,D
187598,21,DNK1,2022-04-13,Randers FC,Midtjylland,1,3,-2,L
187599,21,DNK1,2022-04-14,Odense,Vejle,2,1,1,W
187600,21,DNK1,2022-04-14,Aarhus,Viborg,0,2,-2,L
187601,21,DNK1,2022-04-14,Silkeborg,FC Kobenhavn,3,1,2,W
187602,21,DNK1,2022-04-14,Brondby,Aalborg,0,1,-1,L
187603,21,DNK1,2022-04-15,Nordsjalland,SonderjyskE,2,0,2,W
187604,21,DNK1,2022-04-17,Viborg,Odense,1,1,0,D
187605,21,DNK1,2022-04-18,SonderjyskE,Aarhus,2,1,1,W
187606,21,DNK1,2022-04-18,Vejle,Nordsjalland,0,0,0,D
187607,21,DNK1,2022-04-18,FC Kobenhavn,Brondby,2,0,2,W
187608,21,DNK1,2022-04-18,Midtjylland,Aalborg,2,0,2,W
187609,21,DNK1,2022-04-19,Randers FC,Silkeborg,1,2,-1,L
187610,21,DNK1,2022-04-22,SonderjyskE,Vejle,0,1,-1,L
187611,21,DNK1,2022-04-24,Nordsjalland,Viborg,2,0,2,W
187612,21,DNK1,2022-04-24,Aarhus,Odense,1,2,-1,L
187613,21,DNK1,2022-04-24,Aalborg,Silkeborg,1,2,-1,L
187614,21,DNK1,2022-04-24,FC Kobenhavn,Randers FC,0,1,-1,L
187615,21,DNK1,2022-04-25,Brondby,Midtjylland,1,3,-2,L
187616,21,DNK1,2022-04-29,Viborg,Nordsjalland,1,1,0,D
187617,21,DNK1,2022-05-01,Odense,Aarhus,1,0,1,W
187618,21,DNK1,2022-05-01,Vejle,SonderjyskE,0,3,-3,L
187619,21,DNK1,2022-05-01,Randers FC,Brondby,2,1,1,W
187620,21,DNK1,2022-05-01,Midtjylland,FC Kobenhavn,0,0,0,D
187621,21,DNK1,2022-05-02,Silkeborg,Aalborg,4,2,2,W
187622,21,DNK1,2022-05-06,Silkeborg,Randers FC,1,0,1,W
187623,21,DNK1,2022-05-08,Nordsjalland,Odense,1,1,0,D
187624,21,DNK1,2022-05-08,Aarhus,SonderjyskE,1,1,0,D
187625,21,DNK1,2022-05-08,Brondby,FC Kobenhavn,1,1,0,D
187626,21,DNK1,2022-05-08,Aalborg,Midtjylland,1,2,-1,L
187627,21,DNK1,2022-05-09,Viborg,Vejle,2,2,0,D
187628,21,DNK1,2022-05-11,SonderjyskE,Nordsjalland,1,1,0,D
187629,21,DNK1,2022-05-11,Randers FC,Aalborg,2,2,0,D
187630,21,DNK1,2022-05-11,FC Kobenhavn,Silkeborg,2,1,1,W
187631,21,DNK1,2022-05-12,Vejle,Aarhus,1,0,1,W
187632,21,DNK1,2022-05-12,Odense,Viborg,1,1,0,D
187633,21,DNK1,2022-05-12,Midtjylland,Brondby,2,2,0,D
187634,21,DNK1,2022-05-15,Nordsjalland,Vejle,2,1,1,W
187635,21,DNK1,2022-05-15,Odense,SonderjyskE,1,1,0,D
187636,21,DNK1,2022-05-15,Viborg,Aarhus,1,0,1,W
187637,21,DNK1,2022-05-15,Randers FC,FC Kobenhavn,0,2,-2,L
187638,21,DNK1,2022-05-15,Aalborg,Brondby,1,3,-2,L
187639,21,DNK1,2022-05-16,Silkeborg,Midtjylland,1,4,-3,L
187640,21,DNK1,2022-05-21,Aarhus,Nordsjalland,2,2,0,D
187641,21,DNK1,2022-05-21,Vejle,Odense,2,1,1,W
187642,21,DNK1,2022-05-21,SonderjyskE,Viborg,0,2,-2,L
187643,21,DNK1,2022-05-22,FC Kobenhavn,Aalborg,3,0,3,W
187644,21,DNK1,2022-05-22,Midtjylland,Randers FC,3,2,1,W
187645,21,DNK1,2022-05-22,Brondby,Silkeborg,2,1,1,W
187646,22,DNK1,2022-07-15,Midtjylland,Randers FC,1,1,0,D
187647,22,DNK1,2022-07-17,Viborg,Aalborg,2,1,1,W
187648,22,DNK1,2022-07-17,Lyngby,Silkeborg,2,2,0,D
187649,22,DNK1,2022-07-17,FC Kobenhavn,Horsens,0,1,-1,L
187650,22,DNK1,2022-07-17,Brondby,Aarhus,1,0,1,W
187651,22,DNK1,2022-07-18,Odense,Nordsjalland,0,2,-2,L
187652,22,DNK1,2022-07-22,Midtjylland,Silkeborg,1,3,-2,L
187653,22,DNK1,2022-07-24,Aarhus,Viborg,3,1,2,W
187654,22,DNK1,2022-07-24,Randers FC,Odense,2,2,0,D
187655,22,DNK1,2022-07-24,Brondby,Nordsjalland,1,3,-2,L
187656,22,DNK1,2022-07-24,Aalborg,FC Kobenhavn,1,3,-2,L
187657,22,DNK1,2022-07-25,Horsens,Lyngby,1,0,1,W
187658,22,DNK1,2022-07-29,Odense,Midtjylland,1,5,-4,L
187659,22,DNK1,2022-07-31,Aalborg,Horsens,0,0,0,D
187660,22,DNK1,2022-07-31,Aarhus,Randers FC,0,0,0,D
187661,22,DNK1,2022-07-31,Viborg,FC Kobenhavn,4,2,2,W
187662,22,DNK1,2022-07-31,Silkeborg,Brondby,2,0,2,W
187663,22,DNK1,2022-08-01,Nordsjalland,Lyngby,2,1,1,W
187664,22,DNK1,2022-08-05,Randers FC,Horsens,1,0,1,W
187665,22,DNK1,2022-08-05,Lyngby,Midtjylland,3,3,0,D
187666,22,DNK1,2022-08-06,Nordsjalland,Viborg,1,0,1,W
187667,22,DNK1,2022-08-07,FC Kobenhavn,Brondby,4,1,3,W
187668,22,DNK1,2022-08-07,Odense,Aarhus,1,2,-1,L
187669,22,DNK1,2022-08-08,Silkeborg,Aalborg,3,1,2,W
187670,22,DNK1,2022-08-12,Horsens,Midtjylland,3,3,0,D
187671,22,DNK1,2022-08-12,FC Kobenhavn,Randers FC,1,3,-2,L
187672,22,DNK1,2022-08-14,Viborg,Silkeborg,2,0,2,W
187673,22,DNK1,2022-08-14,Aalborg,Nordsjalland,0,0,0,D
187674,22,DNK1,2022-08-14,Brondby,Odense,2,0,2,W
187675,22,DNK1,2022-08-15,Aarhus,Lyngby,1,0,1,W
187676,22,DNK1,2022-08-19,Lyngby,FC Kobenhavn,0,3,-3,L
187677,22,DNK1,2022-08-20,Midtjylland,Aarhus,0,2,-2,L
187678,22,DNK1,2022-08-21,Nordsjalland,Silkeborg,0,2,-2,L
187679,22,DNK1,2022-08-21,Randers FC,Viborg,1,0,1,W
187680,22,DNK1,2022-08-21,Aalborg,Brondby,2,1,1,W
187681,22,DNK1,2022-08-22,Odense,Horsens,1,0,1,W
187682,22,DNK1,2022-08-26,Horsens,Aarhus,2,1,1,W
187683,22,DNK1,2022-08-28,Randers FC,Aalborg,1,0,1,W
187684,22,DNK1,2022-08-28,Viborg,Lyngby,2,1,1,W
187685,22,DNK1,2022-08-28,Nordsjalland,FC Kobenhavn,3,1,2,W
187686,22,DNK1,2022-08-28,Silkeborg,Odense,1,2,-1,L
187687,22,DNK1,2022-08-29,Brondby,Midtjylland,0,2,-2,L
187688,22,DNK1,2022-09-02,FC Kobenhavn,Silkeborg,1,0,1,W
187689,22,DNK1,2022-09-04,Lyngby,Randers FC,0,2,-2,L
187690,22,DNK1,2022-09-04,Odense,Viborg,1,2,-1,L
187691,22,DNK1,2022-09-04,Horsens,Brondby,0,2,-2,L
187692,22,DNK1,2022-09-04,Midtjylland,Aalborg,0,2,-2,L
187693,22,DNK1,2022-09-05,Aarhus,Nordsjalland,2,3,-1,L
187694,22,DNK1,2022-09-10,Odense,FC Kobenhavn,2,1,1,W
187695,22,DNK1,2022-09-11,Aalborg,Lyngby,1,1,0,D
187696,22,DNK1,2022-09-11,Nordsjalland,Midtjylland,1,1,0,D
187697,22,DNK1,2022-09-11,Brondby,Randers FC,2,2,0,D
187698,22,DNK1,2022-09-11,Silkeborg,Aarhus,1,0,1,W
187699,22,DNK1,2022-09-12,Viborg,Horsens,2,1,1,W
187700,22,DNK1,2022-09-16,Horsens,Nordsjalland,1,0,1,W
187701,22,DNK1,2022-09-17,Aarhus,Aalborg,3,1,2,W
187702,22,DNK1,2022-09-18,Lyngby,Odense,0,2,-2,L
187703,22,DNK1,2022-09-18,Randers FC,Silkeborg,3,2,1,W
187704,22,DNK1,2022-09-18,Viborg,Brondby,0,0,0,D
187705,22,DNK1,2022-09-18,Midtjylland,FC Kobenhavn,2,1,1,W
187706,22,DNK1,2022-09-30,Aalborg,Odense,1,1,0,D
187707,22,DNK1,2022-10-02,Midtjylland,Viborg,1,1,0,D
187708,22,DNK1,2022-10-02,Silkeborg,Horsens,2,1,1,W
187709,22,DNK1,2022-10-02,Brondby,Lyngby,3,3,0,D
187710,22,DNK1,2022-10-02,FC Kobenhavn,Aarhus,1,0,1,W
187711,22,DNK1,2022-10-03,Nordsjalland,Randers FC,3,1,2,W
187712,22,DNK1,2022-10-07,Lyngby,Viborg,1,1,0,D
187713,22,DNK1,2022-10-08,FC Kobenhavn,Nordsjalland,1,1,0,D
187714,22,DNK1,2022-10-09,Aarhus,Midtjylland,0,1,-1,L
187715,22,DNK1,2022-10-09,Odense,Silkeborg,1,1,0,D
187716,22,DNK1,2022-10-09,Randers FC,Brondby,2,3,-1,L
187717,22,DNK1,2022-10-10,Horsens,Aalborg,0,0,0,D
187718,22,DNK1,2022-10-14,Lyngby,Aalborg,0,2,-2,L
187719,22,DNK1,2022-10-16,Brondby,FC Kobenhavn,1,1,0,D
187720,22,DNK1,2022-10-16,Viborg,Odense,0,0,0,D
187721,22,DNK1,2022-10-16,Nordsjalland,Aarhus,1,1,0,D
187722,22,DNK1,2022-10-16,Midtjylland,Horsens,2,1,1,W
187723,22,DNK1,2022-10-17,Silkeborg,Randers FC,3,3,0,D
187724,22,DNK1,2022-10-21,Odense,Lyngby,3,1,2,W
187725,22,DNK1,2022-10-22,FC Kobenhavn,Midtjylland,1,1,0,D
187726,22,DNK1,2022-10-23,Randers FC,Nordsjalland,0,2,-2,L
187727,22,DNK1,2022-10-23,Horsens,Silkeborg,3,2,1,W
187728,22,DNK1,2022-10-23,Aarhus,Brondby,2,2,0,D
187729,22,DNK1,2022-10-24,Aalborg,Viborg,1,3,-2,L
187730,22,DNK1,2022-10-28,Nordsjalland,Horsens,2,0,2,W
187731,22,DNK1,2022-10-29,Randers FC,FC Kobenhavn,0,2,-2,L
187732,22,DNK1,2022-10-30,Lyngby,Aarhus,0,1,-1,L
187733,22,DNK1,2022-10-30,Silkeborg,Viborg,1,2,-1,L
187734,22,DNK1,2022-10-30,Brondby,Aalborg,3,2,1,W
187735,22,DNK1,2022-10-31,Midtjylland,Odense,1,2,-1,L
187736,22,DNK1,2022-11-04,Horsens,Randers FC,5,1,4,W
187737,22,DNK1,2022-11-06,Aalborg,Silkeborg,1,2,-1,L
187738,22,DNK1,2022-11-06,Viborg,Aarhus,1,1,0,D
187739,22,DNK1,2022-11-06,FC Kobenhavn,Lyngby,3,0,3,W
187740,22,DNK1,2022-11-06,Odense,Brondby,1,1,0,D
187741,22,DNK1,2022-11-07,Midtjylland,Nordsjalland,0,0,0,D
187742,22,DNK1,2022-11-12,Silkeborg,Lyngby,0,2,-2,L
187743,22,DNK1,2022-11-13,Aarhus,FC Kobenhavn,0,2,-2,L
187744,22,DNK1,2022-11-13,Horsens,Odense,3,3,0,D
187745,22,DNK1,2022-11-13,Brondby,Viborg,0,2,-2,L
187746,22,DNK1,2022-11-13,Nordsjalland,Aalborg,5,1,4,W
187747,22,DNK1,2022-11-13,Randers FC,Midtjylland,0,0,0,D
187748,22,DNK1,2023-02-17,Aalborg,Aarhus,0,1,-1,L
187749,22,DNK1,2023-02-19,Lyngby,Nordsjalland,1,1,0,D
187750,22,DNK1,2023-02-19,Odense,Randers FC,0,0,0,D
187751,22,DNK1,2023-02-19,Silkeborg,FC Kobenhavn,0,3,-3,L
187752,22,DNK1,2023-02-19,Brondby,Horsens,5,2,3,W
187753,22,DNK1,2023-02-20,Viborg,Midtjylland,0,4,-4,L
187754,22,DNK1,2023-02-24,Nordsjalland,Odense,4,2,2,W
187755,22,DNK1,2023-02-26,Horsens,Viborg,0,3,-3,L
187756,22,DNK1,2023-02-26,Randers FC,Lyngby,1,0,1,W
187757,22,DNK1,2023-02-26,FC Kobenhavn,Aalborg,1,0,1,W
187758,22,DNK1,2023-02-26,Aarhus,Silkeborg,1,1,0,D
187759,22,DNK1,2023-02-27,Midtjylland,Brondby,0,1,-1,L
187760,22,DNK1,2023-03-03,Aarhus,Horsens,2,0,2,W
187761,22,DNK1,2023-03-05,Silkeborg,Nordsjalland,2,1,1,W
187762,22,DNK1,2023-03-05,Viborg,Randers FC,2,2,0,D
187763,22,DNK1,2023-03-05,Lyngby,Brondby,1,0,1,W
187764,22,DNK1,2023-03-05,FC Kobenhavn,Odense,7,0,7,W
187765,22,DNK1,2023-03-06,Aalborg,Midtjylland,0,0,0,D
187766,22,DNK1,2023-03-10,Odense,Aalborg,2,1,1,W
187767,22,DNK1,2023-03-12,Midtjylland,Lyngby,1,3,-2,L
187768,22,DNK1,2023-03-12,Viborg,Nordsjalland,1,1,0,D
187769,22,DNK1,2023-03-12,Horsens,FC Kobenhavn,1,4,-3,L
187770,22,DNK1,2023-03-12,Brondby,Silkeborg,2,1,1,W
187771,22,DNK1,2023-03-13,Randers FC,Aarhus,1,2,-1,L
187772,22,DNK1,2023-03-19,Aalborg,Randers FC,0,1,-1,L
187773,22,DNK1,2023-03-19,Aarhus,Odense,1,0,1,W
187774,22,DNK1,2023-03-19,FC Kobenhavn,Viborg,2,1,1,W
187775,22,DNK1,2023-03-19,Nordsjalland,Brondby,2,1,1,W
187776,22,DNK1,2023-03-19,Lyngby,Horsens,1,1,0,D
187777,22,DNK1,2023-03-19,Silkeborg,Midtjylland,3,3,0,D
187778,22,DNK1,2023-03-31,Odense,Midtjylland,1,3,-2,L
187779,22,DNK1,2023-04-02,Lyngby,Silkeborg,1,1,0,D
187780,22,DNK1,2023-04-02,Horsens,Aalborg,0,4,-4,L
187781,22,DNK1,2023-04-02,Brondby,Viborg,0,3,-3,L
187782,22,DNK1,2023-04-02,FC Kobenhavn,Nordsjalland,2,1,1,W
187783,22,DNK1,2023-04-03,Aarhus,Randers FC,1,1,0,D
